,datetime,season,year,month,hour,user_casual,user_registered,count_total,moving_avg
0,2011-01-01,1,0,1,0,3,13,16,
1,2011-01-01,1,0,1,1,8,32,40,
2,2011-01-01,1,0,1,2,5,27,32,29.333333333333332
3,2011-01-01,1,0,1,3,3,10,13,28.333333333333332
4,2011-01-01,1,0,1,4,0,1,1,15.333333333333334
5,2011-01-01,1,0,1,5,0,1,1,5.0
6,2011-01-01,1,0,1,6,2,0,2,1.3333333333333333
7,2011-01-01,1,0,1,7,1,2,3,2.0
8,2011-01-01,1,0,1,8,1,7,8,4.333333333333333
9,2011-01-01,1,0,1,9,8,6,14,8.333333333333334
10,2011-01-01,1,0,1,10,12,24,36,19.333333333333332
11,2011-01-01,1,0,1,11,26,30,56,35.333333333333336
12,2011-01-01,1,0,1,12,29,55,84,58.666666666666664
13,2011-01-01,1,0,1,13,47,47,94,78.0
14,2011-01-01,1,0,1,14,35,71,106,94.66666666666667
15,2011-01-01,1,0,1,15,40,70,110,103.33333333333333
16,2011-01-01,1,0,1,16,41,52,93,103.0
17,2011-01-01,1,0,1,17,15,52,67,90.0
18,2011-01-01,1,0,1,18,9,26,35,65.0
19,2011-01-01,1,0,1,19,6,31,37,46.333333333333336
20,2011-01-01,1,0,1,20,11,25,36,36.0
21,2011-01-01,1,0,1,21,3,31,34,35.666666666666664
22,2011-01-01,1,0,1,22,11,17,28,32.666666666666664
23,2011-01-01,1,0,1,23,15,24,39,33.666666666666664
24,2011-01-02,1,0,1,0,4,13,17,28.0
25,2011-01-02,1,0,1,1,1,16,17,24.333333333333332
26,2011-01-02,1,0,1,2,1,8,9,14.333333333333334
27,2011-01-02,1,0,1,3,2,4,6,10.666666666666666
28,2011-01-02,1,0,1,4,2,1,3,6.0
29,2011-01-02,1,0,1,6,0,2,2,3.6666666666666665
30,2011-01-02,1,0,1,7,0,1,1,2.0
31,2011-01-02,1,0,1,8,0,8,8,3.6666666666666665
32,2011-01-02,1,0,1,9,1,19,20,9.666666666666666
33,2011-01-02,1,0,1,10,7,46,53,27.0
34,2011-01-02,1,0,1,11,16,54,70,47.666666666666664
35,2011-01-02,1,0,1,12,20,73,93,72.0
36,2011-01-02,1,0,1,13,11,64,75,79.33333333333333
37,2011-01-02,1,0,1,14,4,55,59,75.66666666666667
38,2011-01-02,1,0,1,15,19,55,74,69.33333333333333
39,2011-01-02,1,0,1,16,9,67,76,69.66666666666667
40,2011-01-02,1,0,1,17,7,58,65,71.66666666666667
41,2011-01-02,1,0,1,18,10,43,53,64.66666666666667
42,2011-01-02,1,0,1,19,1,29,30,49.333333333333336
43,2011-01-02,1,0,1,20,5,17,22,35.0
44,2011-01-02,1,0,1,21,11,20,31,27.666666666666668
45,2011-01-02,1,0,1,22,0,9,9,20.666666666666668
46,2011-01-02,1,0,1,23,0,8,8,16.0
47,2011-01-03,1,0,1,0,0,5,5,7.333333333333333
48,2011-01-03,1,0,1,1,0,2,2,5.0
49,2011-01-03,1,0,1,4,0,1,1,2.6666666666666665
50,2011-01-03,1,0,1,5,0,3,3,2.0
51,2011-01-03,1,0,1,6,0,30,30,11.333333333333334
52,2011-01-03,1,0,1,7,1,63,64,32.333333333333336
53,2011-01-03,1,0,1,8,1,153,154,82.66666666666667
54,2011-01-03,1,0,1,9,7,81,88,102.0
55,2011-01-03,1,0,1,10,11,33,44,95.33333333333333
56,2011-01-03,1,0,1,11,10,41,51,61.0
57,2011-01-03,1,0,1,12,13,48,61,52.0
58,2011-01-03,1,0,1,13,8,53,61,57.666666666666664
59,2011-01-03,1,0,1,14,11,66,77,66.33333333333333
60,2011-01-03,1,0,1,15,14,58,72,70.0
61,2011-01-03,1,0,1,16,9,67,76,75.0
62,2011-01-03,1,0,1,17,11,146,157,101.66666666666667
63,2011-01-03,1,0,1,18,9,148,157,130.0
64,2011-01-03,1,0,1,19,8,102,110,141.33333333333334
65,2011-01-03,1,0,1,20,3,49,52,106.33333333333333
66,2011-01-03,1,0,1,21,3,49,52,71.33333333333333
67,2011-01-03,1,0,1,22,0,20,20,41.333333333333336
68,2011-01-03,1,0,1,23,1,11,12,28.0
69,2011-01-04,1,0,1,0,0,5,5,12.333333333333334
70,2011-01-04,1,0,1,1,0,2,2,6.333333333333333
71,2011-01-04,1,0,1,2,0,1,1,2.6666666666666665
72,2011-01-04,1,0,1,4,0,2,2,1.6666666666666667
73,2011-01-04,1,0,1,5,0,4,4,2.3333333333333335
74,2011-01-04,1,0,1,6,0,36,36,14.0
75,2011-01-04,1,0,1,7,2,92,94,44.666666666666664
76,2011-01-04,1,0,1,8,2,177,179,103.0
77,2011-01-04,1,0,1,9,2,98,100,124.33333333333333
78,2011-01-04,1,0,1,10,5,37,42,107.0
79,2011-01-04,1,0,1,11,7,50,57,66.33333333333333
80,2011-01-04,1,0,1,12,12,66,78,59.0
81,2011-01-04,1,0,1,13,18,79,97,77.33333333333333
82,2011-01-04,1,0,1,14,9,54,63,79.33333333333333
83,2011-01-04,1,0,1,15,17,48,65,75.0
84,2011-01-04,1,0,1,16,15,68,83,70.33333333333333
85,2011-01-04,1,0,1,17,10,202,212,120.0
86,2011-01-04,1,0,1,18,3,179,182,159.0
87,2011-01-04,1,0,1,19,2,110,112,168.66666666666666
88,2011-01-04,1,0,1,20,1,53,54,116.0
89,2011-01-04,1,0,1,21,0,48,48,71.33333333333333
90,2011-01-04,1,0,1,22,1,34,35,45.666666666666664
91,2011-01-04,1,0,1,23,2,9,11,31.333333333333332
92,2011-01-05,1,0,1,0,0,6,6,17.333333333333332
93,2011-01-05,1,0,1,1,0,6,6,7.666666666666667
94,2011-01-05,1,0,1,2,0,2,2,4.666666666666667
95,2011-01-05,1,0,1,4,0,2,2,3.3333333333333335
96,2011-01-05,1,0,1,5,0,3,3,2.3333333333333335
97,2011-01-05,1,0,1,6,0,33,33,12.666666666666666
98,2011-01-05,1,0,1,7,1,87,88,41.333333333333336
99,2011-01-05,1,0,1,8,3,192,195,105.33333333333333
100,2011-01-05,1,0,1,9,6,109,115,132.66666666666666
101,2011-01-05,1,0,1,10,4,53,57,122.33333333333333
102,2011-01-05,1,0,1,11,12,34,46,72.66666666666667
103,2011-01-05,1,0,1,12,5,74,79,60.666666666666664
104,2011-01-05,1,0,1,13,6,65,71,65.33333333333333
105,2011-01-05,1,0,1,14,10,52,62,70.66666666666667
106,2011-01-05,1,0,1,15,7,55,62,65.0
107,2011-01-05,1,0,1,16,4,85,89,71.0
108,2011-01-05,1,0,1,17,4,186,190,113.66666666666667
109,2011-01-05,1,0,1,18,3,166,169,149.33333333333334
110,2011-01-05,1,0,1,19,5,127,132,163.66666666666666
111,2011-01-05,1,0,1,20,7,82,89,130.0
112,2011-01-05,1,0,1,21,3,40,43,88.0
113,2011-01-05,1,0,1,22,1,41,42,58.0
114,2011-01-05,1,0,1,23,1,18,19,34.666666666666664
115,2011-01-06,1,0,1,0,0,11,11,24.0
116,2011-01-06,1,0,1,1,0,4,4,11.333333333333334
117,2011-01-06,1,0,1,2,0,2,2,5.666666666666667
118,2011-01-06,1,0,1,4,0,1,1,2.3333333333333335
119,2011-01-06,1,0,1,5,0,4,4,2.3333333333333335
120,2011-01-06,1,0,1,6,0,36,36,13.666666666666666
121,2011-01-06,1,0,1,7,0,95,95,45.0
122,2011-01-06,1,0,1,8,3,216,219,116.66666666666667
123,2011-01-06,1,0,1,9,6,116,122,145.33333333333334
124,2011-01-06,1,0,1,10,3,42,45,128.66666666666666
125,2011-01-06,1,0,1,11,2,57,59,75.33333333333333
126,2011-01-06,1,0,1,12,6,78,84,62.666666666666664
127,2011-01-06,1,0,1,13,12,55,67,70.0
128,2011-01-06,1,0,1,14,11,59,70,73.66666666666667
129,2011-01-06,1,0,1,15,8,54,62,66.33333333333333
130,2011-01-06,1,0,1,16,12,74,86,72.66666666666667
131,2011-01-06,1,0,1,17,9,163,172,106.66666666666667
132,2011-01-06,1,0,1,18,5,158,163,140.33333333333334
133,2011-01-06,1,0,1,19,3,109,112,149.0
134,2011-01-06,1,0,1,20,3,66,69,114.66666666666667
135,2011-01-06,1,0,1,21,0,48,48,76.33333333333333
136,2011-01-06,1,0,1,22,1,51,52,56.333333333333336
137,2011-01-06,1,0,1,23,4,19,23,41.0
138,2011-01-07,1,0,1,0,4,13,17,30.666666666666668
139,2011-01-07,1,0,1,1,2,5,7,15.666666666666666
140,2011-01-07,1,0,1,2,0,1,1,8.333333333333334
141,2011-01-07,1,0,1,4,0,1,1,3.0
142,2011-01-07,1,0,1,5,0,5,5,2.3333333333333335
143,2011-01-07,1,0,1,6,8,26,34,13.333333333333334
144,2011-01-07,1,0,1,7,8,76,84,41.0
145,2011-01-07,1,0,1,8,20,190,210,109.33333333333333
146,2011-01-07,1,0,1,9,9,125,134,142.66666666666666
147,2011-01-07,1,0,1,10,16,47,63,135.66666666666666
148,2011-01-07,1,0,1,11,19,48,67,88.0
149,2011-01-07,1,0,1,12,9,50,59,63.0
150,2011-01-07,1,0,1,13,9,64,73,66.33333333333333
151,2011-01-07,1,0,1,14,7,43,50,60.666666666666664
152,2011-01-07,1,0,1,15,9,63,72,65.0
153,2011-01-07,1,0,1,16,5,82,87,69.66666666666667
154,2011-01-07,1,0,1,17,9,178,187,115.33333333333333
155,2011-01-07,1,0,1,18,7,116,123,132.33333333333334
156,2011-01-07,1,0,1,19,3,92,95,135.0
157,2011-01-07,1,0,1,20,1,50,51,89.66666666666667
158,2011-01-07,1,0,1,21,0,39,39,61.666666666666664
159,2011-01-07,1,0,1,22,2,34,36,42.0
160,2011-01-07,1,0,1,23,1,14,15,30.0
161,2011-01-08,1,0,1,0,1,24,25,25.333333333333332
162,2011-01-08,1,0,1,1,1,15,16,18.666666666666668
163,2011-01-08,1,0,1,2,3,13,16,19.0
164,2011-01-08,1,0,1,3,0,7,7,13.0
165,2011-01-08,1,0,1,4,0,1,1,8.0
166,2011-01-08,1,0,1,5,0,5,5,4.333333333333333
167,2011-01-08,1,0,1,6,0,2,2,2.6666666666666665
168,2011-01-08,1,0,1,7,1,8,9,5.333333333333333
169,2011-01-08,1,0,1,8,0,15,15,8.666666666666666
170,2011-01-08,1,0,1,9,0,20,20,14.666666666666666
171,2011-01-08,1,0,1,10,5,56,61,32.0
172,2011-01-08,1,0,1,11,2,60,62,47.666666666666664
173,2011-01-08,1,0,1,12,8,90,98,73.66666666666667
174,2011-01-08,1,0,1,13,7,95,102,87.33333333333333
175,2011-01-08,1,0,1,14,12,83,95,98.33333333333333
176,2011-01-08,1,0,1,15,5,69,74,90.33333333333333
177,2011-01-08,1,0,1,16,8,68,76,81.66666666666667
178,2011-01-08,1,0,1,17,5,64,69,73.0
179,2011-01-08,1,0,1,18,3,52,55,66.66666666666667
180,2011-01-08,1,0,1,19,4,26,30,51.333333333333336
181,2011-01-08,1,0,1,20,0,28,28,37.666666666666664
182,2011-01-08,1,0,1,21,2,35,37,31.666666666666668
183,2011-01-08,1,0,1,22,1,33,34,33.0
184,2011-01-08,1,0,1,23,0,22,22,31.0
185,2011-01-09,1,0,1,0,1,24,25,27.0
186,2011-01-09,1,0,1,1,0,12,12,19.666666666666668
187,2011-01-09,1,0,1,2,0,11,11,16.0
188,2011-01-09,1,0,1,3,0,4,4,9.0
189,2011-01-09,1,0,1,4,0,1,1,5.333333333333333
190,2011-01-09,1,0,1,5,0,1,1,2.0
191,2011-01-09,1,0,1,6,0,1,1,1.0
192,2011-01-09,1,0,1,7,1,5,6,2.6666666666666665
193,2011-01-09,1,0,1,8,0,10,10,5.666666666666667
194,2011-01-09,1,0,1,9,0,19,19,11.666666666666666
195,2011-01-09,1,0,1,10,0,49,49,26.0
196,2011-01-09,1,0,1,11,2,47,49,39.0
197,2011-01-09,1,0,1,12,4,79,83,60.333333333333336
198,2011-01-09,1,0,1,13,6,69,75,69.0
199,2011-01-09,1,0,1,14,8,64,72,76.66666666666667
200,2011-01-09,1,0,1,15,5,77,82,76.33333333333333
201,2011-01-09,1,0,1,16,13,79,92,82.0
202,2011-01-09,1,0,1,17,3,59,62,78.66666666666667
203,2011-01-09,1,0,1,18,4,44,48,67.33333333333333
204,2011-01-09,1,0,1,19,1,40,41,50.333333333333336
205,2011-01-09,1,0,1,20,0,38,38,42.333333333333336
206,2011-01-09,1,0,1,21,1,19,20,33.0
207,2011-01-09,1,0,1,22,5,10,15,24.333333333333332
208,2011-01-09,1,0,1,23,0,6,6,13.666666666666666
209,2011-01-10,1,0,1,0,2,3,5,8.666666666666666
210,2011-01-10,1,0,1,1,1,0,1,4.0
211,2011-01-10,1,0,1,2,0,3,3,3.0
212,2011-01-10,1,0,1,3,0,1,1,1.6666666666666667
213,2011-01-10,1,0,1,4,1,2,3,2.3333333333333335
214,2011-01-10,1,0,1,5,0,3,3,2.3333333333333335
215,2011-01-10,1,0,1,6,0,31,31,12.333333333333334
216,2011-01-10,1,0,1,7,2,75,77,37.0
217,2011-01-10,1,0,1,8,4,184,188,98.66666666666667
218,2011-01-10,1,0,1,9,2,92,94,119.66666666666667
219,2011-01-10,1,0,1,10,0,31,31,104.33333333333333
220,2011-01-10,1,0,1,11,2,28,30,51.666666666666664
221,2011-01-10,1,0,1,12,5,47,52,37.666666666666664
222,2011-01-10,1,0,1,13,4,50,54,45.333333333333336
223,2011-01-10,1,0,1,14,0,47,47,51.0
224,2011-01-10,1,0,1,15,2,43,45,48.666666666666664
225,2011-01-10,1,0,1,16,4,70,74,55.333333333333336
226,2011-01-10,1,0,1,17,4,174,178,99.0
227,2011-01-10,1,0,1,18,1,154,155,135.66666666666666
228,2011-01-10,1,0,1,19,3,92,95,142.66666666666666
229,2011-01-10,1,0,1,20,1,73,74,108.0
230,2011-01-10,1,0,1,21,1,37,38,69.0
231,2011-01-10,1,0,1,22,2,22,24,45.333333333333336
232,2011-01-10,1,0,1,23,0,18,18,26.666666666666668
233,2011-01-11,1,0,1,0,2,10,12,18.0
234,2011-01-11,1,0,1,1,0,3,3,11.0
235,2011-01-11,1,0,1,2,0,3,3,6.0
236,2011-01-11,1,0,1,5,0,6,6,4.0
237,2011-01-11,1,0,1,6,0,27,27,12.0
238,2011-01-11,1,0,1,7,2,97,99,44.0
239,2011-01-11,1,0,1,8,3,214,217,114.33333333333333
240,2011-01-11,1,0,1,9,3,127,130,148.66666666666666
241,2011-01-11,1,0,1,10,3,51,54,133.66666666666666
242,2011-01-11,1,0,1,11,4,31,35,73.0
243,2011-01-11,1,0,1,12,2,55,57,48.666666666666664
244,2011-01-11,1,0,1,13,6,46,52,48.0
245,2011-01-11,1,0,1,14,3,60,63,57.333333333333336
246,2011-01-11,1,0,1,15,2,45,47,54.0
247,2011-01-11,1,0,1,16,4,72,76,62.0
248,2011-01-11,1,0,1,17,6,130,136,86.33333333333333
249,2011-01-11,1,0,1,18,1,94,95,102.33333333333333
250,2011-01-11,1,0,1,19,0,51,51,94.0
251,2011-01-11,1,0,1,20,0,32,32,59.333333333333336
252,2011-01-11,1,0,1,21,0,20,20,34.333333333333336
253,2011-01-11,1,0,1,22,1,28,29,27.0
254,2011-01-11,1,0,1,23,1,18,19,22.666666666666668
255,2011-01-12,1,0,1,0,0,7,7,18.333333333333332
256,2011-01-12,1,0,1,1,0,6,6,10.666666666666666
257,2011-01-12,1,0,1,2,0,1,1,4.666666666666667
258,2011-01-12,1,0,1,5,0,5,5,4.0
259,2011-01-12,1,0,1,6,0,16,16,7.333333333333333
260,2011-01-12,1,0,1,7,0,54,54,25.0
261,2011-01-12,1,0,1,8,3,125,128,66.0
262,2011-01-12,1,0,1,9,3,78,81,87.66666666666667
263,2011-01-12,1,0,1,10,0,39,39,82.66666666666667
264,2011-01-12,1,0,1,11,3,32,35,51.666666666666664
265,2011-01-12,1,0,1,12,3,52,55,43.0
266,2011-01-12,1,0,1,13,0,49,49,46.333333333333336
267,2011-01-12,1,0,1,14,0,44,44,49.333333333333336
268,2011-01-12,1,0,1,15,1,48,49,47.333333333333336
269,2011-01-12,1,0,1,16,5,63,68,53.666666666666664
270,2011-01-12,1,0,1,17,0,139,139,85.33333333333333
271,2011-01-12,1,0,1,18,2,135,137,114.66666666666667
272,2011-01-12,1,0,1,19,1,82,83,119.66666666666667
273,2011-01-12,1,0,1,20,2,54,56,92.0
274,2011-01-12,1,0,1,21,0,57,57,65.33333333333333
275,2011-01-12,1,0,1,22,1,32,33,48.666666666666664
276,2011-01-12,1,0,1,23,1,19,20,36.666666666666664
277,2011-01-13,1,0,1,0,1,6,7,20.0
278,2011-01-13,1,0,1,1,0,2,2,9.666666666666666
279,2011-01-13,1,0,1,2,0,2,2,3.6666666666666665
280,2011-01-13,1,0,1,3,0,3,3,2.3333333333333335
281,2011-01-13,1,0,1,4,0,4,4,3.0
282,2011-01-13,1,0,1,5,0,3,3,3.3333333333333335
283,2011-01-13,1,0,1,6,0,28,28,11.666666666666666
284,2011-01-13,1,0,1,7,0,72,72,34.333333333333336
285,2011-01-13,1,0,1,8,5,197,202,100.66666666666667
286,2011-01-13,1,0,1,9,2,137,139,137.66666666666666
287,2011-01-13,1,0,1,10,2,36,38,126.33333333333333
288,2011-01-13,1,0,1,11,4,33,37,71.33333333333333
289,2011-01-13,1,0,1,12,3,49,52,42.333333333333336
290,2011-01-13,1,0,1,13,2,81,83,57.333333333333336
291,2011-01-13,1,0,1,14,3,39,42,59.0
292,2011-01-13,1,0,1,15,5,55,60,61.666666666666664
293,2011-01-13,1,0,1,16,2,76,78,60.0
294,2011-01-13,1,0,1,17,4,158,162,100.0
295,2011-01-13,1,0,1,18,3,141,144,128.0
296,2011-01-13,1,0,1,19,1,98,99,135.0
297,2011-01-13,1,0,1,20,0,64,64,102.33333333333333
298,2011-01-13,1,0,1,21,0,40,40,67.66666666666667
299,2011-01-13,1,0,1,22,0,30,30,44.666666666666664
300,2011-01-13,1,0,1,23,1,14,15,28.333333333333332
301,2011-01-14,1,0,1,0,0,14,14,19.666666666666668
302,2011-01-14,1,0,1,1,0,5,5,11.333333333333334
303,2011-01-14,1,0,1,2,0,1,1,6.666666666666667
304,2011-01-14,1,0,1,3,0,1,1,2.3333333333333335
305,2011-01-14,1,0,1,5,0,8,8,3.3333333333333335
306,2011-01-14,1,0,1,6,0,17,17,8.666666666666666
307,2011-01-14,1,0,1,7,0,70,70,31.666666666666668
308,2011-01-14,1,0,1,8,2,156,158,81.66666666666667
309,2011-01-14,1,0,1,9,0,117,117,115.0
310,2011-01-14,1,0,1,10,4,40,44,106.33333333333333
311,2011-01-14,1,0,1,11,6,47,53,71.33333333333333
312,2011-01-14,1,0,1,12,2,59,61,52.666666666666664
313,2011-01-14,1,0,1,13,4,73,77,63.666666666666664
314,2011-01-14,1,0,1,14,5,59,64,67.33333333333333
315,2011-01-14,1,0,1,15,9,59,68,69.66666666666667
316,2011-01-14,1,0,1,16,3,87,90,74.0
317,2011-01-14,1,0,1,17,4,155,159,105.66666666666667
318,2011-01-14,1,0,1,18,5,134,139,129.33333333333334
319,2011-01-14,1,0,1,19,3,89,92,130.0
320,2011-01-14,1,0,1,20,0,68,68,99.66666666666667
321,2011-01-14,1,0,1,21,4,48,52,70.66666666666667
322,2011-01-14,1,0,1,22,2,34,36,52.0
323,2011-01-14,1,0,1,23,1,26,27,38.333333333333336
324,2011-01-15,1,0,1,0,3,25,28,30.333333333333332
325,2011-01-15,1,0,1,1,2,18,20,25.0
326,2011-01-15,1,0,1,2,0,12,12,20.0
327,2011-01-15,1,0,1,3,1,7,8,13.333333333333334
328,2011-01-15,1,0,1,4,0,5,5,8.333333333333334
329,2011-01-15,1,0,1,5,0,1,1,4.666666666666667
330,2011-01-15,1,0,1,6,1,2,3,3.0
331,2011-01-15,1,0,1,7,1,9,10,4.666666666666667
332,2011-01-15,1,0,1,8,1,22,23,12.0
333,2011-01-15,1,0,1,9,2,31,33,22.0
334,2011-01-15,1,0,1,10,2,57,59,38.333333333333336
335,2011-01-15,1,0,1,11,18,54,72,54.666666666666664
336,2011-01-15,1,0,1,12,15,74,89,73.33333333333333
337,2011-01-15,1,0,1,13,21,80,101,87.33333333333333
338,2011-01-15,1,0,1,14,26,92,118,102.66666666666667
339,2011-01-15,1,0,1,15,21,108,129,116.0
340,2011-01-15,1,0,1,16,33,95,128,125.0
341,2011-01-15,1,0,1,17,29,54,83,113.33333333333333
342,2011-01-15,1,0,1,18,15,69,84,98.33333333333333
343,2011-01-15,1,0,1,19,14,60,74,80.33333333333333
344,2011-01-15,1,0,1,20,6,35,41,66.33333333333333
345,2011-01-15,1,0,1,21,6,51,57,57.333333333333336
346,2011-01-15,1,0,1,22,0,26,26,41.333333333333336
347,2011-01-15,1,0,1,23,5,39,44,42.333333333333336
348,2011-01-16,1,0,1,0,6,33,39,36.333333333333336
349,2011-01-16,1,0,1,1,4,19,23,35.333333333333336
350,2011-01-16,1,0,1,2,3,13,16,26.0
351,2011-01-16,1,0,1,3,9,6,15,18.0
352,2011-01-16,1,0,1,4,0,1,1,10.666666666666666
353,2011-01-16,1,0,1,5,1,1,2,6.0
354,2011-01-16,1,0,1,6,0,1,1,1.3333333333333333
355,2011-01-16,1,0,1,7,0,3,3,2.0
356,2011-01-16,1,0,1,8,0,18,18,7.333333333333333
357,2011-01-16,1,0,1,9,3,29,32,17.666666666666668
358,2011-01-16,1,0,1,10,8,71,79,43.0
359,2011-01-16,1,0,1,11,23,70,93,68.0
360,2011-01-16,1,0,1,12,29,75,104,92.0
361,2011-01-16,1,0,1,13,23,95,118,105.0
362,2011-01-16,1,0,1,14,22,69,91,104.33333333333333
363,2011-01-16,1,0,1,15,35,78,113,107.33333333333333
364,2011-01-16,1,0,1,16,22,77,99,101.0
365,2011-01-16,1,0,1,17,23,82,105,105.66666666666667
366,2011-01-16,1,0,1,18,11,56,67,90.33333333333333
367,2011-01-16,1,0,1,19,14,47,61,77.66666666666667
368,2011-01-16,1,0,1,20,7,50,57,61.666666666666664
369,2011-01-16,1,0,1,21,6,22,28,48.666666666666664
370,2011-01-16,1,0,1,22,2,19,21,35.333333333333336
371,2011-01-16,1,0,1,23,0,18,18,22.333333333333332
372,2011-01-17,1,0,1,0,1,16,17,18.666666666666668
373,2011-01-17,1,0,1,1,1,15,16,17.0
374,2011-01-17,1,0,1,2,0,8,8,13.666666666666666
375,2011-01-17,1,0,1,3,0,2,2,8.666666666666666
376,2011-01-17,1,0,1,4,1,2,3,4.333333333333333
377,2011-01-17,1,0,1,5,0,1,1,2.0
378,2011-01-17,1,0,1,6,0,5,5,3.0
379,2011-01-17,1,0,1,7,4,9,13,6.333333333333333
380,2011-01-17,1,0,1,8,3,30,33,17.0
381,2011-01-17,1,0,1,9,8,39,47,31.0
382,2011-01-17,1,0,1,10,7,50,57,45.666666666666664
383,2011-01-17,1,0,1,11,9,55,64,56.0
384,2011-01-17,1,0,1,12,10,70,80,67.0
385,2011-01-17,1,0,1,13,13,80,93,79.0
386,2011-01-17,1,0,1,14,12,74,86,86.33333333333333
387,2011-01-17,1,0,1,15,21,72,93,90.66666666666667
388,2011-01-17,1,0,1,16,6,76,82,87.0
389,2011-01-17,1,0,1,17,4,67,71,82.0
390,2011-01-17,1,0,1,18,7,85,92,81.66666666666667
391,2011-01-17,1,0,1,19,2,58,60,74.33333333333333
392,2011-01-17,1,0,1,20,4,29,33,61.666666666666664
393,2011-01-17,1,0,1,21,3,24,27,40.0
394,2011-01-17,1,0,1,22,0,13,13,24.333333333333332
395,2011-01-17,1,0,1,23,1,3,4,14.666666666666666
396,2011-01-18,1,0,1,12,0,3,3,6.666666666666667
397,2011-01-18,1,0,1,13,0,22,22,9.666666666666666
398,2011-01-18,1,0,1,14,2,26,28,17.666666666666668
399,2011-01-18,1,0,1,15,3,32,35,28.333333333333332
400,2011-01-18,1,0,1,16,0,61,61,41.333333333333336
401,2011-01-18,1,0,1,17,1,124,125,73.66666666666667
402,2011-01-18,1,0,1,18,1,132,133,106.33333333333333
403,2011-01-18,1,0,1,19,1,98,99,119.0
404,2011-01-18,1,0,1,20,0,83,83,105.0
405,2011-01-18,1,0,1,21,0,41,41,74.33333333333333
406,2011-01-18,1,0,1,22,0,33,33,52.333333333333336
407,2011-01-18,1,0,1,23,1,19,20,31.333333333333332
408,2011-01-19,1,0,1,0,0,3,3,18.666666666666668
409,2011-01-19,1,0,1,1,1,6,7,10.0
410,2011-01-19,1,0,1,2,0,3,3,4.333333333333333
411,2011-01-19,1,0,1,4,1,1,2,4.0
412,2011-01-19,1,0,1,5,0,7,7,4.0
413,2011-01-19,1,0,1,6,0,32,32,13.666666666666666
414,2011-01-19,1,0,1,7,1,89,90,43.0
415,2011-01-19,1,0,1,8,1,196,197,106.33333333333333
416,2011-01-19,1,0,1,9,2,107,109,132.0
417,2011-01-19,1,0,1,10,1,46,47,117.66666666666667
418,2011-01-19,1,0,1,11,5,47,52,69.33333333333333
419,2011-01-19,1,0,1,12,5,65,70,56.333333333333336
420,2011-01-19,1,0,1,13,11,67,78,66.66666666666667
421,2011-01-19,1,0,1,14,7,68,75,74.33333333333333
422,2011-01-19,1,0,1,15,4,78,82,78.33333333333333
423,2011-01-19,1,0,1,16,10,94,104,87.0
424,2011-01-19,1,0,1,17,7,190,197,127.66666666666667
425,2011-01-19,1,0,1,18,5,156,161,154.0
426,2011-01-19,1,0,1,19,4,108,112,156.66666666666666
427,2011-01-19,1,0,1,20,2,74,76,116.33333333333333
428,2011-01-19,1,0,1,21,4,55,59,82.33333333333333
429,2011-01-19,1,0,1,22,6,53,59,64.66666666666667
430,2011-01-19,1,0,1,23,1,27,28,48.666666666666664
431,2011-01-20,1,0,1,0,5,8,13,33.333333333333336
432,2011-01-20,1,0,1,1,2,3,5,15.333333333333334
433,2011-01-20,1,0,1,2,0,2,2,6.666666666666667
434,2011-01-20,1,0,1,3,0,1,1,2.6666666666666665
435,2011-01-20,1,0,1,4,0,1,1,1.3333333333333333
436,2011-01-20,1,0,1,5,0,6,6,2.6666666666666665
437,2011-01-20,1,0,1,6,0,35,35,14.0
438,2011-01-20,1,0,1,7,1,100,101,47.333333333333336
439,2011-01-20,1,0,1,8,2,247,249,128.33333333333334
440,2011-01-20,1,0,1,9,3,140,143,164.33333333333334
441,2011-01-20,1,0,1,10,1,56,57,149.66666666666666
442,2011-01-20,1,0,1,11,5,63,68,89.33333333333333
443,2011-01-20,1,0,1,12,7,77,84,69.66666666666667
444,2011-01-20,1,0,1,13,12,86,98,83.33333333333333
445,2011-01-20,1,0,1,14,6,75,81,87.66666666666667
446,2011-01-20,1,0,1,15,8,62,70,83.0
447,2011-01-20,1,0,1,16,8,83,91,80.66666666666667
448,2011-01-20,1,0,1,17,8,207,215,125.33333333333333
449,2011-01-20,1,0,1,18,1,184,185,163.66666666666666
450,2011-01-20,1,0,1,19,6,146,152,184.0
451,2011-01-20,1,0,1,20,2,124,126,154.33333333333334
452,2011-01-20,1,0,1,21,3,54,57,111.66666666666667
453,2011-01-20,1,0,1,22,0,56,56,79.66666666666667
454,2011-01-20,1,0,1,23,3,28,31,48.0
455,2011-01-21,1,0,1,0,1,20,21,36.0
456,2011-01-21,1,0,1,1,0,6,6,19.333333333333332
457,2011-01-21,1,0,1,2,0,2,2,9.666666666666666
458,2011-01-21,1,0,1,3,0,1,1,3.0
459,2011-01-21,1,0,1,4,0,1,1,1.3333333333333333
460,2011-01-21,1,0,1,5,1,4,5,2.3333333333333335
461,2011-01-21,1,0,1,6,0,27,27,11.0
462,2011-01-21,1,0,1,7,2,66,68,33.333333333333336
463,2011-01-21,1,0,1,8,7,210,217,104.0
464,2011-01-21,1,0,1,9,7,159,166,150.33333333333334
465,2011-01-21,1,0,1,10,6,57,63,148.66666666666666
466,2011-01-21,1,0,1,11,6,53,59,96.0
467,2011-01-21,1,0,1,12,11,67,78,66.66666666666667
468,2011-01-21,1,0,1,13,8,65,73,70.0
469,2011-01-21,1,0,1,14,6,56,62,71.0
470,2011-01-21,1,0,1,15,4,61,65,66.66666666666667
471,2011-01-21,1,0,1,16,0,97,97,74.66666666666667
472,2011-01-21,1,0,1,17,10,151,161,107.66666666666667
473,2011-01-21,1,0,1,18,1,119,120,126.0
474,2011-01-21,1,0,1,19,3,93,96,125.66666666666667
475,2011-01-21,1,0,1,20,1,52,53,89.66666666666667
476,2011-01-21,1,0,1,21,0,41,41,63.333333333333336
477,2011-01-21,1,0,1,22,1,33,34,42.666666666666664
478,2011-01-21,1,0,1,23,0,27,27,34.0
479,2011-01-22,1,0,1,0,0,13,13,24.666666666666668
480,2011-01-22,1,0,1,1,3,9,12,17.333333333333332
481,2011-01-22,1,0,1,2,0,11,11,12.0
482,2011-01-22,1,0,1,3,1,6,7,10.0
483,2011-01-22,1,0,1,4,0,3,3,7.0
484,2011-01-22,1,0,1,6,0,2,2,4.0
485,2011-01-22,1,0,1,7,0,8,8,4.333333333333333
486,2011-01-22,1,0,1,8,1,26,27,12.333333333333334
487,2011-01-22,1,0,1,9,3,37,40,25.0
488,2011-01-22,1,0,1,10,3,50,53,40.0
489,2011-01-22,1,0,1,11,4,59,63,52.0
490,2011-01-22,1,0,1,12,10,60,70,62.0
491,2011-01-22,1,0,1,13,12,72,84,72.33333333333333
492,2011-01-22,1,0,1,14,11,64,75,76.33333333333333
493,2011-01-22,1,0,1,15,10,93,103,87.33333333333333
494,2011-01-22,1,0,1,16,11,72,83,87.0
495,2011-01-22,1,0,1,17,8,59,67,84.33333333333333
496,2011-01-22,1,0,1,18,0,54,54,68.0
497,2011-01-22,1,0,1,19,6,53,59,60.0
498,2011-01-22,1,0,1,20,1,44,45,52.666666666666664
499,2011-01-22,1,0,1,21,0,39,39,47.666666666666664
500,2011-01-22,1,0,1,22,7,23,30,38.0
501,2011-01-22,1,0,1,23,2,31,33,34.0
502,2011-01-23,1,0,1,0,2,20,22,28.333333333333332
503,2011-01-23,1,0,1,1,1,12,13,22.666666666666668
504,2011-01-23,1,0,1,2,3,15,18,17.666666666666668
505,2011-01-23,1,0,1,3,1,4,5,12.0
506,2011-01-23,1,0,1,5,0,3,3,8.666666666666666
507,2011-01-23,1,0,1,6,0,1,1,3.0
508,2011-01-23,1,0,1,7,1,1,2,2.0
509,2011-01-23,1,0,1,8,2,17,19,7.333333333333333
510,2011-01-23,1,0,1,9,3,25,28,16.333333333333332
511,2011-01-23,1,0,1,10,7,51,58,35.0
512,2011-01-23,1,0,1,11,22,77,99,61.666666666666664
513,2011-01-23,1,0,1,12,24,92,116,91.0
514,2011-01-23,1,0,1,13,12,75,87,100.66666666666667
515,2011-01-23,1,0,1,14,17,93,110,104.33333333333333
516,2011-01-23,1,0,1,15,13,64,77,91.33333333333333
517,2011-01-23,1,0,1,16,9,56,65,84.0
518,2011-01-23,1,0,1,17,5,50,55,65.66666666666667
519,2011-01-23,1,0,1,18,5,44,49,56.333333333333336
520,2011-01-23,1,0,1,19,5,45,50,51.333333333333336
521,2011-01-23,1,0,1,20,4,31,35,44.666666666666664
522,2011-01-23,1,0,1,21,5,20,25,36.666666666666664
523,2011-01-23,1,0,1,22,5,23,28,29.333333333333332
524,2011-01-23,1,0,1,23,4,17,21,24.666666666666668
525,2011-01-24,1,0,1,0,0,7,7,18.666666666666668
526,2011-01-24,1,0,1,1,0,1,1,9.666666666666666
527,2011-01-24,1,0,1,3,0,1,1,3.0
528,2011-01-24,1,0,1,4,0,1,1,1.0
529,2011-01-24,1,0,1,5,0,5,5,2.3333333333333335
530,2011-01-24,1,0,1,6,0,15,15,7.0
531,2011-01-24,1,0,1,7,5,79,84,34.666666666666664
532,2011-01-24,1,0,1,8,6,171,177,92.0
533,2011-01-24,1,0,1,9,4,98,102,121.0
534,2011-01-24,1,0,1,10,6,34,40,106.33333333333333
535,2011-01-24,1,0,1,11,3,43,46,62.666666666666664
536,2011-01-24,1,0,1,12,11,52,63,49.666666666666664
537,2011-01-24,1,0,1,13,6,54,60,56.333333333333336
538,2011-01-24,1,0,1,14,2,43,45,56.0
539,2011-01-24,1,0,1,15,7,50,57,54.0
540,2011-01-24,1,0,1,16,4,66,70,57.333333333333336
541,2011-01-24,1,0,1,17,6,178,184,103.66666666666667
542,2011-01-24,1,0,1,18,8,145,153,135.66666666666666
543,2011-01-24,1,0,1,19,5,101,106,147.66666666666666
544,2011-01-24,1,0,1,20,1,80,81,113.33333333333333
545,2011-01-24,1,0,1,21,6,53,59,82.0
546,2011-01-24,1,0,1,22,3,32,35,58.333333333333336
547,2011-01-24,1,0,1,23,3,21,24,39.333333333333336
548,2011-01-25,1,0,1,0,3,6,9,22.666666666666668
549,2011-01-25,1,0,1,1,0,5,5,12.666666666666666
550,2011-01-25,1,0,1,2,0,2,2,5.333333333333333
551,2011-01-25,1,0,1,4,0,1,1,2.6666666666666665
552,2011-01-25,1,0,1,5,0,9,9,4.0
553,2011-01-25,1,0,1,6,1,35,36,15.333333333333334
554,2011-01-25,1,0,1,7,5,103,108,51.0
555,2011-01-25,1,0,1,8,5,233,238,127.33333333333333
556,2011-01-25,1,0,1,9,10,134,144,163.33333333333334
557,2011-01-25,1,0,1,10,6,49,55,145.66666666666666
558,2011-01-25,1,0,1,11,6,55,61,86.66666666666667
559,2011-01-25,1,0,1,12,21,85,106,74.0
560,2011-01-25,1,0,1,13,21,72,93,86.66666666666667
561,2011-01-25,1,0,1,14,11,57,68,89.0
562,2011-01-25,1,0,1,15,21,63,84,81.66666666666667
563,2011-01-25,1,0,1,16,14,102,116,89.33333333333333
564,2011-01-25,1,0,1,17,14,208,222,140.66666666666666
565,2011-01-25,1,0,1,18,7,218,225,187.66666666666666
566,2011-01-25,1,0,1,19,13,133,146,197.66666666666666
567,2011-01-25,1,0,1,20,16,103,119,163.33333333333334
568,2011-01-25,1,0,1,21,5,40,45,103.33333333333333
569,2011-01-25,1,0,1,22,4,49,53,72.33333333333333
570,2011-01-25,1,0,1,23,3,37,40,46.0
571,2011-01-26,1,0,1,0,3,14,17,36.666666666666664
572,2011-01-26,1,0,1,1,0,5,5,20.666666666666668
573,2011-01-26,1,0,1,2,3,7,10,10.666666666666666
574,2011-01-26,1,0,1,5,0,1,1,5.333333333333333
575,2011-01-26,1,0,1,6,0,8,8,6.333333333333333
576,2011-01-26,1,0,1,7,1,29,30,13.0
577,2011-01-26,1,0,1,8,3,69,72,36.666666666666664
578,2011-01-26,1,0,1,9,3,55,58,53.333333333333336
579,2011-01-26,1,0,1,10,2,26,28,52.666666666666664
580,2011-01-26,1,0,1,11,6,35,41,42.333333333333336
581,2011-01-26,1,0,1,12,7,41,48,39.0
582,2011-01-26,1,0,1,13,4,43,47,45.333333333333336
583,2011-01-26,1,0,1,14,0,36,36,43.666666666666664
584,2011-01-26,1,0,1,15,1,42,43,42.0
585,2011-01-26,1,0,1,16,1,35,36,38.333333333333336
586,2011-01-26,1,0,1,17,0,26,26,35.0
587,2011-01-27,1,0,1,16,1,23,24,28.666666666666668
588,2011-01-27,1,0,1,17,2,82,84,44.666666666666664
589,2011-01-27,1,0,1,18,3,101,104,70.66666666666667
590,2011-01-27,1,0,1,19,3,76,79,89.0
591,2011-01-27,1,0,1,20,4,55,59,80.66666666666667
592,2011-01-27,1,0,1,21,2,36,38,58.666666666666664
593,2011-01-27,1,0,1,22,0,27,27,41.333333333333336
594,2011-01-27,1,0,1,23,0,16,16,27.0
595,2011-01-28,1,0,1,0,0,9,9,17.333333333333332
596,2011-01-28,1,0,1,1,1,2,3,9.333333333333334
597,2011-01-28,1,0,1,2,0,2,2,4.666666666666667
598,2011-01-28,1,0,1,3,1,0,1,2.0
599,2011-01-28,1,0,1,5,0,4,4,2.3333333333333335
600,2011-01-28,1,0,1,6,0,16,16,7.0
601,2011-01-28,1,0,1,7,2,58,60,26.666666666666668
602,2011-01-28,1,0,1,8,2,155,157,77.66666666666667
603,2011-01-28,1,0,1,9,6,95,101,106.0
604,2011-01-28,1,0,1,10,0,49,49,102.33333333333333
605,2011-01-28,1,0,1,11,0,30,30,60.0
606,2011-01-28,1,0,1,12,1,28,29,36.0
607,2011-01-28,1,0,1,13,0,31,31,30.0
608,2011-01-28,1,0,1,14,2,36,38,32.666666666666664
609,2011-01-28,1,0,1,15,1,40,41,36.666666666666664
610,2011-01-28,1,0,1,16,10,70,80,53.0
611,2011-01-28,1,0,1,17,2,147,149,90.0
612,2011-01-28,1,0,1,18,2,107,109,112.66666666666667
613,2011-01-28,1,0,1,19,5,84,89,115.66666666666667
614,2011-01-28,1,0,1,20,1,61,62,86.66666666666667
615,2011-01-28,1,0,1,21,1,57,58,69.66666666666667
616,2011-01-28,1,0,1,22,0,26,26,48.666666666666664
617,2011-01-28,1,0,1,23,1,22,23,35.666666666666664
618,2011-01-29,1,0,1,0,2,26,28,25.666666666666668
619,2011-01-29,1,0,1,1,0,20,20,23.666666666666668
620,2011-01-29,1,0,1,2,0,15,15,21.0
621,2011-01-29,1,0,1,3,3,5,8,14.333333333333334
622,2011-01-29,1,0,1,4,1,2,3,8.666666666666666
623,2011-01-29,1,0,1,6,0,2,2,4.333333333333333
624,2011-01-29,1,0,1,7,1,4,5,3.3333333333333335
625,2011-01-29,1,0,1,8,3,31,34,13.666666666666666
626,2011-01-29,1,0,1,9,0,34,34,24.333333333333332
627,2011-01-29,1,0,1,10,4,51,55,41.0
628,2011-01-29,1,0,1,11,4,60,64,51.0
629,2011-01-29,1,0,1,12,12,66,78,65.66666666666667
630,2011-01-29,1,0,1,13,9,56,65,69.0
631,2011-01-29,1,0,1,14,10,89,99,80.66666666666667
632,2011-01-29,1,0,1,15,22,98,120,94.66666666666667
633,2011-01-29,1,0,1,16,19,88,107,108.66666666666667
634,2011-01-29,1,0,1,17,9,82,91,106.0
635,2011-01-29,1,0,1,18,9,59,68,88.66666666666667
636,2011-01-29,1,0,1,19,6,52,58,72.33333333333333
637,2011-01-29,1,0,1,20,1,42,43,56.333333333333336
638,2011-01-29,1,0,1,21,1,35,36,45.666666666666664
639,2011-01-29,1,0,1,22,4,28,32,37.0
640,2011-01-29,1,0,1,23,3,30,33,33.666666666666664
641,2011-01-30,1,0,1,0,0,33,33,32.666666666666664
642,2011-01-30,1,0,1,1,7,22,29,31.666666666666668
643,2011-01-30,1,0,1,2,1,10,11,24.333333333333332
644,2011-01-30,1,0,1,3,1,7,8,16.0
645,2011-01-30,1,0,1,4,0,1,1,6.666666666666667
646,2011-01-30,1,0,1,5,0,3,3,4.0
647,2011-01-30,1,0,1,7,0,3,3,2.3333333333333335
648,2011-01-30,1,0,1,8,1,11,12,6.0
649,2011-01-30,1,0,1,9,4,34,38,17.666666666666668
650,2011-01-30,1,0,1,10,7,57,64,38.0
651,2011-01-30,1,0,1,11,9,50,59,53.666666666666664
652,2011-01-30,1,0,1,12,10,87,97,73.33333333333333
653,2011-01-30,1,0,1,13,13,71,84,80.0
654,2011-01-30,1,0,1,14,18,104,122,101.0
655,2011-01-30,1,0,1,15,14,95,109,105.0
656,2011-01-30,1,0,1,16,19,104,123,118.0
657,2011-01-30,1,0,1,17,6,71,77,103.0
658,2011-01-30,1,0,1,18,8,57,65,88.33333333333333
659,2011-01-30,1,0,1,19,9,46,55,65.66666666666667
660,2011-01-30,1,0,1,20,3,30,33,51.0
661,2011-01-30,1,0,1,21,3,25,28,38.666666666666664
662,2011-01-30,1,0,1,22,2,19,21,27.333333333333332
663,2011-01-30,1,0,1,23,5,16,21,23.333333333333332
664,2011-01-31,1,0,1,0,1,6,7,16.333333333333332
665,2011-01-31,1,0,1,1,2,5,7,11.666666666666666
666,2011-01-31,1,0,1,2,0,1,1,5.0
667,2011-01-31,1,0,1,3,0,2,2,3.3333333333333335
668,2011-01-31,1,0,1,4,0,2,2,1.6666666666666667
669,2011-01-31,1,0,1,5,0,8,8,4.0
670,2011-01-31,1,0,1,6,0,37,37,15.666666666666666
671,2011-01-31,1,0,1,7,1,71,72,39.0
672,2011-01-31,1,0,1,8,3,182,185,98.0
673,2011-01-31,1,0,1,9,0,112,112,123.0
674,2011-01-31,1,0,1,10,1,68,69,122.0
675,2011-01-31,1,0,1,11,2,46,48,76.33333333333333
676,2011-01-31,1,0,1,12,6,62,68,61.666666666666664
677,2011-01-31,1,0,1,13,2,52,54,56.666666666666664
678,2011-01-31,1,0,1,14,1,85,86,69.33333333333333
679,2011-01-31,1,0,1,15,3,41,44,61.333333333333336
680,2011-01-31,1,0,1,16,3,83,86,72.0
681,2011-01-31,1,0,1,17,6,155,161,97.0
682,2011-01-31,1,0,1,18,3,153,156,134.33333333333334
683,2011-01-31,1,0,1,19,3,108,111,142.66666666666666
684,2011-01-31,1,0,1,20,0,78,78,115.0
685,2011-01-31,1,0,1,21,3,53,56,81.66666666666667
686,2011-01-31,1,0,1,22,0,34,34,56.0
687,2011-01-31,1,0,1,23,2,15,17,35.666666666666664
688,2011-02-01,1,0,2,0,2,6,8,19.666666666666668
689,2011-02-01,1,0,2,1,0,3,3,9.333333333333334
690,2011-02-01,1,0,2,2,0,2,2,4.333333333333333
691,2011-02-01,1,0,2,3,0,2,2,2.3333333333333335
692,2011-02-01,1,0,2,5,0,3,3,2.3333333333333335
693,2011-02-01,1,0,2,6,0,22,22,9.0
694,2011-02-01,1,0,2,7,0,52,52,25.666666666666668
695,2011-02-01,1,0,2,8,3,132,135,69.66666666666667
696,2011-02-01,1,0,2,9,2,114,116,101.0
697,2011-02-01,1,0,2,10,0,47,47,99.33333333333333
698,2011-02-01,1,0,2,11,2,49,51,71.33333333333333
699,2011-02-01,1,0,2,12,2,53,55,51.0
700,2011-02-01,1,0,2,13,3,49,52,52.666666666666664
701,2011-02-01,1,0,2,14,5,49,54,53.666666666666664
702,2011-02-01,1,0,2,15,7,45,52,52.666666666666664
703,2011-02-01,1,0,2,16,3,61,64,56.666666666666664
704,2011-02-01,1,0,2,17,4,172,176,97.33333333333333
705,2011-02-01,1,0,2,18,3,165,168,136.0
706,2011-02-01,1,0,2,19,3,105,108,150.66666666666666
707,2011-02-01,1,0,2,20,5,69,74,116.66666666666667
708,2011-02-01,1,0,2,21,0,64,64,82.0
709,2011-02-01,1,0,2,22,2,34,36,58.0
710,2011-02-01,1,0,2,23,1,15,16,38.666666666666664
711,2011-02-02,1,0,2,0,0,2,2,18.0
712,2011-02-02,1,0,2,1,0,3,3,7.0
713,2011-02-02,1,0,2,2,4,0,4,3.0
714,2011-02-02,1,0,2,3,0,1,1,2.6666666666666665
715,2011-02-02,1,0,2,4,0,1,1,2.0
716,2011-02-02,1,0,2,5,0,3,3,1.6666666666666667
717,2011-02-02,1,0,2,6,1,17,18,7.333333333333333
718,2011-02-02,1,0,2,7,1,48,49,23.333333333333332
719,2011-02-02,1,0,2,8,1,154,155,74.0
720,2011-02-02,1,0,2,9,4,119,123,109.0
721,2011-02-02,1,0,2,10,2,59,61,113.0
722,2011-02-02,1,0,2,11,5,47,52,78.66666666666667
723,2011-02-02,1,0,2,12,3,61,64,59.0
724,2011-02-02,1,0,2,13,1,74,75,63.666666666666664
725,2011-02-02,1,0,2,14,2,61,63,67.33333333333333
726,2011-02-02,1,0,2,15,10,66,76,71.33333333333333
727,2011-02-02,1,0,2,16,8,95,103,80.66666666666667
728,2011-02-02,1,0,2,17,7,183,190,123.0
729,2011-02-02,1,0,2,18,7,175,182,158.33333333333334
730,2011-02-02,1,0,2,19,3,88,91,154.33333333333334
731,2011-02-02,1,0,2,20,4,71,75,116.0
732,2011-02-02,1,0,2,21,1,62,63,76.33333333333333
733,2011-02-02,1,0,2,22,5,35,40,59.333333333333336
734,2011-02-02,1,0,2,23,3,29,32,45.0
735,2011-02-03,1,0,2,0,1,11,12,28.0
736,2011-02-03,1,0,2,1,0,5,5,16.333333333333332
737,2011-02-03,1,0,2,2,0,2,2,6.333333333333333
738,2011-02-03,1,0,2,3,0,1,1,2.6666666666666665
739,2011-02-03,1,0,2,5,0,2,2,1.6666666666666667
740,2011-02-03,1,0,2,6,0,39,39,14.0
741,2011-02-03,1,0,2,7,1,86,87,42.666666666666664
742,2011-02-03,1,0,2,8,4,184,188,104.66666666666667
743,2011-02-03,1,0,2,9,6,127,133,136.0
744,2011-02-03,1,0,2,10,2,50,52,124.33333333333333
745,2011-02-03,1,0,2,11,9,55,64,83.0
746,2011-02-03,1,0,2,12,2,67,69,61.666666666666664
747,2011-02-03,1,0,2,13,4,47,51,61.333333333333336
748,2011-02-03,1,0,2,14,4,43,47,55.666666666666664
749,2011-02-03,1,0,2,15,4,56,60,52.666666666666664
750,2011-02-03,1,0,2,16,5,73,78,61.666666666666664
751,2011-02-03,1,0,2,17,5,170,175,104.33333333333333
752,2011-02-03,1,0,2,18,2,145,147,133.33333333333334
753,2011-02-03,1,0,2,19,4,92,96,139.33333333333334
754,2011-02-03,1,0,2,20,1,108,109,117.33333333333333
755,2011-02-03,1,0,2,21,1,53,54,86.33333333333333
756,2011-02-03,1,0,2,22,2,39,41,68.0
757,2011-02-03,1,0,2,23,4,34,38,44.333333333333336
758,2011-02-04,1,0,2,0,3,10,13,30.666666666666668
759,2011-02-04,1,0,2,1,0,7,7,19.333333333333332
760,2011-02-04,1,0,2,2,0,1,1,7.0
761,2011-02-04,1,0,2,3,0,1,1,3.0
762,2011-02-04,1,0,2,5,0,7,7,3.0
763,2011-02-04,1,0,2,6,2,26,28,12.0
764,2011-02-04,1,0,2,7,0,87,87,40.666666666666664
765,2011-02-04,1,0,2,8,3,217,220,111.66666666666667
766,2011-02-04,1,0,2,9,3,124,127,144.66666666666666
767,2011-02-04,1,0,2,10,5,46,51,132.66666666666666
768,2011-02-04,1,0,2,11,3,61,64,80.66666666666667
769,2011-02-04,1,0,2,12,8,78,86,67.0
770,2011-02-04,1,0,2,13,9,73,82,77.33333333333333
771,2011-02-04,1,0,2,14,15,76,91,86.33333333333333
772,2011-02-04,1,0,2,15,9,81,90,87.66666666666667
773,2011-02-04,1,0,2,16,8,91,99,93.33333333333333
774,2011-02-04,1,0,2,17,10,195,205,131.33333333333334
775,2011-02-04,1,0,2,18,3,152,155,153.0
776,2011-02-04,1,0,2,19,1,102,103,154.33333333333334
777,2011-02-04,1,0,2,20,2,69,71,109.66666666666667
778,2011-02-04,1,0,2,21,2,41,43,72.33333333333333
779,2011-02-04,1,0,2,22,1,45,46,53.333333333333336
780,2011-02-04,1,0,2,23,1,30,31,40.0
781,2011-02-05,1,0,2,0,3,36,39,38.666666666666664
782,2011-02-05,1,0,2,1,1,17,18,29.333333333333332
783,2011-02-05,1,0,2,2,5,12,17,24.666666666666668
784,2011-02-05,1,0,2,3,1,10,11,15.333333333333334
785,2011-02-05,1,0,2,4,0,8,8,12.0
786,2011-02-05,1,0,2,5,0,9,9,9.333333333333334
787,2011-02-05,1,0,2,6,0,4,4,7.0
788,2011-02-05,1,0,2,7,0,4,4,5.666666666666667
789,2011-02-05,1,0,2,8,0,10,10,6.0
790,2011-02-05,1,0,2,9,3,17,20,11.333333333333334
791,2011-02-05,1,0,2,10,3,31,34,21.333333333333332
792,2011-02-05,1,0,2,11,1,46,47,33.666666666666664
793,2011-02-05,1,0,2,12,10,42,52,44.333333333333336
794,2011-02-05,1,0,2,13,10,62,72,57.0
795,2011-02-05,1,0,2,14,5,50,55,59.666666666666664
796,2011-02-05,1,0,2,15,11,49,60,62.333333333333336
797,2011-02-05,1,0,2,16,8,63,71,62.0
798,2011-02-05,1,0,2,17,14,64,78,69.66666666666667
799,2011-02-05,1,0,2,18,2,81,83,77.33333333333333
800,2011-02-05,1,0,2,19,6,78,84,81.66666666666667
801,2011-02-05,1,0,2,20,5,64,69,78.66666666666667
802,2011-02-05,1,0,2,21,3,53,56,69.66666666666667
803,2011-02-05,1,0,2,22,2,43,45,56.666666666666664
804,2011-02-05,1,0,2,23,7,52,59,53.333333333333336
805,2011-02-06,1,0,2,0,2,37,39,47.666666666666664
806,2011-02-06,1,0,2,1,4,40,44,47.333333333333336
807,2011-02-06,1,0,2,2,0,20,20,34.333333333333336
808,2011-02-06,1,0,2,3,3,10,13,25.666666666666668
809,2011-02-06,1,0,2,4,0,2,2,11.666666666666666
810,2011-02-06,1,0,2,5,0,1,1,5.333333333333333
811,2011-02-06,1,0,2,6,0,1,1,1.3333333333333333
812,2011-02-06,1,0,2,7,0,8,8,3.3333333333333335
813,2011-02-06,1,0,2,8,2,21,23,10.666666666666666
814,2011-02-06,1,0,2,9,7,38,45,25.333333333333332
815,2011-02-06,1,0,2,10,15,74,89,52.333333333333336
816,2011-02-06,1,0,2,11,28,89,117,83.66666666666667
817,2011-02-06,1,0,2,12,48,126,174,126.66666666666667
818,2011-02-06,1,0,2,13,47,135,182,157.66666666666666
819,2011-02-06,1,0,2,14,47,114,161,172.33333333333334
820,2011-02-06,1,0,2,15,52,130,182,175.0
821,2011-02-06,1,0,2,16,42,115,157,166.66666666666666
822,2011-02-06,1,0,2,17,24,97,121,153.33333333333334
823,2011-02-06,1,0,2,18,13,65,78,118.66666666666667
824,2011-02-06,1,0,2,19,1,20,21,73.33333333333333
825,2011-02-06,1,0,2,20,5,21,26,41.666666666666664
826,2011-02-06,1,0,2,21,5,22,27,24.666666666666668
827,2011-02-06,1,0,2,22,5,57,62,38.333333333333336
828,2011-02-06,1,0,2,23,4,26,30,39.666666666666664
829,2011-02-07,1,0,2,0,1,14,15,35.666666666666664
830,2011-02-07,1,0,2,1,1,4,5,16.666666666666668
831,2011-02-07,1,0,2,2,0,3,3,7.666666666666667
832,2011-02-07,1,0,2,3,0,1,1,3.0
833,2011-02-07,1,0,2,4,1,1,2,2.0
834,2011-02-07,1,0,2,5,1,9,10,4.333333333333333
835,2011-02-07,1,0,2,6,1,29,30,14.0
836,2011-02-07,1,0,2,7,6,89,95,45.0
837,2011-02-07,1,0,2,8,7,223,230,118.33333333333333
838,2011-02-07,1,0,2,9,3,115,118,147.66666666666666
839,2011-02-07,1,0,2,10,6,49,55,134.33333333333334
840,2011-02-07,1,0,2,11,11,36,47,73.33333333333333
841,2011-02-07,1,0,2,12,7,59,66,56.0
842,2011-02-07,1,0,2,13,10,54,64,59.0
843,2011-02-07,1,0,2,14,8,52,60,63.333333333333336
844,2011-02-07,1,0,2,15,4,46,50,58.0
845,2011-02-07,1,0,2,16,16,98,114,74.66666666666667
846,2011-02-07,1,0,2,17,9,207,216,126.66666666666667
847,2011-02-07,1,0,2,18,5,170,175,168.33333333333334
848,2011-02-07,1,0,2,19,5,123,128,173.0
849,2011-02-07,1,0,2,20,6,82,88,130.33333333333334
850,2011-02-07,1,0,2,21,3,75,78,98.0
851,2011-02-07,1,0,2,22,3,34,37,67.66666666666667
852,2011-02-07,1,0,2,23,6,19,25,46.666666666666664
853,2011-02-08,1,0,2,0,4,6,10,24.0
854,2011-02-08,1,0,2,1,0,4,4,13.0
855,2011-02-08,1,0,2,2,1,1,2,5.333333333333333
856,2011-02-08,1,0,2,3,0,1,1,2.3333333333333335
857,2011-02-08,1,0,2,4,0,3,3,2.0
858,2011-02-08,1,0,2,5,0,2,2,2.0
859,2011-02-08,1,0,2,6,0,39,39,14.666666666666666
860,2011-02-08,1,0,2,7,3,97,100,47.0
861,2011-02-08,1,0,2,8,7,236,243,127.33333333333333
862,2011-02-08,1,0,2,9,7,128,135,159.33333333333334
863,2011-02-08,1,0,2,10,4,44,48,142.0
864,2011-02-08,1,0,2,11,1,49,50,77.66666666666667
865,2011-02-08,1,0,2,12,2,63,65,54.333333333333336
866,2011-02-08,1,0,2,13,2,48,50,55.0
867,2011-02-08,1,0,2,14,3,61,64,59.666666666666664
868,2011-02-08,1,0,2,15,6,45,51,55.0
869,2011-02-08,1,0,2,16,4,79,83,66.0
870,2011-02-08,1,0,2,17,4,172,176,103.33333333333333
871,2011-02-08,1,0,2,18,1,151,152,137.0
872,2011-02-08,1,0,2,19,1,100,101,143.0
873,2011-02-08,1,0,2,20,3,53,56,103.0
874,2011-02-08,1,0,2,21,8,46,54,70.33333333333333
875,2011-02-08,1,0,2,22,0,29,29,46.333333333333336
876,2011-02-08,1,0,2,23,3,9,12,31.666666666666668
877,2011-02-09,1,0,2,0,0,17,17,19.333333333333332
878,2011-02-09,1,0,2,1,0,7,7,12.0
879,2011-02-09,1,0,2,2,1,2,3,9.0
880,2011-02-09,1,0,2,3,0,2,2,4.0
881,2011-02-09,1,0,2,5,0,7,7,4.0
882,2011-02-09,1,0,2,6,0,43,43,17.333333333333332
883,2011-02-09,1,0,2,7,4,95,99,49.666666666666664
884,2011-02-09,1,0,2,8,1,198,199,113.66666666666667
885,2011-02-09,1,0,2,9,4,119,123,140.33333333333334
886,2011-02-09,1,0,2,10,8,51,59,127.0
887,2011-02-09,1,0,2,11,1,40,41,74.33333333333333
888,2011-02-09,1,0,2,12,4,57,61,53.666666666666664
889,2011-02-09,1,0,2,13,2,67,69,57.0
890,2011-02-09,1,0,2,14,2,56,58,62.666666666666664
891,2011-02-09,1,0,2,15,3,61,64,63.666666666666664
892,2011-02-09,1,0,2,16,7,72,79,67.0
893,2011-02-09,1,0,2,17,9,157,166,103.0
894,2011-02-09,1,0,2,18,2,168,170,138.33333333333334
895,2011-02-09,1,0,2,19,1,87,88,141.33333333333334
896,2011-02-09,1,0,2,20,0,84,84,114.0
897,2011-02-09,1,0,2,21,0,83,83,85.0
898,2011-02-09,1,0,2,22,4,42,46,71.0
899,2011-02-09,1,0,2,23,0,37,37,55.333333333333336
900,2011-02-10,1,0,2,0,0,16,16,33.0
901,2011-02-10,1,0,2,1,0,7,7,20.0
902,2011-02-10,1,0,2,2,0,3,3,8.666666666666666
903,2011-02-10,1,0,2,4,0,1,1,3.6666666666666665
904,2011-02-10,1,0,2,5,0,6,6,3.3333333333333335
905,2011-02-10,1,0,2,6,0,26,26,11.0
906,2011-02-10,1,0,2,7,0,99,99,43.666666666666664
907,2011-02-10,1,0,2,8,5,173,178,101.0
908,2011-02-10,1,0,2,9,1,121,122,133.0
909,2011-02-10,1,0,2,10,1,34,35,111.66666666666667
910,2011-02-10,1,0,2,11,1,44,45,67.33333333333333
911,2011-02-10,1,0,2,12,4,65,69,49.666666666666664
912,2011-02-10,1,0,2,13,3,59,62,58.666666666666664
913,2011-02-10,1,0,2,14,6,42,48,59.666666666666664
914,2011-02-10,1,0,2,15,0,50,50,53.333333333333336
915,2011-02-10,1,0,2,16,4,76,80,59.333333333333336
916,2011-02-10,1,0,2,17,6,159,165,98.33333333333333
917,2011-02-10,1,0,2,18,3,157,160,135.0
918,2011-02-10,1,0,2,19,2,110,112,145.66666666666666
919,2011-02-10,1,0,2,20,4,93,97,123.0
920,2011-02-10,1,0,2,21,2,70,72,93.66666666666667
921,2011-02-10,1,0,2,22,4,47,51,73.33333333333333
922,2011-02-10,1,0,2,23,1,33,34,52.333333333333336
923,2011-02-11,1,0,2,0,2,12,14,33.0
924,2011-02-11,1,0,2,1,1,6,7,18.333333333333332
925,2011-02-11,1,0,2,2,0,3,3,8.0
926,2011-02-11,1,0,2,5,0,4,4,4.666666666666667
927,2011-02-11,1,0,2,6,1,23,24,10.333333333333334
928,2011-02-11,1,0,2,7,1,73,74,34.0
929,2011-02-11,1,0,2,8,4,212,216,104.66666666666667
930,2011-02-11,1,0,2,9,8,132,140,143.33333333333334
931,2011-02-11,1,0,2,10,5,39,44,133.33333333333334
932,2011-02-11,1,0,2,11,12,52,64,82.66666666666667
933,2011-02-11,1,0,2,12,7,64,71,59.666666666666664
934,2011-02-11,1,0,2,13,21,89,110,81.66666666666667
935,2011-02-11,1,0,2,14,17,67,84,88.33333333333333
936,2011-02-11,1,0,2,15,12,62,74,89.33333333333333
937,2011-02-11,1,0,2,16,14,111,125,94.33333333333333
938,2011-02-11,1,0,2,17,18,193,211,136.66666666666666
939,2011-02-11,1,0,2,18,9,165,174,170.0
940,2011-02-11,1,0,2,19,7,94,101,162.0
941,2011-02-11,1,0,2,20,2,61,63,112.66666666666667
942,2011-02-11,1,0,2,21,1,46,47,70.33333333333333
943,2011-02-11,1,0,2,22,2,41,43,51.0
944,2011-02-11,1,0,2,23,5,48,53,47.666666666666664
945,2011-02-12,1,0,2,0,3,27,30,42.0
946,2011-02-12,1,0,2,1,2,22,24,35.666666666666664
947,2011-02-12,1,0,2,2,2,13,15,23.0
948,2011-02-12,1,0,2,3,3,7,10,16.333333333333332
949,2011-02-12,1,0,2,4,0,4,4,9.666666666666666
950,2011-02-12,1,0,2,5,0,1,1,5.0
951,2011-02-12,1,0,2,6,1,1,2,2.3333333333333335
952,2011-02-12,1,0,2,7,2,9,11,4.666666666666667
953,2011-02-12,1,0,2,8,2,28,30,14.333333333333334
954,2011-02-12,1,0,2,9,5,38,43,28.0
955,2011-02-12,1,0,2,10,13,71,84,52.333333333333336
956,2011-02-12,1,0,2,11,30,84,114,80.33333333333333
957,2011-02-12,1,0,2,12,27,93,120,106.0
958,2011-02-12,1,0,2,13,32,103,135,123.0
959,2011-02-12,1,0,2,14,30,90,120,125.0
960,2011-02-12,1,0,2,15,47,127,174,143.0
961,2011-02-12,1,0,2,16,42,103,145,146.33333333333334
962,2011-02-12,1,0,2,17,24,113,137,152.0
963,2011-02-12,1,0,2,18,4,60,64,115.33333333333333
964,2011-02-12,1,0,2,19,2,39,41,80.66666666666667
965,2011-02-12,1,0,2,20,1,39,40,48.333333333333336
966,2011-02-12,1,0,2,21,9,42,51,44.0
967,2011-02-12,1,0,2,22,6,39,45,45.333333333333336
968,2011-02-12,1,0,2,23,1,31,32,42.666666666666664
969,2011-02-13,1,0,2,0,5,34,39,38.666666666666664
970,2011-02-13,1,0,2,1,1,23,24,31.666666666666668
971,2011-02-13,1,0,2,2,1,19,20,27.666666666666668
972,2011-02-13,1,0,2,3,4,8,12,18.666666666666668
973,2011-02-13,1,0,2,4,0,2,2,11.333333333333334
974,2011-02-13,1,0,2,6,2,3,5,6.333333333333333
975,2011-02-13,1,0,2,7,0,3,3,3.3333333333333335
976,2011-02-13,1,0,2,8,1,11,12,6.666666666666667
977,2011-02-13,1,0,2,9,12,35,47,20.666666666666668
978,2011-02-13,1,0,2,10,19,86,105,54.666666666666664
979,2011-02-13,1,0,2,11,26,86,112,88.0
980,2011-02-13,1,0,2,12,58,94,152,123.0
981,2011-02-13,1,0,2,13,62,92,154,139.33333333333334
982,2011-02-13,1,0,2,14,51,110,161,155.66666666666666
983,2011-02-13,1,0,2,15,40,122,162,159.0
984,2011-02-13,1,0,2,16,28,106,134,152.33333333333334
985,2011-02-13,1,0,2,17,30,95,125,140.33333333333334
986,2011-02-13,1,0,2,18,17,78,95,118.0
987,2011-02-13,1,0,2,19,11,50,61,93.66666666666667
988,2011-02-13,1,0,2,20,15,32,47,67.66666666666667
989,2011-02-13,1,0,2,21,6,45,51,53.0
990,2011-02-13,1,0,2,22,5,31,36,44.666666666666664
991,2011-02-13,1,0,2,23,3,27,30,39.0
992,2011-02-14,1,0,2,0,3,8,11,25.666666666666668
993,2011-02-14,1,0,2,1,1,6,7,16.0
994,2011-02-14,1,0,2,2,0,2,2,6.666666666666667
995,2011-02-14,1,0,2,3,1,1,2,3.6666666666666665
996,2011-02-14,1,0,2,4,0,2,2,2.0
997,2011-02-14,1,0,2,5,0,3,3,2.3333333333333335
998,2011-02-14,1,0,2,6,1,25,26,10.333333333333334
999,2011-02-14,1,0,2,7,2,96,98,42.333333333333336
1000,2011-02-14,1,0,2,8,7,249,256,126.66666666666667
1001,2011-02-14,1,0,2,9,8,122,130,161.33333333333334
1002,2011-02-14,1,0,2,10,9,46,55,147.0
1003,2011-02-14,1,0,2,11,10,43,53,79.33333333333333
1004,2011-02-14,1,0,2,12,27,99,126,78.0
1005,2011-02-14,1,0,2,13,27,93,120,99.66666666666667
1006,2011-02-14,1,0,2,14,14,76,90,112.0
1007,2011-02-14,1,0,2,15,19,71,90,100.0
1008,2011-02-14,1,0,2,16,16,102,118,99.33333333333333
1009,2011-02-14,1,0,2,17,25,218,243,150.33333333333334
1010,2011-02-14,1,0,2,18,11,194,205,188.66666666666666
1011,2011-02-14,1,0,2,19,12,86,98,182.0
1012,2011-02-14,1,0,2,20,5,65,70,124.33333333333333
1013,2011-02-14,1,0,2,21,8,35,43,70.33333333333333
1014,2011-02-14,1,0,2,22,1,44,45,52.666666666666664
1015,2011-02-14,1,0,2,23,1,19,20,36.0
1016,2011-02-15,1,0,2,0,7,12,19,28.0
1017,2011-02-15,1,0,2,1,0,5,5,14.666666666666666
1018,2011-02-15,1,0,2,2,1,2,3,9.0
1019,2011-02-15,1,0,2,4,0,1,1,3.0
1020,2011-02-15,1,0,2,5,0,4,4,2.6666666666666665
1021,2011-02-15,1,0,2,6,0,30,30,11.666666666666666
1022,2011-02-15,1,0,2,7,2,103,105,46.333333333333336
1023,2011-02-15,1,0,2,8,10,213,223,119.33333333333333
1024,2011-02-15,1,0,2,9,2,108,110,146.0
1025,2011-02-15,1,0,2,10,5,47,52,128.33333333333334
1026,2011-02-15,1,0,2,11,11,46,57,73.0
1027,2011-02-15,1,0,2,12,6,65,71,60.0
1028,2011-02-15,1,0,2,13,14,68,82,70.0
1029,2011-02-15,1,0,2,14,10,69,79,77.33333333333333
1030,2011-02-15,1,0,2,15,11,74,85,82.0
1031,2011-02-15,1,0,2,16,21,77,98,87.33333333333333
1032,2011-02-15,1,0,2,17,15,191,206,129.66666666666666
1033,2011-02-15,1,0,2,18,14,198,212,172.0
1034,2011-02-15,1,0,2,19,3,142,145,187.66666666666666
1035,2011-02-15,1,0,2,20,3,98,101,152.66666666666666
1036,2011-02-15,1,0,2,21,5,61,66,104.0
1037,2011-02-15,1,0,2,22,0,41,41,69.33333333333333
1038,2011-02-15,1,0,2,23,0,20,20,42.333333333333336
1039,2011-02-16,1,0,2,0,0,15,15,25.333333333333332
1040,2011-02-16,1,0,2,1,0,9,9,14.666666666666666
1041,2011-02-16,1,0,2,3,0,1,1,8.333333333333334
1042,2011-02-16,1,0,2,4,0,1,1,3.6666666666666665
1043,2011-02-16,1,0,2,5,0,5,5,2.3333333333333335
1044,2011-02-16,1,0,2,6,1,32,33,13.0
1045,2011-02-16,1,0,2,7,5,103,108,48.666666666666664
1046,2011-02-16,1,0,2,8,6,224,230,123.66666666666667
1047,2011-02-16,1,0,2,9,2,122,124,154.0
1048,2011-02-16,1,0,2,10,14,55,69,141.0
1049,2011-02-16,1,0,2,11,7,59,66,86.33333333333333
1050,2011-02-16,1,0,2,12,14,72,86,73.66666666666667
1051,2011-02-16,1,0,2,13,13,80,93,81.66666666666667
1052,2011-02-16,1,0,2,14,17,65,82,87.0
1053,2011-02-16,1,0,2,15,35,82,117,97.33333333333333
1054,2011-02-16,1,0,2,16,26,96,122,107.0
1055,2011-02-16,1,0,2,17,11,244,255,164.66666666666666
1056,2011-02-16,1,0,2,18,20,202,222,199.66666666666666
1057,2011-02-16,1,0,2,19,18,143,161,212.66666666666666
1058,2011-02-16,1,0,2,20,10,108,118,167.0
1059,2011-02-16,1,0,2,21,5,87,92,123.66666666666667
1060,2011-02-16,1,0,2,22,12,61,73,94.33333333333333
1061,2011-02-16,1,0,2,23,2,31,33,66.0
1062,2011-02-17,1,0,2,0,1,16,17,41.0
1063,2011-02-17,1,0,2,1,0,6,6,18.666666666666668
1064,2011-02-17,1,0,2,2,2,4,6,9.666666666666666
1065,2011-02-17,1,0,2,3,3,1,4,5.333333333333333
1066,2011-02-17,1,0,2,4,3,1,4,4.666666666666667
1067,2011-02-17,1,0,2,5,1,11,12,6.666666666666667
1068,2011-02-17,1,0,2,6,3,44,47,21.0
1069,2011-02-17,1,0,2,7,7,119,126,61.666666666666664
1070,2011-02-17,1,0,2,8,18,267,285,152.66666666666666
1071,2011-02-17,1,0,2,9,16,163,179,196.66666666666666
1072,2011-02-17,1,0,2,10,18,70,88,184.0
1073,2011-02-17,1,0,2,11,19,71,90,119.0
1074,2011-02-17,1,0,2,12,15,86,101,93.0
1075,2011-02-17,1,0,2,13,15,108,123,104.66666666666667
1076,2011-02-17,1,0,2,14,26,55,81,101.66666666666667
1077,2011-02-17,1,0,2,15,15,91,106,103.33333333333333
1078,2011-02-17,1,0,2,16,29,117,146,111.0
1079,2011-02-17,1,0,2,17,18,256,274,175.33333333333334
1080,2011-02-17,1,0,2,18,11,211,222,214.0
1081,2011-02-17,1,0,2,19,14,161,175,223.66666666666666
1082,2011-02-17,1,0,2,20,8,131,139,178.66666666666666
1083,2011-02-17,1,0,2,21,5,119,124,146.0
1084,2011-02-17,1,0,2,22,8,68,76,113.0
1085,2011-02-17,1,0,2,23,4,40,44,81.33333333333333
1086,2011-02-18,1,0,2,0,12,20,32,50.666666666666664
1087,2011-02-18,1,0,2,1,1,7,8,28.0
1088,2011-02-18,1,0,2,2,2,5,7,15.666666666666666
1089,2011-02-18,1,0,2,3,2,6,8,7.666666666666667
1090,2011-02-18,1,0,2,4,0,1,1,5.333333333333333
1091,2011-02-18,1,0,2,5,1,6,7,5.333333333333333
1092,2011-02-18,1,0,2,6,2,48,50,19.333333333333332
1093,2011-02-18,1,0,2,7,8,108,116,57.666666666666664
1094,2011-02-18,1,0,2,8,26,246,272,146.0
1095,2011-02-18,1,0,2,9,15,154,169,185.66666666666666
1096,2011-02-18,1,0,2,10,17,78,95,178.66666666666666
1097,2011-02-18,1,0,2,11,31,82,113,125.66666666666667
1098,2011-02-18,1,0,2,12,59,126,185,131.0
1099,2011-02-18,1,0,2,13,45,131,176,158.0
1100,2011-02-18,1,0,2,14,73,118,191,184.0
1101,2011-02-18,1,0,2,15,55,117,172,179.66666666666666
1102,2011-02-18,1,0,2,16,68,164,232,198.33333333333334
1103,2011-02-18,1,0,2,17,52,275,327,243.66666666666666
1104,2011-02-18,1,0,2,18,29,195,224,261.0
1105,2011-02-18,1,0,2,19,16,146,162,237.66666666666666
1106,2011-02-18,1,0,2,20,19,105,124,170.0
1107,2011-02-18,1,0,2,21,11,61,72,119.33333333333333
1108,2011-02-18,1,0,2,22,19,88,107,101.0
1109,2011-02-18,1,0,2,23,16,61,77,85.33333333333333
1110,2011-02-19,1,0,2,0,6,23,29,71.0
1111,2011-02-19,1,0,2,1,10,21,31,45.666666666666664
1112,2011-02-19,1,0,2,2,3,14,17,25.666666666666668
1113,2011-02-19,1,0,2,3,0,7,7,18.333333333333332
1114,2011-02-19,1,0,2,4,0,3,3,9.0
1115,2011-02-19,1,0,2,5,0,3,3,4.333333333333333
1116,2011-02-19,1,0,2,6,3,3,6,4.0
1117,2011-02-19,1,0,2,7,6,16,22,10.333333333333334
1118,2011-02-19,1,0,2,8,9,36,45,24.333333333333332
1119,2011-02-19,1,0,2,9,18,37,55,40.666666666666664
1120,2011-02-19,1,0,2,10,34,72,106,68.66666666666667
1121,2011-02-19,1,0,2,11,47,76,123,94.66666666666667
1122,2011-02-19,1,0,2,12,38,81,119,116.0
1123,2011-02-19,1,0,2,13,52,103,155,132.33333333333334
1124,2011-02-19,1,0,2,14,102,94,196,156.66666666666666
1125,2011-02-19,1,0,2,15,84,87,171,174.0
1126,2011-02-19,1,0,2,16,39,81,120,162.33333333333334
1127,2011-02-19,1,0,2,17,36,91,127,139.33333333333334
1128,2011-02-19,1,0,2,18,21,67,88,111.66666666666667
1129,2011-02-19,1,0,2,19,5,54,59,91.33333333333333
1130,2011-02-19,1,0,2,20,9,38,47,64.66666666666667
1131,2011-02-19,1,0,2,21,4,29,33,46.333333333333336
1132,2011-02-19,1,0,2,22,2,42,44,41.333333333333336
1133,2011-02-19,1,0,2,23,4,25,29,35.333333333333336
1134,2011-02-20,1,0,2,0,3,14,17,30.0
1135,2011-02-20,1,0,2,1,5,11,16,20.666666666666668
1136,2011-02-20,1,0,2,2,0,17,17,16.666666666666668
1137,2011-02-20,1,0,2,3,9,9,18,17.0
1138,2011-02-20,1,0,2,4,0,1,1,12.0
1139,2011-02-20,1,0,2,6,1,1,2,7.0
1140,2011-02-20,1,0,2,7,0,2,2,1.6666666666666667
1141,2011-02-20,1,0,2,8,2,22,24,9.333333333333334
1142,2011-02-20,1,0,2,9,7,48,55,27.0
1143,2011-02-20,1,0,2,10,34,70,104,61.0
1144,2011-02-20,1,0,2,11,72,89,161,106.66666666666667
1145,2011-02-20,1,0,2,12,62,120,182,149.0
1146,2011-02-20,1,0,2,13,76,122,198,180.33333333333334
1147,2011-02-20,1,0,2,14,108,104,212,197.33333333333334
1148,2011-02-20,1,0,2,15,66,102,168,192.66666666666666
1149,2011-02-20,1,0,2,16,59,88,147,175.66666666666666
1150,2011-02-20,1,0,2,17,60,86,146,153.66666666666666
1151,2011-02-20,1,0,2,18,30,71,101,131.33333333333334
1152,2011-02-20,1,0,2,19,3,39,42,96.33333333333333
1153,2011-02-20,1,0,2,20,12,30,42,61.666666666666664
1154,2011-02-20,1,0,2,21,17,39,56,46.666666666666664
1155,2011-02-20,1,0,2,22,4,43,47,48.333333333333336
1156,2011-02-20,1,0,2,23,9,45,54,52.333333333333336
1157,2011-02-21,1,0,2,0,7,30,37,46.0
1158,2011-02-21,1,0,2,1,2,11,13,34.666666666666664
1159,2011-02-21,1,0,2,2,1,3,4,18.0
1160,2011-02-21,1,0,2,3,2,3,5,7.333333333333333
1161,2011-02-21,1,0,2,4,1,0,1,3.3333333333333335
1162,2011-02-21,1,0,2,5,1,2,3,3.0
1163,2011-02-21,1,0,2,6,2,6,8,4.0
1164,2011-02-21,1,0,2,7,3,16,19,10.0
1165,2011-02-21,1,0,2,8,7,56,63,30.0
1166,2011-02-21,1,0,2,9,11,46,57,46.333333333333336
1167,2011-02-21,1,0,2,10,29,52,81,67.0
1168,2011-02-21,1,0,2,11,20,70,90,76.0
1169,2011-02-21,1,0,2,12,26,67,93,88.0
1170,2011-02-21,1,0,2,13,28,75,103,95.33333333333333
1171,2011-02-21,1,0,2,14,15,101,116,104.0
1172,2011-02-21,1,0,2,15,11,76,87,102.0
1173,2011-02-21,1,0,2,16,8,48,56,86.33333333333333
1174,2011-02-21,1,0,2,17,18,62,80,74.33333333333333
1175,2011-02-21,1,0,2,18,2,64,66,67.33333333333333
1176,2011-02-21,1,0,2,19,0,49,49,65.0
1177,2011-02-21,1,0,2,20,0,29,29,48.0
1178,2011-02-21,1,0,2,21,1,33,34,37.333333333333336
1179,2011-02-21,1,0,2,22,0,11,11,24.666666666666668
1180,2011-02-21,1,0,2,23,0,2,2,15.666666666666666
1181,2011-02-22,1,0,2,6,0,7,7,6.666666666666667
1182,2011-02-22,1,0,2,7,0,40,40,16.333333333333332
1183,2011-02-22,1,0,2,8,7,107,114,53.666666666666664
1184,2011-02-22,1,0,2,9,5,101,106,86.66666666666667
1185,2011-02-22,1,0,2,10,0,44,44,88.0
1186,2011-02-22,1,0,2,11,7,43,50,66.66666666666667
1187,2011-02-22,1,0,2,12,7,48,55,49.666666666666664
1188,2011-02-22,1,0,2,13,3,52,55,53.333333333333336
1189,2011-02-22,1,0,2,14,9,49,58,56.0
1190,2011-02-22,1,0,2,15,2,67,69,60.666666666666664
1191,2011-02-22,1,0,2,16,7,79,86,71.0
1192,2011-02-22,1,0,2,17,8,188,196,117.0
1193,2011-02-22,1,0,2,18,6,161,167,149.66666666666666
1194,2011-02-22,1,0,2,19,4,114,118,160.33333333333334
1195,2011-02-22,1,0,2,20,3,102,105,130.0
1196,2011-02-22,1,0,2,21,2,80,82,101.66666666666667
1197,2011-02-22,1,0,2,22,1,76,77,88.0
1198,2011-02-22,1,0,2,23,3,18,21,60.0
1199,2011-02-23,1,0,2,0,0,6,6,34.666666666666664
1200,2011-02-23,1,0,2,1,0,4,4,10.333333333333334
1201,2011-02-23,1,0,2,2,0,1,1,3.6666666666666665
1202,2011-02-23,1,0,2,3,0,2,2,2.3333333333333335
1203,2011-02-23,1,0,2,5,0,8,8,3.6666666666666665
1204,2011-02-23,1,0,2,6,0,36,36,15.333333333333334
1205,2011-02-23,1,0,2,7,2,94,96,46.666666666666664
1206,2011-02-23,1,0,2,8,8,227,235,122.33333333333333
1207,2011-02-23,1,0,2,9,9,130,139,156.66666666666666
1208,2011-02-23,1,0,2,10,4,47,51,141.66666666666666
1209,2011-02-23,1,0,2,11,16,53,69,86.33333333333333
1210,2011-02-23,1,0,2,12,11,56,67,62.333333333333336
1211,2011-02-23,1,0,2,13,9,78,87,74.33333333333333
1212,2011-02-23,1,0,2,14,17,61,78,77.33333333333333
1213,2011-02-23,1,0,2,15,18,54,72,79.0
1214,2011-02-23,1,0,2,16,15,79,94,81.33333333333333
1215,2011-02-23,1,0,2,17,15,207,222,129.33333333333334
1216,2011-02-23,1,0,2,18,3,206,209,175.0
1217,2011-02-23,1,0,2,19,6,135,141,190.66666666666666
1218,2011-02-23,1,0,2,20,2,107,109,153.0
1219,2011-02-23,1,0,2,21,2,89,91,113.66666666666667
1220,2011-02-23,1,0,2,22,1,60,61,87.0
1221,2011-02-23,1,0,2,23,1,38,39,63.666666666666664
1222,2011-02-24,1,0,2,0,0,11,11,37.0
1223,2011-02-24,1,0,2,1,0,7,7,19.0
1224,2011-02-24,1,0,2,2,0,4,4,7.333333333333333
1225,2011-02-24,1,0,2,3,0,2,2,4.333333333333333
1226,2011-02-24,1,0,2,5,1,3,4,3.3333333333333335
1227,2011-02-24,1,0,2,6,0,58,58,21.333333333333332
1228,2011-02-24,1,0,2,7,0,104,104,55.333333333333336
1229,2011-02-24,1,0,2,8,8,244,252,138.0
1230,2011-02-24,1,0,2,9,4,133,137,164.33333333333334
1231,2011-02-24,1,0,2,10,8,49,57,148.66666666666666
1232,2011-02-24,1,0,2,11,8,71,79,91.0
1233,2011-02-24,1,0,2,12,10,85,95,77.0
1234,2011-02-24,1,0,2,13,16,72,88,87.33333333333333
1235,2011-02-24,1,0,2,14,2,67,69,84.0
1236,2011-02-24,1,0,2,15,5,58,63,73.33333333333333
1237,2011-02-24,1,0,2,16,4,67,71,67.66666666666667
1238,2011-02-24,1,0,2,17,9,168,177,103.66666666666667
1239,2011-02-24,1,0,2,18,5,132,137,128.33333333333334
1240,2011-02-24,1,0,2,19,3,112,115,143.0
1241,2011-02-24,1,0,2,20,2,87,89,113.66666666666667
1242,2011-02-24,1,0,2,21,7,76,83,95.66666666666667
1243,2011-02-24,1,0,2,22,5,50,55,75.66666666666667
1244,2011-02-24,1,0,2,23,3,47,50,62.666666666666664
1245,2011-02-25,1,0,2,0,1,8,9,38.0
1246,2011-02-25,1,0,2,1,1,9,10,23.0
1247,2011-02-25,1,0,2,2,0,3,3,7.333333333333333
1248,2011-02-25,1,0,2,3,1,1,2,5.0
1249,2011-02-25,1,0,2,5,1,5,6,3.6666666666666665
1250,2011-02-25,1,0,2,6,0,11,11,6.333333333333333
1251,2011-02-25,1,0,2,7,1,34,35,17.333333333333332
1252,2011-02-25,1,0,2,8,3,70,73,39.666666666666664
1253,2011-02-25,1,0,2,9,3,111,114,74.0
1254,2011-02-25,1,0,2,10,7,42,49,78.66666666666667
1255,2011-02-25,1,0,2,11,9,50,59,74.0
1256,2011-02-25,1,0,2,12,20,95,115,74.33333333333333
1257,2011-02-25,1,0,2,13,6,77,83,85.66666666666667
1258,2011-02-25,1,0,2,14,14,71,85,94.33333333333333
1259,2011-02-25,1,0,2,15,5,50,55,74.33333333333333
1260,2011-02-25,1,0,2,16,11,91,102,80.66666666666667
1261,2011-02-25,1,0,2,17,8,181,189,115.33333333333333
1262,2011-02-25,1,0,2,18,7,150,157,149.33333333333334
1263,2011-02-25,1,0,2,19,4,86,90,145.33333333333334
1264,2011-02-25,1,0,2,20,2,60,62,103.0
1265,2011-02-25,1,0,2,21,7,56,63,71.66666666666667
1266,2011-02-25,1,0,2,22,7,43,50,58.333333333333336
1267,2011-02-25,1,0,2,23,2,37,39,50.666666666666664
1268,2011-02-26,1,0,2,0,3,25,28,39.0
1269,2011-02-26,1,0,2,1,2,25,27,31.333333333333332
1270,2011-02-26,1,0,2,2,3,9,12,22.333333333333332
1271,2011-02-26,1,0,2,3,1,7,8,15.666666666666666
1272,2011-02-26,1,0,2,4,1,1,2,7.333333333333333
1273,2011-02-26,1,0,2,5,1,9,10,6.666666666666667
1274,2011-02-26,1,0,2,6,1,6,7,6.333333333333333
1275,2011-02-26,1,0,2,7,1,21,22,13.0
1276,2011-02-26,1,0,2,8,2,55,57,28.666666666666668
1277,2011-02-26,1,0,2,9,9,65,74,51.0
1278,2011-02-26,1,0,2,10,14,71,85,72.0
1279,2011-02-26,1,0,2,11,26,100,126,95.0
1280,2011-02-26,1,0,2,12,45,115,160,123.66666666666667
1281,2011-02-26,1,0,2,13,38,136,174,153.33333333333334
1282,2011-02-26,1,0,2,14,57,154,211,181.66666666666666
1283,2011-02-26,1,0,2,15,40,125,165,183.33333333333334
1284,2011-02-26,1,0,2,16,41,130,171,182.33333333333334
1285,2011-02-26,1,0,2,17,53,130,183,173.0
1286,2011-02-26,1,0,2,18,26,111,137,163.66666666666666
1287,2011-02-26,1,0,2,19,30,64,94,138.0
1288,2011-02-26,1,0,2,20,8,60,68,99.66666666666667
1289,2011-02-26,1,0,2,21,9,59,68,76.66666666666667
1290,2011-02-26,1,0,2,22,8,38,46,60.666666666666664
1291,2011-02-26,1,0,2,23,5,29,34,49.333333333333336
1292,2011-02-27,1,0,2,0,8,26,34,38.0
1293,2011-02-27,1,0,2,1,7,30,37,35.0
1294,2011-02-27,1,0,2,2,2,20,22,31.0
1295,2011-02-27,1,0,2,3,3,8,11,23.333333333333332
1296,2011-02-27,1,0,2,4,0,2,2,11.666666666666666
1297,2011-02-27,1,0,2,6,2,1,3,5.333333333333333
1298,2011-02-27,1,0,2,7,6,8,14,6.333333333333333
1299,2011-02-27,1,0,2,8,9,26,35,17.333333333333332
1300,2011-02-27,1,0,2,9,17,42,59,36.0
1301,2011-02-27,1,0,2,10,24,79,103,65.66666666666667
1302,2011-02-27,1,0,2,11,33,92,125,95.66666666666667
1303,2011-02-27,1,0,2,12,61,132,193,140.33333333333334
1304,2011-02-27,1,0,2,13,90,169,259,192.33333333333334
1305,2011-02-27,1,0,2,14,105,177,282,244.66666666666666
1306,2011-02-27,1,0,2,15,98,163,261,267.3333333333333
1307,2011-02-27,1,0,2,16,98,170,268,270.3333333333333
1308,2011-02-27,1,0,2,17,66,121,187,238.66666666666666
1309,2011-02-27,1,0,2,18,24,103,127,194.0
1310,2011-02-27,1,0,2,19,16,86,102,138.66666666666666
1311,2011-02-27,1,0,2,20,9,72,81,103.33333333333333
1312,2011-02-27,1,0,2,21,8,61,69,84.0
1313,2011-02-27,1,0,2,22,2,67,69,73.0
1314,2011-02-27,1,0,2,23,6,53,59,65.66666666666667
1315,2011-02-28,1,0,2,0,5,25,30,52.666666666666664
1316,2011-02-28,1,0,2,1,1,7,8,32.333333333333336
1317,2011-02-28,1,0,2,3,0,1,1,13.0
1318,2011-02-28,1,0,2,5,1,4,5,4.666666666666667
1319,2011-02-28,1,0,2,6,1,27,28,11.333333333333334
1320,2011-02-28,1,0,2,7,2,90,92,41.666666666666664
1321,2011-02-28,1,0,2,8,13,242,255,125.0
1322,2011-02-28,1,0,2,9,15,127,142,163.0
1323,2011-02-28,1,0,2,10,13,79,92,163.0
1324,2011-02-28,1,0,2,11,13,74,87,107.0
1325,2011-02-28,1,0,2,12,0,36,36,71.66666666666667
1326,2011-02-28,1,0,2,13,1,31,32,51.666666666666664
1327,2011-02-28,1,0,2,14,1,24,25,31.0
1328,2011-02-28,1,0,2,15,0,35,35,30.666666666666668
1329,2011-02-28,1,0,2,16,2,40,42,34.0
1330,2011-02-28,1,0,2,17,2,77,79,52.0
1331,2011-02-28,1,0,2,18,4,127,131,84.0
1332,2011-02-28,1,0,2,19,1,79,80,96.66666666666667
1333,2011-02-28,1,0,2,20,0,45,45,85.33333333333333
1334,2011-02-28,1,0,2,21,2,78,80,68.33333333333333
1335,2011-02-28,1,0,2,22,4,72,76,67.0
1336,2011-02-28,1,0,2,23,0,45,45,67.0
1337,2011-03-01,1,0,3,0,0,7,7,42.666666666666664
1338,2011-03-01,1,0,3,1,0,3,3,18.333333333333332
1339,2011-03-01,1,0,3,2,0,4,4,4.666666666666667
1340,2011-03-01,1,0,3,3,0,2,2,3.0
1341,2011-03-01,1,0,3,4,0,1,1,2.3333333333333335
1342,2011-03-01,1,0,3,5,1,1,2,1.6666666666666667
1343,2011-03-01,1,0,3,6,0,46,46,16.333333333333332
1344,2011-03-01,1,0,3,7,2,105,107,51.666666666666664
1345,2011-03-01,1,0,3,8,10,204,214,122.33333333333333
1346,2011-03-01,1,0,3,9,8,116,124,148.33333333333334
1347,2011-03-01,1,0,3,10,13,55,68,135.33333333333334
1348,2011-03-01,1,0,3,11,8,48,56,82.66666666666667
1349,2011-03-01,1,0,3,12,6,80,86,70.0
1350,2011-03-01,1,0,3,13,13,65,78,73.33333333333333
1351,2011-03-01,1,0,3,14,18,61,79,81.0
1352,2011-03-01,1,0,3,15,7,57,64,73.66666666666667
1353,2011-03-01,1,0,3,16,10,92,102,81.66666666666667
1354,2011-03-01,1,0,3,17,12,230,242,136.0
1355,2011-03-01,1,0,3,18,10,214,224,189.33333333333334
1356,2011-03-01,1,0,3,19,4,115,119,195.0
1357,2011-03-01,1,0,3,20,2,86,88,143.66666666666666
1358,2011-03-01,1,0,3,21,8,55,63,90.0
1359,2011-03-01,1,0,3,22,3,44,47,66.0
1360,2011-03-01,1,0,3,23,2,23,25,45.0
1361,2011-03-02,1,0,3,0,3,5,8,26.666666666666668
1362,2011-03-02,1,0,3,1,0,4,4,12.333333333333334
1363,2011-03-02,1,0,3,2,0,2,2,4.666666666666667
1364,2011-03-02,1,0,3,3,3,1,4,3.3333333333333335
1365,2011-03-02,1,0,3,4,1,0,1,2.3333333333333335
1366,2011-03-02,1,0,3,5,0,5,5,3.3333333333333335
1367,2011-03-02,1,0,3,6,1,39,40,15.333333333333334
1368,2011-03-02,1,0,3,7,2,108,110,51.666666666666664
1369,2011-03-02,1,0,3,8,13,243,256,135.33333333333334
1370,2011-03-02,1,0,3,9,7,141,148,171.33333333333334
1371,2011-03-02,1,0,3,10,11,65,76,160.0
1372,2011-03-02,1,0,3,11,8,65,73,99.0
1373,2011-03-02,1,0,3,12,20,62,82,77.0
1374,2011-03-02,1,0,3,13,35,90,125,93.33333333333333
1375,2011-03-02,1,0,3,14,21,75,96,101.0
1376,2011-03-02,1,0,3,15,19,91,110,110.33333333333333
1377,2011-03-02,1,0,3,16,27,112,139,115.0
1378,2011-03-02,1,0,3,17,30,238,268,172.33333333333334
1379,2011-03-02,1,0,3,18,8,193,201,202.66666666666666
1380,2011-03-02,1,0,3,19,6,144,150,206.33333333333334
1381,2011-03-02,1,0,3,20,9,86,95,148.66666666666666
1382,2011-03-02,1,0,3,21,3,68,71,105.33333333333333
1383,2011-03-02,1,0,3,22,4,44,48,71.33333333333333
1384,2011-03-02,1,0,3,23,0,22,22,47.0
1385,2011-03-03,1,0,3,0,3,10,13,27.666666666666668
1386,2011-03-03,1,0,3,1,0,1,1,12.0
1387,2011-03-03,1,0,3,2,1,2,3,5.666666666666667
1388,2011-03-03,1,0,3,3,0,1,1,1.6666666666666667
1389,2011-03-03,1,0,3,4,0,1,1,1.6666666666666667
1390,2011-03-03,1,0,3,5,1,7,8,3.3333333333333335
1391,2011-03-03,1,0,3,6,1,34,35,14.666666666666666
1392,2011-03-03,1,0,3,7,1,110,111,51.333333333333336
1393,2011-03-03,1,0,3,8,4,216,220,122.0
1394,2011-03-03,1,0,3,9,10,135,145,158.66666666666666
1395,2011-03-03,1,0,3,10,7,49,56,140.33333333333334
1396,2011-03-03,1,0,3,11,10,40,50,83.66666666666667
1397,2011-03-03,1,0,3,12,7,65,72,59.333333333333336
1398,2011-03-03,1,0,3,13,13,67,80,67.33333333333333
1399,2011-03-03,1,0,3,14,18,60,78,76.66666666666667
1400,2011-03-03,1,0,3,15,6,62,68,75.33333333333333
1401,2011-03-03,1,0,3,16,6,65,71,72.33333333333333
1402,2011-03-03,1,0,3,17,17,185,202,113.66666666666667
1403,2011-03-03,1,0,3,18,6,161,167,146.66666666666666
1404,2011-03-03,1,0,3,19,5,101,106,158.33333333333334
1405,2011-03-03,1,0,3,20,1,69,70,114.33333333333333
1406,2011-03-03,1,0,3,21,3,48,51,75.66666666666667
1407,2011-03-03,1,0,3,22,3,50,53,58.0
1408,2011-03-03,1,0,3,23,0,23,23,42.333333333333336
1409,2011-03-04,1,0,3,0,0,12,12,29.333333333333332
1410,2011-03-04,1,0,3,1,0,4,4,13.0
1411,2011-03-04,1,0,3,2,0,2,2,6.0
1412,2011-03-04,1,0,3,3,0,1,1,2.3333333333333335
1413,2011-03-04,1,0,3,4,1,0,1,1.3333333333333333
1414,2011-03-04,1,0,3,5,0,7,7,3.0
1415,2011-03-04,1,0,3,6,1,28,29,12.333333333333334
1416,2011-03-04,1,0,3,7,0,83,83,39.666666666666664
1417,2011-03-04,1,0,3,8,6,222,228,113.33333333333333
1418,2011-03-04,1,0,3,9,12,138,150,153.66666666666666
1419,2011-03-04,1,0,3,10,10,56,66,148.0
1420,2011-03-04,1,0,3,11,16,73,89,101.66666666666667
1421,2011-03-04,1,0,3,12,10,87,97,84.0
1422,2011-03-04,1,0,3,13,13,74,87,91.0
1423,2011-03-04,1,0,3,14,30,65,95,93.0
1424,2011-03-04,1,0,3,15,31,75,106,96.0
1425,2011-03-04,1,0,3,16,17,101,118,106.33333333333333
1426,2011-03-04,1,0,3,17,22,206,228,150.66666666666666
1427,2011-03-04,1,0,3,18,15,172,187,177.66666666666666
1428,2011-03-04,1,0,3,19,5,102,107,174.0
1429,2011-03-04,1,0,3,20,9,78,87,127.0
1430,2011-03-04,1,0,3,21,6,64,70,88.0
1431,2011-03-04,1,0,3,22,4,40,44,67.0
1432,2011-03-04,1,0,3,23,6,40,46,53.333333333333336
1433,2011-03-05,1,0,3,0,4,15,19,36.333333333333336
1434,2011-03-05,1,0,3,1,5,20,25,30.0
1435,2011-03-05,1,0,3,2,5,15,20,21.333333333333332
1436,2011-03-05,1,0,3,3,0,2,2,15.666666666666666
1437,2011-03-05,1,0,3,4,0,1,1,7.666666666666667
1438,2011-03-05,1,0,3,5,0,3,3,2.0
1439,2011-03-05,1,0,3,6,1,3,4,2.6666666666666665
1440,2011-03-05,1,0,3,7,5,10,15,7.333333333333333
1441,2011-03-05,1,0,3,8,11,34,45,21.333333333333332
1442,2011-03-05,1,0,3,9,15,48,63,41.0
1443,2011-03-05,1,0,3,10,34,69,103,70.33333333333333
1444,2011-03-05,1,0,3,11,43,116,159,108.33333333333333
1445,2011-03-05,1,0,3,12,46,121,167,143.0
1446,2011-03-05,1,0,3,13,60,130,190,172.0
1447,2011-03-05,1,0,3,14,80,118,198,185.0
1448,2011-03-05,1,0,3,15,83,122,205,197.66666666666666
1449,2011-03-05,1,0,3,16,74,130,204,202.33333333333334
1450,2011-03-05,1,0,3,17,60,104,164,191.0
1451,2011-03-05,1,0,3,18,37,115,152,173.33333333333334
1452,2011-03-05,1,0,3,19,27,62,89,135.0
1453,2011-03-05,1,0,3,20,12,58,70,103.66666666666667
1454,2011-03-05,1,0,3,21,12,60,72,77.0
1455,2011-03-05,1,0,3,22,16,47,63,68.33333333333333
1456,2011-03-05,1,0,3,23,10,34,44,59.666666666666664
1457,2011-03-06,1,0,3,0,11,41,52,53.0
1458,2011-03-06,1,0,3,1,12,27,39,45.0
1459,2011-03-06,1,0,3,2,5,27,32,41.0
1460,2011-03-06,1,0,3,3,2,9,11,27.333333333333332
1461,2011-03-06,1,0,3,4,0,3,3,15.333333333333334
1462,2011-03-06,1,0,3,6,1,1,2,5.333333333333333
1463,2011-03-06,1,0,3,7,0,5,5,3.3333333333333335
1464,2011-03-06,1,0,3,8,1,8,9,5.333333333333333
1465,2011-03-06,1,0,3,9,4,18,22,12.0
1466,2011-03-06,1,0,3,10,4,27,31,20.666666666666668
1467,2011-03-06,1,0,3,11,18,44,62,38.333333333333336
1468,2011-03-06,1,0,3,12,10,69,79,57.333333333333336
1469,2011-03-06,1,0,3,13,22,83,105,82.0
1470,2011-03-06,1,0,3,14,12,27,39,74.33333333333333
1471,2011-03-06,1,0,3,15,3,4,7,50.333333333333336
1472,2011-03-06,1,0,3,16,3,8,11,19.0
1473,2011-03-06,1,0,3,17,2,23,25,14.333333333333334
1474,2011-03-06,1,0,3,18,0,23,23,19.666666666666668
1475,2011-03-06,1,0,3,19,0,11,11,19.666666666666668
1476,2011-03-06,1,0,3,20,3,8,11,15.0
1477,2011-03-06,1,0,3,21,1,6,7,9.666666666666666
1478,2011-03-06,1,0,3,22,0,10,10,9.333333333333334
1479,2011-03-06,1,0,3,23,0,9,9,8.666666666666666
1480,2011-03-07,1,0,3,0,0,4,4,7.666666666666667
1481,2011-03-07,1,0,3,1,0,2,2,5.0
1482,2011-03-07,1,0,3,3,0,1,1,2.3333333333333335
1483,2011-03-07,1,0,3,4,1,0,1,1.3333333333333333
1484,2011-03-07,1,0,3,5,0,1,1,1.0
1485,2011-03-07,1,0,3,6,3,31,34,12.0
1486,2011-03-07,1,0,3,7,3,88,91,42.0
1487,2011-03-07,1,0,3,8,11,200,211,112.0
1488,2011-03-07,1,0,3,9,5,129,134,145.33333333333334
1489,2011-03-07,1,0,3,10,15,43,58,134.33333333333334
1490,2011-03-07,1,0,3,11,19,41,60,84.0
1491,2011-03-07,1,0,3,12,28,68,96,71.33333333333333
1492,2011-03-07,1,0,3,13,16,54,70,75.33333333333333
1493,2011-03-07,1,0,3,14,21,56,77,81.0
1494,2011-03-07,1,0,3,15,32,64,96,81.0
1495,2011-03-07,1,0,3,16,26,96,122,98.33333333333333
1496,2011-03-07,1,0,3,17,27,206,233,150.33333333333334
1497,2011-03-07,1,0,3,18,19,214,233,196.0
1498,2011-03-07,1,0,3,19,11,134,145,203.66666666666666
1499,2011-03-07,1,0,3,20,5,87,92,156.66666666666666
1500,2011-03-07,1,0,3,21,1,53,54,97.0
1501,2011-03-07,1,0,3,22,1,34,35,60.333333333333336
1502,2011-03-07,1,0,3,23,0,22,22,37.0
1503,2011-03-08,1,0,3,0,1,9,10,22.333333333333332
1504,2011-03-08,1,0,3,1,0,4,4,12.0
1505,2011-03-08,1,0,3,2,1,0,1,5.0
1506,2011-03-08,1,0,3,3,5,2,7,4.0
1507,2011-03-08,1,0,3,4,0,2,2,3.3333333333333335
1508,2011-03-08,1,0,3,5,2,8,10,6.333333333333333
1509,2011-03-08,1,0,3,6,3,42,45,19.0
1510,2011-03-08,1,0,3,7,9,119,128,61.0
1511,2011-03-08,1,0,3,8,10,247,257,143.33333333333334
1512,2011-03-08,1,0,3,9,11,140,151,178.66666666666666
1513,2011-03-08,1,0,3,10,25,46,71,159.66666666666666
1514,2011-03-08,1,0,3,11,26,52,78,100.0
1515,2011-03-08,1,0,3,12,29,70,99,82.66666666666667
1516,2011-03-08,1,0,3,13,25,73,98,91.66666666666667
1517,2011-03-08,1,0,3,14,16,56,72,89.66666666666667
1518,2011-03-08,1,0,3,15,35,77,112,94.0
1519,2011-03-08,1,0,3,16,26,82,108,97.33333333333333
1520,2011-03-08,1,0,3,17,39,209,248,156.0
1521,2011-03-08,1,0,3,18,21,214,235,197.0
1522,2011-03-08,1,0,3,19,9,141,150,211.0
1523,2011-03-08,1,0,3,20,2,74,76,153.66666666666666
1524,2011-03-08,1,0,3,21,7,68,75,100.33333333333333
1525,2011-03-08,1,0,3,22,11,44,55,68.66666666666667
1526,2011-03-08,1,0,3,23,3,38,41,57.0
1527,2011-03-09,1,0,3,0,0,9,9,35.0
1528,2011-03-09,1,0,3,1,0,4,4,18.0
1529,2011-03-09,1,0,3,2,1,1,2,5.0
1530,2011-03-09,1,0,3,3,1,2,3,3.0
1531,2011-03-09,1,0,3,4,0,2,2,2.3333333333333335
1532,2011-03-09,1,0,3,5,1,7,8,4.333333333333333
1533,2011-03-09,1,0,3,6,5,44,49,19.666666666666668
1534,2011-03-09,1,0,3,7,18,123,141,66.0
1535,2011-03-09,1,0,3,8,11,238,249,146.33333333333334
1536,2011-03-09,1,0,3,9,5,136,141,177.0
1537,2011-03-09,1,0,3,10,8,49,57,149.0
1538,2011-03-09,1,0,3,11,15,44,59,85.66666666666667
1539,2011-03-09,1,0,3,12,14,84,98,71.33333333333333
1540,2011-03-09,1,0,3,13,17,82,99,85.33333333333333
1541,2011-03-09,1,0,3,14,10,61,71,89.33333333333333
1542,2011-03-09,1,0,3,15,15,64,79,83.0
1543,2011-03-09,1,0,3,16,10,102,112,87.33333333333333
1544,2011-03-09,1,0,3,17,18,176,194,128.33333333333334
1545,2011-03-09,1,0,3,18,12,176,188,164.66666666666666
1546,2011-03-09,1,0,3,19,11,123,134,172.0
1547,2011-03-09,1,0,3,20,4,87,91,137.66666666666666
1548,2011-03-09,1,0,3,21,10,52,62,95.66666666666667
1549,2011-03-09,1,0,3,22,4,17,21,58.0
1550,2011-03-09,1,0,3,23,1,17,18,33.666666666666664
1551,2011-03-10,1,0,3,0,3,0,3,14.0
1552,2011-03-10,1,0,3,1,0,2,2,7.666666666666667
1553,2011-03-10,1,0,3,2,0,1,1,2.0
1554,2011-03-10,1,0,3,5,1,2,3,2.0
1555,2011-03-10,1,0,3,6,0,12,12,5.333333333333333
1556,2011-03-10,1,0,3,7,1,36,37,17.333333333333332
1557,2011-03-10,1,0,3,8,1,43,44,31.0
1558,2011-03-10,1,0,3,9,1,23,24,35.0
1559,2011-03-10,1,0,3,10,0,17,17,28.333333333333332
1560,2011-03-10,1,0,3,11,6,5,11,17.333333333333332
1561,2011-03-10,1,0,3,12,4,30,34,20.666666666666668
1562,2011-03-10,1,0,3,13,1,11,12,19.0
1563,2011-03-10,1,0,3,14,0,12,12,19.333333333333332
1564,2011-03-10,1,0,3,15,3,11,14,12.666666666666666
1565,2011-03-10,1,0,3,16,1,20,21,15.666666666666666
1566,2011-03-10,1,0,3,17,2,109,111,48.666666666666664
1567,2011-03-10,1,0,3,18,2,80,82,71.33333333333333
1568,2011-03-10,1,0,3,19,5,51,56,83.0
1569,2011-03-10,1,0,3,20,9,29,38,58.666666666666664
1570,2011-03-10,1,0,3,21,1,27,28,40.666666666666664
1571,2011-03-10,1,0,3,22,4,30,34,33.333333333333336
1572,2011-03-10,1,0,3,23,1,26,27,29.666666666666668
1573,2011-03-11,1,0,3,0,0,6,6,22.333333333333332
1574,2011-03-11,1,0,3,1,0,8,8,13.666666666666666
1575,2011-03-11,1,0,3,2,2,3,5,6.333333333333333
1576,2011-03-11,1,0,3,3,0,2,2,5.0
1577,2011-03-11,1,0,3,5,1,6,7,4.666666666666667
1578,2011-03-11,1,0,3,6,1,31,32,13.666666666666666
1579,2011-03-11,1,0,3,7,10,104,114,51.0
1580,2011-03-11,1,0,3,8,15,244,259,135.0
1581,2011-03-11,1,0,3,9,13,143,156,176.33333333333334
1582,2011-03-11,1,0,3,10,18,60,78,164.33333333333334
1583,2011-03-11,1,0,3,11,14,67,81,105.0
1584,2011-03-11,1,0,3,12,15,96,111,90.0
1585,2011-03-11,1,0,3,13,15,92,107,99.66666666666667
1586,2011-03-11,1,0,3,14,25,64,89,102.33333333333333
1587,2011-03-11,1,0,3,15,21,64,85,93.66666666666667
1588,2011-03-11,1,0,3,16,18,95,113,95.66666666666667
1589,2011-03-11,1,0,3,17,23,200,223,140.33333333333334
1590,2011-03-11,1,0,3,18,19,134,153,163.0
1591,2011-03-11,1,0,3,19,7,111,118,164.66666666666666
1592,2011-03-11,1,0,3,20,6,70,76,115.66666666666667
1593,2011-03-11,1,0,3,21,10,43,53,82.33333333333333
1594,2011-03-11,1,0,3,22,11,53,64,64.33333333333333
1595,2011-03-11,1,0,3,23,3,34,37,51.333333333333336
1596,2011-03-12,1,0,3,0,4,30,34,45.0
1597,2011-03-12,1,0,3,1,3,15,18,29.666666666666668
1598,2011-03-12,1,0,3,2,0,14,14,22.0
1599,2011-03-12,1,0,3,3,1,6,7,13.0
1600,2011-03-12,1,0,3,4,0,1,1,7.333333333333333
1601,2011-03-12,1,0,3,5,0,2,2,3.3333333333333335
1602,2011-03-12,1,0,3,6,2,2,4,2.3333333333333335
1603,2011-03-12,1,0,3,7,4,19,23,9.666666666666666
1604,2011-03-12,1,0,3,8,9,44,53,26.666666666666668
1605,2011-03-12,1,0,3,9,25,76,101,59.0
1606,2011-03-12,1,0,3,10,21,78,99,84.33333333333333
1607,2011-03-12,1,0,3,11,36,83,119,106.33333333333333
1608,2011-03-12,1,0,3,12,51,107,158,125.33333333333333
1609,2011-03-12,1,0,3,13,62,95,157,144.66666666666666
1610,2011-03-12,1,0,3,14,70,96,166,160.33333333333334
1611,2011-03-12,1,0,3,15,81,101,182,168.33333333333334
1612,2011-03-12,1,0,3,16,100,144,244,197.33333333333334
1613,2011-03-12,1,0,3,17,99,114,213,213.0
1614,2011-03-12,1,0,3,18,54,91,145,200.66666666666666
1615,2011-03-12,1,0,3,19,26,86,112,156.66666666666666
1616,2011-03-12,1,0,3,20,22,64,86,114.33333333333333
1617,2011-03-12,1,0,3,21,36,46,82,93.33333333333333
1618,2011-03-12,1,0,3,22,7,56,63,77.0
1619,2011-03-12,1,0,3,23,11,38,49,64.66666666666667
1620,2011-03-13,1,0,3,0,3,35,38,50.0
1621,2011-03-13,1,0,3,1,10,23,33,40.0
1622,2011-03-13,1,0,3,3,6,17,23,31.333333333333332
1623,2011-03-13,1,0,3,4,4,9,13,23.0
1624,2011-03-13,1,0,3,5,0,3,3,13.0
1625,2011-03-13,1,0,3,6,0,2,2,6.0
1626,2011-03-13,1,0,3,7,2,8,10,5.0
1627,2011-03-13,1,0,3,8,11,23,34,15.333333333333334
1628,2011-03-13,1,0,3,9,8,36,44,29.333333333333332
1629,2011-03-13,1,0,3,10,36,86,122,66.66666666666667
1630,2011-03-13,1,0,3,11,88,93,181,115.66666666666667
1631,2011-03-13,1,0,3,12,74,120,194,165.66666666666666
1632,2011-03-13,1,0,3,13,97,124,221,198.66666666666666
1633,2011-03-13,1,0,3,14,144,106,250,221.66666666666666
1634,2011-03-13,1,0,3,15,149,155,304,258.3333333333333
1635,2011-03-13,1,0,3,16,124,132,256,270.0
1636,2011-03-13,1,0,3,17,98,143,241,267.0
1637,2011-03-13,1,0,3,18,55,92,147,214.66666666666666
1638,2011-03-13,1,0,3,19,28,73,101,163.0
1639,2011-03-13,1,0,3,20,23,54,77,108.33333333333333
1640,2011-03-13,1,0,3,21,9,49,58,78.66666666666667
1641,2011-03-13,1,0,3,22,8,29,37,57.333333333333336
1642,2011-03-13,1,0,3,23,5,23,28,41.0
1643,2011-03-14,1,0,3,0,4,7,11,25.333333333333332
1644,2011-03-14,1,0,3,1,0,1,1,13.333333333333334
1645,2011-03-14,1,0,3,2,0,1,1,4.333333333333333
1646,2011-03-14,1,0,3,3,0,3,3,1.6666666666666667
1647,2011-03-14,1,0,3,5,0,8,8,4.0
1648,2011-03-14,1,0,3,6,1,27,28,13.0
1649,2011-03-14,1,0,3,7,4,84,88,41.333333333333336
1650,2011-03-14,1,0,3,8,24,217,241,119.0
1651,2011-03-14,1,0,3,9,13,127,140,156.33333333333334
1652,2011-03-14,1,0,3,10,27,57,84,155.0
1653,2011-03-14,1,0,3,11,26,45,71,98.33333333333333
1654,2011-03-14,1,0,3,12,40,54,94,83.0
1655,2011-03-14,1,0,3,13,24,51,75,80.0
1656,2011-03-14,1,0,3,14,27,52,79,82.66666666666667
1657,2011-03-14,1,0,3,15,24,77,101,85.0
1658,2011-03-14,1,0,3,16,27,80,107,95.66666666666667
1659,2011-03-14,1,0,3,17,42,229,271,159.66666666666666
1660,2011-03-14,1,0,3,18,25,210,235,204.33333333333334
1661,2011-03-14,1,0,3,19,17,133,150,218.66666666666666
1662,2011-03-14,1,0,3,20,23,106,129,171.33333333333334
1663,2011-03-14,1,0,3,21,5,58,63,114.0
1664,2011-03-14,1,0,3,22,4,43,47,79.66666666666667
1665,2011-03-14,1,0,3,23,2,17,19,43.0
1666,2011-03-15,1,0,3,0,7,7,14,26.666666666666668
1667,2011-03-15,1,0,3,1,4,6,10,14.333333333333334
1668,2011-03-15,1,0,3,2,1,2,3,9.0
1669,2011-03-15,1,0,3,4,1,1,2,5.0
1670,2011-03-15,1,0,3,5,0,11,11,5.333333333333333
1671,2011-03-15,1,0,3,6,3,32,35,16.0
1672,2011-03-15,1,0,3,7,10,109,119,55.0
1673,2011-03-15,1,0,3,8,23,259,282,145.33333333333334
1674,2011-03-15,1,0,3,9,10,147,157,186.0
1675,2011-03-15,1,0,3,10,22,56,78,172.33333333333334
1676,2011-03-15,1,0,3,11,27,51,78,104.33333333333333
1677,2011-03-15,1,0,3,12,32,70,102,86.0
1678,2011-03-15,1,0,3,13,23,74,97,92.33333333333333
1679,2011-03-15,1,0,3,14,14,74,88,95.66666666666667
1680,2011-03-15,1,0,3,15,24,66,90,91.66666666666667
1681,2011-03-15,1,0,3,16,21,93,114,97.33333333333333
1682,2011-03-15,1,0,3,17,22,195,217,140.33333333333334
1683,2011-03-15,1,0,3,18,18,207,225,185.33333333333334
1684,2011-03-15,1,0,3,19,14,138,152,198.0
1685,2011-03-15,1,0,3,20,9,79,88,155.0
1686,2011-03-15,1,0,3,21,2,53,55,98.33333333333333
1687,2011-03-15,1,0,3,22,1,20,21,54.666666666666664
1688,2011-03-15,1,0,3,23,1,17,18,31.333333333333332
1689,2011-03-16,1,0,3,0,0,8,8,15.666666666666666
1690,2011-03-16,1,0,3,1,1,2,3,9.666666666666666
1691,2011-03-16,1,0,3,3,1,2,3,4.666666666666667
1692,2011-03-16,1,0,3,4,0,1,1,2.3333333333333335
1693,2011-03-16,1,0,3,5,0,3,3,2.3333333333333335
1694,2011-03-16,1,0,3,6,1,30,31,11.666666666666666
1695,2011-03-16,1,0,3,7,10,101,111,48.333333333333336
1696,2011-03-16,1,0,3,8,26,227,253,131.66666666666666
1697,2011-03-16,1,0,3,9,10,144,154,172.66666666666666
1698,2011-03-16,1,0,3,10,19,49,68,158.33333333333334
1699,2011-03-16,1,0,3,11,13,62,75,99.0
1700,2011-03-16,1,0,3,12,23,65,88,77.0
1701,2011-03-16,1,0,3,13,18,81,99,87.33333333333333
1702,2011-03-16,1,0,3,14,33,67,100,95.66666666666667
1703,2011-03-16,1,0,3,15,22,79,101,100.0
1704,2011-03-16,1,0,3,16,30,121,151,117.33333333333333
1705,2011-03-16,1,0,3,17,37,216,253,168.33333333333334
1706,2011-03-16,1,0,3,18,26,211,237,213.66666666666666
1707,2011-03-16,1,0,3,19,18,150,168,219.33333333333334
1708,2011-03-16,1,0,3,20,10,111,121,175.33333333333334
1709,2011-03-16,1,0,3,21,3,75,78,122.33333333333333
1710,2011-03-16,1,0,3,22,11,48,59,86.0
1711,2011-03-16,1,0,3,23,9,18,27,54.666666666666664
1712,2011-03-17,1,0,3,0,4,19,23,36.333333333333336
1713,2011-03-17,1,0,3,1,1,11,12,20.666666666666668
1714,2011-03-17,1,0,3,2,3,5,8,14.333333333333334
1715,2011-03-17,1,0,3,3,1,1,2,7.333333333333333
1716,2011-03-17,1,0,3,4,0,3,3,4.333333333333333
1717,2011-03-17,1,0,3,5,0,13,13,6.0
1718,2011-03-17,1,0,3,6,4,47,51,22.333333333333332
1719,2011-03-17,1,0,3,7,12,128,140,68.0
1720,2011-03-17,1,0,3,8,17,282,299,163.33333333333334
1721,2011-03-17,1,0,3,9,23,162,185,208.0
1722,2011-03-17,1,0,3,10,9,69,78,187.33333333333334
1723,2011-03-17,1,0,3,11,20,66,86,116.33333333333333
1724,2011-03-17,1,0,3,12,24,81,105,89.66666666666667
1725,2011-03-17,1,0,3,13,26,85,111,100.66666666666667
1726,2011-03-17,1,0,3,14,32,87,119,111.66666666666667
1727,2011-03-17,1,0,3,15,30,95,125,118.33333333333333
1728,2011-03-17,1,0,3,16,34,108,142,128.66666666666666
1729,2011-03-17,1,0,3,17,48,265,313,193.33333333333334
1730,2011-03-17,1,0,3,18,50,260,310,255.0
1731,2011-03-17,1,0,3,19,18,189,207,276.6666666666667
1732,2011-03-17,1,0,3,20,25,112,137,218.0
1733,2011-03-17,1,0,3,21,19,119,138,160.66666666666666
1734,2011-03-17,1,0,3,22,17,70,87,120.66666666666667
1735,2011-03-17,1,0,3,23,7,43,50,91.66666666666667
1736,2011-03-18,1,0,3,0,5,24,29,55.333333333333336
1737,2011-03-18,1,0,3,1,4,12,16,31.666666666666668
1738,2011-03-18,1,0,3,2,5,9,14,19.666666666666668
1739,2011-03-18,1,0,3,3,1,4,5,11.666666666666666
1740,2011-03-18,1,0,3,5,2,8,10,9.666666666666666
1741,2011-03-18,1,0,3,6,1,35,36,17.0
1742,2011-03-18,1,0,3,7,11,112,123,56.333333333333336
1743,2011-03-18,1,0,3,8,24,256,280,146.33333333333334
1744,2011-03-18,1,0,3,9,18,192,210,204.33333333333334
1745,2011-03-18,1,0,3,10,43,74,117,202.33333333333334
1746,2011-03-18,1,0,3,11,55,104,159,162.0
1747,2011-03-18,1,0,3,12,72,123,195,157.0
1748,2011-03-18,1,0,3,13,57,118,175,176.33333333333334
1749,2011-03-18,1,0,3,14,71,103,174,181.33333333333334
1750,2011-03-18,1,0,3,15,62,111,173,174.0
1751,2011-03-18,1,0,3,16,67,137,204,183.66666666666666
1752,2011-03-18,1,0,3,17,95,237,332,236.33333333333334
1753,2011-03-18,1,0,3,18,84,247,331,289.0
1754,2011-03-18,1,0,3,19,58,132,190,284.3333333333333
1755,2011-03-18,1,0,3,20,46,103,149,223.33333333333334
1756,2011-03-18,1,0,3,21,22,91,113,150.66666666666666
1757,2011-03-18,1,0,3,22,55,63,118,126.66666666666667
1758,2011-03-18,1,0,3,23,26,60,86,105.66666666666667
1759,2011-03-19,1,0,3,0,26,50,76,93.33333333333333
1760,2011-03-19,1,0,3,1,16,35,51,71.0
1761,2011-03-19,1,0,3,2,5,20,25,50.666666666666664
1762,2011-03-19,1,0,3,3,1,7,8,28.0
1763,2011-03-19,1,0,3,4,1,2,3,12.0
1764,2011-03-19,1,0,3,5,0,2,2,4.333333333333333
1765,2011-03-19,1,0,3,6,0,10,10,5.0
1766,2011-03-19,1,0,3,7,4,9,13,8.333333333333334
1767,2011-03-19,1,0,3,8,11,37,48,23.666666666666668
1768,2011-03-19,1,0,3,9,35,41,76,45.666666666666664
1769,2011-03-19,1,0,3,10,55,85,140,88.0
1770,2011-03-19,1,0,3,11,90,106,196,137.33333333333334
1771,2011-03-19,1,0,3,12,126,141,267,201.0
1772,2011-03-19,1,0,3,13,174,127,301,254.66666666666666
1773,2011-03-19,1,0,3,14,168,144,312,293.3333333333333
1774,2011-03-19,1,0,3,15,170,143,313,308.6666666666667
1775,2011-03-19,1,0,3,16,175,129,304,309.6666666666667
1776,2011-03-19,1,0,3,17,138,140,278,298.3333333333333
1777,2011-03-19,1,0,3,18,92,125,217,266.3333333333333
1778,2011-03-19,1,0,3,19,38,116,154,216.33333333333334
1779,2011-03-19,1,0,3,20,39,69,108,159.66666666666666
1780,2011-03-19,1,0,3,21,20,73,93,118.33333333333333
1781,2011-03-19,1,0,3,22,27,45,72,91.0
1782,2011-03-19,1,0,3,23,13,37,50,71.66666666666667
1783,2011-03-20,1,0,3,0,7,33,40,54.0
1784,2011-03-20,1,0,3,1,2,22,24,38.0
1785,2011-03-20,1,0,3,2,6,24,30,31.333333333333332
1786,2011-03-20,1,0,3,3,1,11,12,22.0
1787,2011-03-20,1,0,3,4,2,1,3,15.0
1788,2011-03-20,1,0,3,5,3,6,9,8.0
1789,2011-03-20,1,0,3,6,1,3,4,5.333333333333333
1790,2011-03-20,1,0,3,7,5,9,14,9.0
1791,2011-03-20,1,0,3,8,7,30,37,18.333333333333332
1792,2011-03-20,1,0,3,9,35,43,78,43.0
1793,2011-03-20,1,0,3,10,55,81,136,83.66666666666667
1794,2011-03-20,1,0,3,11,92,111,203,139.0
1795,2011-03-20,1,0,3,12,120,108,228,189.0
1796,2011-03-20,1,0,3,13,88,115,203,211.33333333333334
1797,2011-03-20,1,0,3,14,145,134,279,236.66666666666666
1798,2011-03-20,1,0,3,15,172,136,308,263.3333333333333
1799,2011-03-20,1,0,3,16,92,132,224,270.3333333333333
1800,2011-03-20,1,0,3,17,83,143,226,252.66666666666666
1801,2011-03-20,1,0,3,18,58,98,156,202.0
1802,2011-03-20,1,0,3,19,21,58,79,153.66666666666666
1803,2011-03-20,1,0,3,20,21,46,67,100.66666666666667
1804,2011-03-20,1,0,3,21,10,39,49,65.0
1805,2011-03-20,1,0,3,22,8,30,38,51.333333333333336
1806,2011-03-20,1,0,3,23,13,11,24,37.0
1807,2011-03-21,2,0,3,0,2,11,13,25.0
1808,2011-03-21,2,0,3,1,1,6,7,14.666666666666666
1809,2011-03-21,2,0,3,2,1,5,6,8.666666666666666
1810,2011-03-21,2,0,3,3,0,1,1,4.666666666666667
1811,2011-03-21,2,0,3,5,1,1,2,3.0
1812,2011-03-21,2,0,3,6,2,30,32,11.666666666666666
1813,2011-03-21,2,0,3,7,3,15,18,17.333333333333332
1814,2011-03-21,2,0,3,8,3,95,98,49.333333333333336
1815,2011-03-21,2,0,3,9,12,115,127,81.0
1816,2011-03-21,2,0,3,10,17,45,62,95.66666666666667
1817,2011-03-21,2,0,3,11,32,47,79,89.33333333333333
1818,2011-03-21,2,0,3,12,25,56,81,74.0
1819,2011-03-21,2,0,3,13,35,77,112,90.66666666666667
1820,2011-03-21,2,0,3,14,36,65,101,98.0
1821,2011-03-21,2,0,3,15,41,66,107,106.66666666666667
1822,2011-03-21,2,0,3,16,29,112,141,116.33333333333333
1823,2011-03-21,2,0,3,17,41,231,272,173.33333333333334
1824,2011-03-21,2,0,3,18,44,232,276,229.66666666666666
1825,2011-03-21,2,0,3,19,22,199,221,256.3333333333333
1826,2011-03-21,2,0,3,20,16,106,122,206.33333333333334
1827,2011-03-21,2,0,3,21,12,79,91,144.66666666666666
1828,2011-03-21,2,0,3,22,18,60,78,97.0
1829,2011-03-21,2,0,3,23,8,22,30,66.33333333333333
1830,2011-03-22,2,0,3,0,4,7,11,39.666666666666664
1831,2011-03-22,2,0,3,1,6,13,19,20.0
1832,2011-03-22,2,0,3,2,0,1,1,10.333333333333334
1833,2011-03-22,2,0,3,3,3,2,5,8.333333333333334
1834,2011-03-22,2,0,3,4,0,1,1,2.3333333333333335
1835,2011-03-22,2,0,3,5,1,11,12,6.0
1836,2011-03-22,2,0,3,6,2,58,60,24.333333333333332
1837,2011-03-22,2,0,3,7,4,132,136,69.33333333333333
1838,2011-03-22,2,0,3,8,24,312,336,177.33333333333334
1839,2011-03-22,2,0,3,9,19,159,178,216.66666666666666
1840,2011-03-22,2,0,3,10,29,95,124,212.66666666666666
1841,2011-03-22,2,0,3,11,22,64,86,129.33333333333334
1842,2011-03-22,2,0,3,12,35,86,121,110.33333333333333
1843,2011-03-22,2,0,3,13,21,85,106,104.33333333333333
1844,2011-03-22,2,0,3,14,30,71,101,109.33333333333333
1845,2011-03-22,2,0,3,15,55,79,134,113.66666666666667
1846,2011-03-22,2,0,3,16,40,125,165,133.33333333333334
1847,2011-03-22,2,0,3,17,42,265,307,202.0
1848,2011-03-22,2,0,3,18,41,271,312,261.3333333333333
1849,2011-03-22,2,0,3,19,22,142,164,261.0
1850,2011-03-22,2,0,3,20,19,116,135,203.66666666666666
1851,2011-03-22,2,0,3,21,24,63,87,128.66666666666666
1852,2011-03-22,2,0,3,22,13,57,70,97.33333333333333
1853,2011-03-22,2,0,3,23,4,28,32,63.0
1854,2011-03-23,2,0,3,0,3,8,11,37.666666666666664
1855,2011-03-23,2,0,3,1,0,7,7,16.666666666666668
1856,2011-03-23,2,0,3,2,1,1,2,6.666666666666667
1857,2011-03-23,2,0,3,3,0,3,3,4.0
1858,2011-03-23,2,0,3,5,0,10,10,5.0
1859,2011-03-23,2,0,3,6,1,43,44,19.0
1860,2011-03-23,2,0,3,7,7,111,118,57.333333333333336
1861,2011-03-23,2,0,3,8,14,247,261,141.0
1862,2011-03-23,2,0,3,9,8,174,182,187.0
1863,2011-03-23,2,0,3,10,15,60,75,172.66666666666666
1864,2011-03-23,2,0,3,11,18,53,71,109.33333333333333
1865,2011-03-23,2,0,3,12,14,73,87,77.66666666666667
1866,2011-03-23,2,0,3,13,14,94,108,88.66666666666667
1867,2011-03-23,2,0,3,14,13,71,84,93.0
1868,2011-03-23,2,0,3,15,11,74,85,92.33333333333333
1869,2011-03-23,2,0,3,16,13,123,136,101.66666666666667
1870,2011-03-23,2,0,3,17,28,245,273,164.66666666666666
1871,2011-03-23,2,0,3,18,20,218,238,215.66666666666666
1872,2011-03-23,2,0,3,19,12,147,159,223.33333333333334
1873,2011-03-23,2,0,3,20,3,72,75,157.33333333333334
1874,2011-03-23,2,0,3,21,0,22,22,85.33333333333333
1875,2011-03-23,2,0,3,22,6,38,44,47.0
1876,2011-03-23,2,0,3,23,2,24,26,30.666666666666668
1877,2011-03-24,2,0,3,0,0,11,11,27.0
1878,2011-03-24,2,0,3,1,0,3,3,13.333333333333334
1879,2011-03-24,2,0,3,2,0,6,6,6.666666666666667
1880,2011-03-24,2,0,3,3,1,0,1,3.3333333333333335
1881,2011-03-24,2,0,3,4,0,1,1,2.6666666666666665
1882,2011-03-24,2,0,3,5,1,8,9,3.6666666666666665
1883,2011-03-24,2,0,3,6,0,41,41,17.0
1884,2011-03-24,2,0,3,7,2,106,108,52.666666666666664
1885,2011-03-24,2,0,3,8,4,120,124,91.0
1886,2011-03-24,2,0,3,9,3,94,97,109.66666666666667
1887,2011-03-24,2,0,3,10,10,55,65,95.33333333333333
1888,2011-03-24,2,0,3,11,10,61,71,77.66666666666667
1889,2011-03-24,2,0,3,12,12,82,94,76.66666666666667
1890,2011-03-24,2,0,3,13,11,90,101,88.66666666666667
1891,2011-03-24,2,0,3,14,17,66,83,92.66666666666667
1892,2011-03-24,2,0,3,15,13,77,90,91.33333333333333
1893,2011-03-24,2,0,3,16,6,78,84,85.66666666666667
1894,2011-03-24,2,0,3,17,12,221,233,135.66666666666666
1895,2011-03-24,2,0,3,18,17,197,214,177.0
1896,2011-03-24,2,0,3,19,16,122,138,195.0
1897,2011-03-24,2,0,3,20,8,110,118,156.66666666666666
1898,2011-03-24,2,0,3,21,11,67,78,111.33333333333333
1899,2011-03-24,2,0,3,22,3,59,62,86.0
1900,2011-03-24,2,0,3,23,9,24,33,57.666666666666664
1901,2011-03-25,2,0,3,0,1,17,18,37.666666666666664
1902,2011-03-25,2,0,3,1,0,5,5,18.666666666666668
1903,2011-03-25,2,0,3,2,0,5,5,9.333333333333334
1904,2011-03-25,2,0,3,3,0,2,2,4.0
1905,2011-03-25,2,0,3,4,3,2,5,4.0
1906,2011-03-25,2,0,3,5,0,9,9,5.333333333333333
1907,2011-03-25,2,0,3,6,0,32,32,15.333333333333334
1908,2011-03-25,2,0,3,7,4,100,104,48.333333333333336
1909,2011-03-25,2,0,3,8,9,228,237,124.33333333333333
1910,2011-03-25,2,0,3,9,16,150,166,169.0
1911,2011-03-25,2,0,3,10,15,53,68,157.0
1912,2011-03-25,2,0,3,11,17,58,75,103.0
1913,2011-03-25,2,0,3,12,37,108,145,96.0
1914,2011-03-25,2,0,3,13,34,104,138,119.33333333333333
1915,2011-03-25,2,0,3,14,30,103,133,138.66666666666666
1916,2011-03-25,2,0,3,15,43,79,122,131.0
1917,2011-03-25,2,0,3,16,23,127,150,135.0
1918,2011-03-25,2,0,3,17,23,202,225,165.66666666666666
1919,2011-03-25,2,0,3,18,8,190,198,191.0
1920,2011-03-25,2,0,3,19,9,126,135,186.0
1921,2011-03-25,2,0,3,20,6,75,81,138.0
1922,2011-03-25,2,0,3,21,11,64,75,97.0
1923,2011-03-25,2,0,3,22,3,40,43,66.33333333333333
1924,2011-03-25,2,0,3,23,8,31,39,52.333333333333336
1925,2011-03-26,2,0,3,0,3,25,28,36.666666666666664
1926,2011-03-26,2,0,3,1,3,24,27,31.333333333333332
1927,2011-03-26,2,0,3,2,4,21,25,26.666666666666668
1928,2011-03-26,2,0,3,3,2,7,9,20.333333333333332
1929,2011-03-26,2,0,3,4,2,4,6,13.333333333333334
1930,2011-03-26,2,0,3,5,0,8,8,7.666666666666667
1931,2011-03-26,2,0,3,6,2,8,10,8.0
1932,2011-03-26,2,0,3,7,18,23,41,19.666666666666668
1933,2011-03-26,2,0,3,8,24,42,66,39.0
1934,2011-03-26,2,0,3,9,32,68,100,69.0
1935,2011-03-26,2,0,3,10,32,93,125,97.0
1936,2011-03-26,2,0,3,11,75,93,168,131.0
1937,2011-03-26,2,0,3,12,98,129,227,173.33333333333334
1938,2011-03-26,2,0,3,13,94,145,239,211.33333333333334
1939,2011-03-26,2,0,3,14,93,123,216,227.33333333333334
1940,2011-03-26,2,0,3,15,110,109,219,224.66666666666666
1941,2011-03-26,2,0,3,16,118,130,248,227.66666666666666
1942,2011-03-26,2,0,3,17,102,101,203,223.33333333333334
1943,2011-03-26,2,0,3,18,64,89,153,201.33333333333334
1944,2011-03-26,2,0,3,19,45,93,138,164.66666666666666
1945,2011-03-26,2,0,3,20,18,67,85,125.33333333333333
1946,2011-03-26,2,0,3,21,15,36,51,91.33333333333333
1947,2011-03-26,2,0,3,22,17,46,63,66.33333333333333
1948,2011-03-26,2,0,3,23,10,31,41,51.666666666666664
1949,2011-03-27,2,0,3,0,5,26,31,45.0
1950,2011-03-27,2,0,3,1,3,17,20,30.666666666666668
1951,2011-03-27,2,0,3,2,6,15,21,24.0
1952,2011-03-27,2,0,3,3,0,14,14,18.333333333333332
1953,2011-03-27,2,0,3,4,1,5,6,13.666666666666666
1954,2011-03-27,2,0,3,6,0,2,2,7.333333333333333
1955,2011-03-27,2,0,3,7,0,7,7,5.0
1956,2011-03-27,2,0,3,8,6,8,14,7.666666666666667
1957,2011-03-27,2,0,3,9,17,37,54,25.0
1958,2011-03-27,2,0,3,10,27,59,86,51.333333333333336
1959,2011-03-27,2,0,3,11,23,85,108,82.66666666666667
1960,2011-03-27,2,0,3,12,43,120,163,119.0
1961,2011-03-27,2,0,3,13,47,100,147,139.33333333333334
1962,2011-03-27,2,0,3,14,61,103,164,158.0
1963,2011-03-27,2,0,3,15,61,111,172,161.0
1964,2011-03-27,2,0,3,16,45,98,143,159.66666666666666
1965,2011-03-27,2,0,3,17,50,109,159,158.0
1966,2011-03-27,2,0,3,18,32,105,137,146.33333333333334
1967,2011-03-27,2,0,3,19,23,80,103,133.0
1968,2011-03-27,2,0,3,20,7,50,57,99.0
1969,2011-03-27,2,0,3,21,7,29,36,65.33333333333333
1970,2011-03-27,2,0,3,22,5,25,30,41.0
1971,2011-03-27,2,0,3,23,3,16,19,28.333333333333332
1972,2011-03-28,2,0,3,0,1,11,12,20.333333333333332
1973,2011-03-28,2,0,3,1,2,4,6,12.333333333333334
1974,2011-03-28,2,0,3,2,0,5,5,7.666666666666667
1975,2011-03-28,2,0,3,3,0,2,2,4.333333333333333
1976,2011-03-28,2,0,3,5,0,8,8,5.0
1977,2011-03-28,2,0,3,6,0,40,40,16.666666666666668
1978,2011-03-28,2,0,3,7,6,104,110,52.666666666666664
1979,2011-03-28,2,0,3,8,15,239,254,134.66666666666666
1980,2011-03-28,2,0,3,9,12,109,121,161.66666666666666
1981,2011-03-28,2,0,3,10,22,47,69,148.0
1982,2011-03-28,2,0,3,11,18,39,57,82.33333333333333
1983,2011-03-28,2,0,3,12,8,71,79,68.33333333333333
1984,2011-03-28,2,0,3,13,14,69,83,73.0
1985,2011-03-28,2,0,3,14,15,65,80,80.66666666666667
1986,2011-03-28,2,0,3,15,19,53,72,78.33333333333333
1987,2011-03-28,2,0,3,16,15,117,132,94.66666666666667
1988,2011-03-28,2,0,3,17,25,227,252,152.0
1989,2011-03-28,2,0,3,18,21,220,241,208.33333333333334
1990,2011-03-28,2,0,3,19,17,156,173,222.0
1991,2011-03-28,2,0,3,20,5,107,112,175.33333333333334
1992,2011-03-28,2,0,3,21,6,55,61,115.33333333333333
1993,2011-03-28,2,0,3,22,0,40,40,71.0
1994,2011-03-28,2,0,3,23,1,18,19,40.0
1995,2011-03-29,2,0,3,0,1,15,16,25.0
1996,2011-03-29,2,0,3,1,0,4,4,13.0
1997,2011-03-29,2,0,3,2,0,3,3,7.666666666666667
1998,2011-03-29,2,0,3,3,2,1,3,3.3333333333333335
1999,2011-03-29,2,0,3,4,1,1,2,2.6666666666666665
2000,2011-03-29,2,0,3,5,0,8,8,4.333333333333333
2001,2011-03-29,2,0,3,6,4,46,50,20.0
2002,2011-03-29,2,0,3,7,5,128,133,63.666666666666664
2003,2011-03-29,2,0,3,8,19,268,287,156.66666666666666
2004,2011-03-29,2,0,3,9,16,156,172,197.33333333333334
2005,2011-03-29,2,0,3,10,13,46,59,172.66666666666666
2006,2011-03-29,2,0,3,11,18,63,81,104.0
2007,2011-03-29,2,0,3,12,29,77,106,82.0
2008,2011-03-29,2,0,3,13,24,80,104,97.0
2009,2011-03-29,2,0,3,14,20,66,86,98.66666666666667
2010,2011-03-29,2,0,3,15,22,65,87,92.33333333333333
2011,2011-03-29,2,0,3,16,12,124,136,103.0
2012,2011-03-29,2,0,3,17,34,265,299,174.0
2013,2011-03-29,2,0,3,18,42,252,294,243.0
2014,2011-03-29,2,0,3,19,20,170,190,261.0
2015,2011-03-29,2,0,3,20,13,119,132,205.33333333333334
2016,2011-03-29,2,0,3,21,8,75,83,135.0
2017,2011-03-29,2,0,3,22,6,49,55,90.0
2018,2011-03-29,2,0,3,23,8,27,35,57.666666666666664
2019,2011-03-30,2,0,3,0,3,8,11,33.666666666666664
2020,2011-03-30,2,0,3,1,1,9,10,18.666666666666668
2021,2011-03-30,2,0,3,2,0,4,4,8.333333333333334
2022,2011-03-30,2,0,3,3,0,4,4,6.0
2023,2011-03-30,2,0,3,4,1,0,1,3.0
2024,2011-03-30,2,0,3,5,0,7,7,4.0
2025,2011-03-30,2,0,3,6,4,44,48,18.666666666666668
2026,2011-03-30,2,0,3,7,8,128,136,63.666666666666664
2027,2011-03-30,2,0,3,8,16,247,263,149.0
2028,2011-03-30,2,0,3,9,7,147,154,184.33333333333334
2029,2011-03-30,2,0,3,10,13,51,64,160.33333333333334
2030,2011-03-30,2,0,3,11,26,64,90,102.66666666666667
2031,2011-03-30,2,0,3,12,15,65,80,78.0
2032,2011-03-30,2,0,3,13,14,84,98,89.33333333333333
2033,2011-03-30,2,0,3,14,16,64,80,86.0
2034,2011-03-30,2,0,3,15,14,56,70,82.66666666666667
2035,2011-03-30,2,0,3,16,0,36,36,62.0
2036,2011-03-30,2,0,3,17,11,105,116,74.0
2037,2011-03-30,2,0,3,18,6,79,85,79.0
2038,2011-03-30,2,0,3,19,5,67,72,91.0
2039,2011-03-30,2,0,3,20,4,40,44,67.0
2040,2011-03-30,2,0,3,21,0,27,27,47.666666666666664
2041,2011-03-30,2,0,3,22,3,21,24,31.666666666666668
2042,2011-03-30,2,0,3,23,1,11,12,21.0
2043,2011-03-31,2,0,3,0,0,3,3,13.0
2044,2011-03-31,2,0,3,1,1,4,5,6.666666666666667
2045,2011-03-31,2,0,3,2,0,5,5,4.333333333333333
2046,2011-03-31,2,0,3,3,0,1,1,3.6666666666666665
2047,2011-03-31,2,0,3,4,0,2,2,2.6666666666666665
2048,2011-03-31,2,0,3,5,0,8,8,3.6666666666666665
2049,2011-03-31,2,0,3,6,2,34,36,15.333333333333334
2050,2011-03-31,2,0,3,7,5,87,92,45.333333333333336
2051,2011-03-31,2,0,3,8,7,185,192,106.66666666666667
2052,2011-03-31,2,0,3,9,6,126,132,138.66666666666666
2053,2011-03-31,2,0,3,10,15,54,69,131.0
2054,2011-03-31,2,0,3,11,6,52,58,86.33333333333333
2055,2011-03-31,2,0,3,12,17,73,90,72.33333333333333
2056,2011-03-31,2,0,3,13,13,55,68,72.0
2057,2011-03-31,2,0,3,14,27,49,76,78.0
2058,2011-03-31,2,0,3,15,4,61,65,69.66666666666667
2059,2011-03-31,2,0,3,16,13,72,85,75.33333333333333
2060,2011-03-31,2,0,3,17,15,153,168,106.0
2061,2011-03-31,2,0,3,18,12,165,177,143.33333333333334
2062,2011-03-31,2,0,3,19,12,118,130,158.33333333333334
2063,2011-03-31,2,0,3,20,6,79,85,130.66666666666666
2064,2011-03-31,2,0,3,21,7,53,60,91.66666666666667
2065,2011-03-31,2,0,3,22,7,44,51,65.33333333333333
2066,2011-03-31,2,0,3,23,4,23,27,46.0
2067,2011-04-01,2,0,4,0,0,6,6,28.0
2068,2011-04-01,2,0,4,1,0,4,4,12.333333333333334
2069,2011-04-01,2,0,4,2,0,7,7,5.666666666666667
2070,2011-04-01,2,0,4,3,0,4,4,5.0
2071,2011-04-01,2,0,4,4,0,3,3,4.666666666666667
2072,2011-04-01,2,0,4,5,1,11,12,6.333333333333333
2073,2011-04-01,2,0,4,6,2,26,28,14.333333333333334
2074,2011-04-01,2,0,4,7,4,91,95,45.0
2075,2011-04-01,2,0,4,8,8,198,206,109.66666666666667
2076,2011-04-01,2,0,4,9,11,162,173,158.0
2077,2011-04-01,2,0,4,10,12,63,75,151.33333333333334
2078,2011-04-01,2,0,4,11,17,72,89,112.33333333333333
2079,2011-04-01,2,0,4,12,15,80,95,86.33333333333333
2080,2011-04-01,2,0,4,13,18,92,110,98.0
2081,2011-04-01,2,0,4,14,26,61,87,97.33333333333333
2082,2011-04-01,2,0,4,15,30,81,111,102.66666666666667
2083,2011-04-01,2,0,4,16,42,125,167,121.66666666666667
2084,2011-04-01,2,0,4,17,36,245,281,186.33333333333334
2085,2011-04-01,2,0,4,18,36,205,241,229.66666666666666
2086,2011-04-01,2,0,4,19,16,120,136,219.33333333333334
2087,2011-04-01,2,0,4,20,2,75,77,151.33333333333334
2088,2011-04-01,2,0,4,21,9,84,93,102.0
2089,2011-04-01,2,0,4,22,10,64,74,81.33333333333333
2090,2011-04-01,2,0,4,23,12,41,53,73.33333333333333
2091,2011-04-02,2,0,4,0,3,29,32,53.0
2092,2011-04-02,2,0,4,1,4,28,32,39.0
2093,2011-04-02,2,0,4,2,1,20,21,28.333333333333332
2094,2011-04-02,2,0,4,3,1,8,9,20.666666666666668
2095,2011-04-02,2,0,4,4,0,5,5,11.666666666666666
2096,2011-04-02,2,0,4,5,1,4,5,6.333333333333333
2097,2011-04-02,2,0,4,6,5,7,12,7.333333333333333
2098,2011-04-02,2,0,4,7,2,16,18,11.666666666666666
2099,2011-04-02,2,0,4,8,10,45,55,28.333333333333332
2100,2011-04-02,2,0,4,9,22,65,87,53.333333333333336
2101,2011-04-02,2,0,4,10,41,113,154,98.66666666666667
2102,2011-04-02,2,0,4,11,72,126,198,146.33333333333334
2103,2011-04-02,2,0,4,12,84,100,184,178.66666666666666
2104,2011-04-02,2,0,4,13,56,81,137,173.0
2105,2011-04-02,2,0,4,14,97,93,190,170.33333333333334
2106,2011-04-02,2,0,4,15,72,64,136,154.33333333333334
2107,2011-04-02,2,0,4,16,111,85,196,174.0
2108,2011-04-02,2,0,4,17,89,95,184,172.0
2109,2011-04-02,2,0,4,18,69,110,179,186.33333333333334
2110,2011-04-02,2,0,4,19,71,77,148,170.33333333333334
2111,2011-04-02,2,0,4,20,29,56,85,137.33333333333334
2112,2011-04-02,2,0,4,21,24,53,77,103.33333333333333
2113,2011-04-02,2,0,4,22,14,41,55,72.33333333333333
2114,2011-04-02,2,0,4,23,20,33,53,61.666666666666664
2115,2011-04-03,2,0,4,0,8,31,39,49.0
2116,2011-04-03,2,0,4,1,8,26,34,42.0
2117,2011-04-03,2,0,4,2,5,19,24,32.333333333333336
2118,2011-04-03,2,0,4,3,3,8,11,23.0
2119,2011-04-03,2,0,4,4,3,0,3,12.666666666666666
2120,2011-04-03,2,0,4,5,1,4,5,6.333333333333333
2121,2011-04-03,2,0,4,6,10,23,33,13.666666666666666
2122,2011-04-03,2,0,4,7,13,20,33,23.666666666666668
2123,2011-04-03,2,0,4,8,18,44,62,42.666666666666664
2124,2011-04-03,2,0,4,9,68,74,142,79.0
2125,2011-04-03,2,0,4,10,111,104,215,139.66666666666666
2126,2011-04-03,2,0,4,11,139,104,243,200.0
2127,2011-04-03,2,0,4,12,166,147,313,257.0
2128,2011-04-03,2,0,4,13,219,148,367,307.6666666666667
2129,2011-04-03,2,0,4,14,240,109,349,343.0
2130,2011-04-03,2,0,4,15,174,118,292,336.0
2131,2011-04-03,2,0,4,16,147,156,303,314.6666666666667
2132,2011-04-03,2,0,4,17,148,126,274,289.6666666666667
2133,2011-04-03,2,0,4,18,71,101,172,249.66666666666666
2134,2011-04-03,2,0,4,19,51,93,144,196.66666666666666
2135,2011-04-03,2,0,4,20,24,55,79,131.66666666666666
2136,2011-04-03,2,0,4,21,8,37,45,89.33333333333333
2137,2011-04-03,2,0,4,22,7,29,36,53.333333333333336
2138,2011-04-03,2,0,4,23,9,22,31,37.333333333333336
2139,2011-04-04,2,0,4,0,1,5,6,24.333333333333332
2140,2011-04-04,2,0,4,1,7,4,11,16.0
2141,2011-04-04,2,0,4,2,1,1,2,6.333333333333333
2142,2011-04-04,2,0,4,3,1,0,1,4.666666666666667
2143,2011-04-04,2,0,4,4,1,1,2,1.6666666666666667
2144,2011-04-04,2,0,4,5,0,7,7,3.3333333333333335
2145,2011-04-04,2,0,4,6,3,43,46,18.333333333333332
2146,2011-04-04,2,0,4,7,7,150,157,70.0
2147,2011-04-04,2,0,4,8,31,308,339,180.66666666666666
2148,2011-04-04,2,0,4,9,24,134,158,218.0
2149,2011-04-04,2,0,4,10,35,55,90,195.66666666666666
2150,2011-04-04,2,0,4,11,58,66,124,124.0
2151,2011-04-04,2,0,4,12,59,98,157,123.66666666666667
2152,2011-04-04,2,0,4,13,47,92,139,140.0
2153,2011-04-04,2,0,4,14,47,76,123,139.66666666666666
2154,2011-04-04,2,0,4,15,47,96,143,135.0
2155,2011-04-04,2,0,4,16,59,130,189,151.66666666666666
2156,2011-04-04,2,0,4,17,83,283,366,232.66666666666666
2157,2011-04-04,2,0,4,18,78,308,386,313.6666666666667
2158,2011-04-04,2,0,4,19,51,227,278,343.3333333333333
2159,2011-04-04,2,0,4,20,40,133,173,279.0
2160,2011-04-04,2,0,4,21,19,76,95,182.0
2161,2011-04-04,2,0,4,22,17,58,75,114.33333333333333
2162,2011-04-04,2,0,4,23,18,30,48,72.66666666666667
2163,2011-04-05,2,0,4,0,10,12,22,48.333333333333336
2164,2011-04-05,2,0,4,1,10,5,15,28.333333333333332
2165,2011-04-05,2,0,4,2,0,5,5,14.0
2166,2011-04-05,2,0,4,3,1,3,4,8.0
2167,2011-04-05,2,0,4,4,0,2,2,3.6666666666666665
2168,2011-04-05,2,0,4,5,0,5,5,3.6666666666666665
2169,2011-04-05,2,0,4,6,2,36,38,15.0
2170,2011-04-05,2,0,4,7,10,124,134,59.0
2171,2011-04-05,2,0,4,8,9,148,157,109.66666666666667
2172,2011-04-05,2,0,4,9,2,44,46,112.33333333333333
2173,2011-04-05,2,0,4,10,3,25,28,77.0
2174,2011-04-05,2,0,4,11,1,18,19,31.0
2175,2011-04-05,2,0,4,12,6,32,38,28.333333333333332
2176,2011-04-05,2,0,4,13,5,51,56,37.666666666666664
2177,2011-04-05,2,0,4,14,9,67,76,56.666666666666664
2178,2011-04-05,2,0,4,15,6,62,68,66.66666666666667
2179,2011-04-05,2,0,4,16,17,113,130,91.33333333333333
2180,2011-04-05,2,0,4,17,27,246,273,157.0
2181,2011-04-05,2,0,4,18,19,248,267,223.33333333333334
2182,2011-04-05,2,0,4,19,12,148,160,233.33333333333334
2183,2011-04-05,2,0,4,20,4,87,91,172.66666666666666
2184,2011-04-05,2,0,4,21,8,81,89,113.33333333333333
2185,2011-04-05,2,0,4,22,3,43,46,75.33333333333333
2186,2011-04-05,2,0,4,23,3,23,26,53.666666666666664
2187,2011-04-06,2,0,4,0,0,15,15,29.0
2188,2011-04-06,2,0,4,1,0,2,2,14.333333333333334
2189,2011-04-06,2,0,4,2,0,5,5,7.333333333333333
2190,2011-04-06,2,0,4,3,0,4,4,3.6666666666666665
2191,2011-04-06,2,0,4,4,0,1,1,3.3333333333333335
2192,2011-04-06,2,0,4,5,1,12,13,6.0
2193,2011-04-06,2,0,4,6,4,52,56,23.333333333333332
2194,2011-04-06,2,0,4,7,3,130,133,67.33333333333333
2195,2011-04-06,2,0,4,8,17,308,325,171.33333333333334
2196,2011-04-06,2,0,4,9,8,157,165,207.66666666666666
2197,2011-04-06,2,0,4,10,21,48,69,186.33333333333334
2198,2011-04-06,2,0,4,11,23,70,93,109.0
2199,2011-04-06,2,0,4,12,22,112,134,98.66666666666667
2200,2011-04-06,2,0,4,13,29,83,112,113.0
2201,2011-04-06,2,0,4,14,35,80,115,120.33333333333333
2202,2011-04-06,2,0,4,15,34,83,117,114.66666666666667
2203,2011-04-06,2,0,4,16,27,142,169,133.66666666666666
2204,2011-04-06,2,0,4,17,53,303,356,214.0
2205,2011-04-06,2,0,4,18,43,282,325,283.3333333333333
2206,2011-04-06,2,0,4,19,36,196,232,304.3333333333333
2207,2011-04-06,2,0,4,20,15,126,141,232.66666666666666
2208,2011-04-06,2,0,4,21,18,84,102,158.33333333333334
2209,2011-04-06,2,0,4,22,13,71,84,109.0
2210,2011-04-06,2,0,4,23,11,29,40,75.33333333333333
2211,2011-04-07,2,0,4,0,5,15,20,48.0
2212,2011-04-07,2,0,4,1,2,11,13,24.333333333333332
2213,2011-04-07,2,0,4,2,0,7,7,13.333333333333334
2214,2011-04-07,2,0,4,3,0,3,3,7.666666666666667
2215,2011-04-07,2,0,4,4,0,1,1,3.6666666666666665
2216,2011-04-07,2,0,4,5,0,6,6,3.3333333333333335
2217,2011-04-07,2,0,4,6,5,59,64,23.666666666666668
2218,2011-04-07,2,0,4,7,8,152,160,76.66666666666667
2219,2011-04-07,2,0,4,8,23,291,314,179.33333333333334
2220,2011-04-07,2,0,4,9,15,155,170,214.66666666666666
2221,2011-04-07,2,0,4,10,29,66,95,193.0
2222,2011-04-07,2,0,4,11,36,86,122,129.0
2223,2011-04-07,2,0,4,12,39,114,153,123.33333333333333
2224,2011-04-07,2,0,4,13,36,99,135,136.66666666666666
2225,2011-04-07,2,0,4,14,46,111,157,148.33333333333334
2226,2011-04-07,2,0,4,15,27,133,160,150.66666666666666
2227,2011-04-07,2,0,4,16,52,161,213,176.66666666666666
2228,2011-04-07,2,0,4,17,63,280,343,238.66666666666666
2229,2011-04-07,2,0,4,18,68,265,333,296.3333333333333
2230,2011-04-07,2,0,4,19,34,192,226,300.6666666666667
2231,2011-04-07,2,0,4,20,37,166,203,254.0
2232,2011-04-07,2,0,4,21,19,89,108,179.0
2233,2011-04-07,2,0,4,22,18,63,81,130.66666666666666
2234,2011-04-07,2,0,4,23,9,45,54,81.0
2235,2011-04-08,2,0,4,0,4,21,25,53.333333333333336
2236,2011-04-08,2,0,4,1,3,6,9,29.333333333333332
2237,2011-04-08,2,0,4,2,3,10,13,15.666666666666666
2238,2011-04-08,2,0,4,3,0,1,1,7.666666666666667
2239,2011-04-08,2,0,4,4,0,1,1,5.0
2240,2011-04-08,2,0,4,5,1,8,9,3.6666666666666665
2241,2011-04-08,2,0,4,6,2,33,35,15.0
2242,2011-04-08,2,0,4,7,4,109,113,52.333333333333336
2243,2011-04-08,2,0,4,8,13,208,221,123.0
2244,2011-04-08,2,0,4,9,17,168,185,173.0
2245,2011-04-08,2,0,4,10,10,63,73,159.66666666666666
2246,2011-04-08,2,0,4,11,19,79,98,118.66666666666667
2247,2011-04-08,2,0,4,12,29,51,80,83.66666666666667
2248,2011-04-08,2,0,4,13,7,35,42,73.33333333333333
2249,2011-04-08,2,0,4,14,2,13,15,45.666666666666664
2250,2011-04-08,2,0,4,15,1,24,25,27.333333333333332
2251,2011-04-08,2,0,4,16,2,58,60,33.333333333333336
2252,2011-04-08,2,0,4,17,10,138,148,77.66666666666667
2253,2011-04-08,2,0,4,18,8,54,62,90.0
2254,2011-04-08,2,0,4,19,1,52,53,87.66666666666667
2255,2011-04-08,2,0,4,20,12,51,63,59.333333333333336
2256,2011-04-08,2,0,4,21,11,43,54,56.666666666666664
2257,2011-04-08,2,0,4,22,9,42,51,56.0
2258,2011-04-08,2,0,4,23,4,31,35,46.666666666666664
2259,2011-04-09,2,0,4,0,5,26,31,39.0
2260,2011-04-09,2,0,4,1,3,17,20,28.666666666666668
2261,2011-04-09,2,0,4,2,2,15,17,22.666666666666668
2262,2011-04-09,2,0,4,3,3,11,14,17.0
2263,2011-04-09,2,0,4,4,0,3,3,11.333333333333334
2264,2011-04-09,2,0,4,5,0,5,5,7.333333333333333
2265,2011-04-09,2,0,4,6,0,13,13,7.0
2266,2011-04-09,2,0,4,7,8,13,21,13.0
2267,2011-04-09,2,0,4,8,7,47,54,29.333333333333332
2268,2011-04-09,2,0,4,9,27,71,98,57.666666666666664
2269,2011-04-09,2,0,4,10,43,90,133,95.0
2270,2011-04-09,2,0,4,11,51,91,142,124.33333333333333
2271,2011-04-09,2,0,4,12,79,123,202,159.0
2272,2011-04-09,2,0,4,13,114,108,222,188.66666666666666
2273,2011-04-09,2,0,4,14,94,118,212,212.0
2274,2011-04-09,2,0,4,15,85,116,201,211.66666666666666
2275,2011-04-09,2,0,4,16,73,118,191,201.33333333333334
2276,2011-04-09,2,0,4,17,128,129,257,216.33333333333334
2277,2011-04-09,2,0,4,18,48,129,177,208.33333333333334
2278,2011-04-09,2,0,4,19,47,83,130,188.0
2279,2011-04-09,2,0,4,20,19,74,93,133.33333333333334
2280,2011-04-09,2,0,4,21,10,65,75,99.33333333333333
2281,2011-04-09,2,0,4,22,21,66,87,85.0
2282,2011-04-09,2,0,4,23,12,45,57,73.0
2283,2011-04-10,2,0,4,0,5,48,53,65.66666666666667
2284,2011-04-10,2,0,4,1,6,31,37,49.0
2285,2011-04-10,2,0,4,2,12,24,36,42.0
2286,2011-04-10,2,0,4,3,5,11,16,29.666666666666668
2287,2011-04-10,2,0,4,4,3,2,5,19.0
2288,2011-04-10,2,0,4,5,0,4,4,8.333333333333334
2289,2011-04-10,2,0,4,6,0,4,4,4.333333333333333
2290,2011-04-10,2,0,4,7,3,7,10,6.0
2291,2011-04-10,2,0,4,8,17,38,55,23.0
2292,2011-04-10,2,0,4,9,31,50,81,48.666666666666664
2293,2011-04-10,2,0,4,10,69,81,150,95.33333333333333
2294,2011-04-10,2,0,4,11,93,109,202,144.33333333333334
2295,2011-04-10,2,0,4,12,94,136,230,194.0
2296,2011-04-10,2,0,4,13,121,142,263,231.66666666666666
2297,2011-04-10,2,0,4,14,148,133,281,258.0
2298,2011-04-10,2,0,4,15,156,141,297,280.3333333333333
2299,2011-04-10,2,0,4,16,135,153,288,288.6666666666667
2300,2011-04-10,2,0,4,17,84,152,236,273.6666666666667
2301,2011-04-10,2,0,4,18,103,137,240,254.66666666666666
2302,2011-04-10,2,0,4,19,47,84,131,202.33333333333334
2303,2011-04-10,2,0,4,20,21,71,92,154.33333333333334
2304,2011-04-10,2,0,4,21,18,77,95,106.0
2305,2011-04-10,2,0,4,22,12,45,57,81.33333333333333
2306,2011-04-10,2,0,4,23,5,27,32,61.333333333333336
2307,2011-04-11,2,0,4,0,7,16,23,37.333333333333336
2308,2011-04-11,2,0,4,1,1,3,4,19.666666666666668
2309,2011-04-11,2,0,4,2,7,2,9,12.0
2310,2011-04-11,2,0,4,4,0,1,1,4.666666666666667
2311,2011-04-11,2,0,4,5,1,12,13,7.666666666666667
2312,2011-04-11,2,0,4,6,2,59,61,25.0
2313,2011-04-11,2,0,4,7,12,164,176,83.33333333333333
2314,2011-04-11,2,0,4,8,28,286,314,183.66666666666666
2315,2011-04-11,2,0,4,9,33,132,165,218.33333333333334
2316,2011-04-11,2,0,4,10,41,55,96,191.66666666666666
2317,2011-04-11,2,0,4,11,45,59,104,121.66666666666667
2318,2011-04-11,2,0,4,12,37,97,134,111.33333333333333
2319,2011-04-11,2,0,4,13,62,77,139,125.66666666666667
2320,2011-04-11,2,0,4,14,60,85,145,139.33333333333334
2321,2011-04-11,2,0,4,15,56,85,141,141.66666666666666
2322,2011-04-11,2,0,4,16,73,162,235,173.66666666666666
2323,2011-04-11,2,0,4,17,100,352,452,276.0
2324,2011-04-11,2,0,4,18,93,290,383,356.6666666666667
2325,2011-04-11,2,0,4,19,73,211,284,373.0
2326,2011-04-11,2,0,4,20,44,122,166,277.6666666666667
2327,2011-04-11,2,0,4,21,39,119,158,202.66666666666666
2328,2011-04-11,2,0,4,22,25,66,91,138.33333333333334
2329,2011-04-11,2,0,4,23,16,38,54,101.0
2330,2011-04-12,2,0,4,0,11,13,24,56.333333333333336
2331,2011-04-12,2,0,4,1,6,7,13,30.333333333333332
2332,2011-04-12,2,0,4,2,7,7,14,17.0
2333,2011-04-12,2,0,4,3,0,1,1,9.333333333333334
2334,2011-04-12,2,0,4,4,4,2,6,7.0
2335,2011-04-12,2,0,4,5,1,15,16,7.666666666666667
2336,2011-04-12,2,0,4,6,3,55,58,26.666666666666668
2337,2011-04-12,2,0,4,7,12,177,189,87.66666666666667
2338,2011-04-12,2,0,4,8,15,211,226,157.66666666666666
2339,2011-04-12,2,0,4,9,4,50,54,156.33333333333334
2340,2011-04-12,2,0,4,10,6,34,40,106.66666666666667
2341,2011-04-12,2,0,4,11,11,38,49,47.666666666666664
2342,2011-04-12,2,0,4,12,9,83,92,60.333333333333336
2343,2011-04-12,2,0,4,13,22,84,106,82.33333333333333
2344,2011-04-12,2,0,4,14,16,28,44,80.66666666666667
2345,2011-04-12,2,0,4,15,24,54,78,76.0
2346,2011-04-12,2,0,4,16,19,80,99,73.66666666666667
2347,2011-04-12,2,0,4,17,29,262,291,156.0
2348,2011-04-12,2,0,4,18,21,203,224,204.66666666666666
2349,2011-04-12,2,0,4,19,3,127,130,215.0
2350,2011-04-12,2,0,4,20,9,94,103,152.33333333333334
2351,2011-04-12,2,0,4,21,10,74,84,105.66666666666667
2352,2011-04-12,2,0,4,22,7,47,54,80.33333333333333
2353,2011-04-12,2,0,4,23,8,31,39,59.0
2354,2011-04-13,2,0,4,0,3,12,15,36.0
2355,2011-04-13,2,0,4,1,0,1,1,18.333333333333332
2356,2011-04-13,2,0,4,2,0,2,2,6.0
2357,2011-04-13,2,0,4,3,0,2,2,1.6666666666666667
2358,2011-04-13,2,0,4,4,1,2,3,2.3333333333333335
2359,2011-04-13,2,0,4,5,1,4,5,3.3333333333333335
2360,2011-04-13,2,0,4,6,1,33,34,14.0
2361,2011-04-13,2,0,4,7,3,67,70,36.333333333333336
2362,2011-04-13,2,0,4,8,6,158,164,89.33333333333333
2363,2011-04-13,2,0,4,9,2,63,65,99.66666666666667
2364,2011-04-13,2,0,4,10,4,42,46,91.66666666666667
2365,2011-04-13,2,0,4,11,4,57,61,57.333333333333336
2366,2011-04-13,2,0,4,12,12,83,95,67.33333333333333
2367,2011-04-13,2,0,4,13,6,55,61,72.33333333333333
2368,2011-04-13,2,0,4,14,24,82,106,87.33333333333333
2369,2011-04-13,2,0,4,15,12,69,81,82.66666666666667
2370,2011-04-13,2,0,4,16,23,119,142,109.66666666666667
2371,2011-04-13,2,0,4,17,25,284,309,177.33333333333334
2372,2011-04-13,2,0,4,18,28,293,321,257.3333333333333
2373,2011-04-13,2,0,4,19,15,160,175,268.3333333333333
2374,2011-04-13,2,0,4,20,7,119,126,207.33333333333334
2375,2011-04-13,2,0,4,21,17,100,117,139.33333333333334
2376,2011-04-13,2,0,4,22,10,89,99,114.0
2377,2011-04-13,2,0,4,23,5,57,62,92.66666666666667
2378,2011-04-14,2,0,4,0,3,18,21,60.666666666666664
2379,2011-04-14,2,0,4,1,1,9,10,31.0
2380,2011-04-14,2,0,4,2,0,3,3,11.333333333333334
2381,2011-04-14,2,0,4,3,0,2,2,5.0
2382,2011-04-14,2,0,4,4,1,8,9,4.666666666666667
2383,2011-04-14,2,0,4,5,2,12,14,8.333333333333334
2384,2011-04-14,2,0,4,6,4,66,70,31.0
2385,2011-04-14,2,0,4,7,11,182,193,92.33333333333333
2386,2011-04-14,2,0,4,8,21,316,337,200.0
2387,2011-04-14,2,0,4,9,18,152,170,233.33333333333334
2388,2011-04-14,2,0,4,10,21,68,89,198.66666666666666
2389,2011-04-14,2,0,4,11,28,87,115,124.66666666666667
2390,2011-04-14,2,0,4,12,35,110,145,116.33333333333333
2391,2011-04-14,2,0,4,13,38,121,159,139.66666666666666
2392,2011-04-14,2,0,4,14,36,101,137,147.0
2393,2011-04-14,2,0,4,15,57,85,142,146.0
2394,2011-04-14,2,0,4,16,49,153,202,160.33333333333334
2395,2011-04-14,2,0,4,17,50,338,388,244.0
2396,2011-04-14,2,0,4,18,47,290,337,309.0
2397,2011-04-14,2,0,4,19,37,222,259,328.0
2398,2011-04-14,2,0,4,20,22,147,169,255.0
2399,2011-04-14,2,0,4,21,19,126,145,191.0
2400,2011-04-14,2,0,4,22,22,82,104,139.33333333333334
2401,2011-04-14,2,0,4,23,7,40,47,98.66666666666667
2402,2011-04-15,2,0,4,0,6,21,27,59.333333333333336
2403,2011-04-15,2,0,4,1,6,9,15,29.666666666666668
2404,2011-04-15,2,0,4,2,8,10,18,20.0
2405,2011-04-15,2,0,4,3,0,3,3,12.0
2406,2011-04-15,2,0,4,4,0,3,3,8.0
2407,2011-04-15,2,0,4,5,2,11,13,6.333333333333333
2408,2011-04-15,2,0,4,6,5,42,47,21.0
2409,2011-04-15,2,0,4,7,10,139,149,69.66666666666667
2410,2011-04-15,2,0,4,8,21,279,300,165.33333333333334
2411,2011-04-15,2,0,4,9,16,162,178,209.0
2412,2011-04-15,2,0,4,10,31,91,122,200.0
2413,2011-04-15,2,0,4,11,41,95,136,145.33333333333334
2414,2011-04-15,2,0,4,12,45,155,200,152.66666666666666
2415,2011-04-15,2,0,4,13,47,133,180,172.0
2416,2011-04-15,2,0,4,14,57,106,163,181.0
2417,2011-04-15,2,0,4,15,50,112,162,168.33333333333334
2418,2011-04-15,2,0,4,16,70,173,243,189.33333333333334
2419,2011-04-15,2,0,4,17,64,267,331,245.33333333333334
2420,2011-04-15,2,0,4,18,47,216,263,279.0
2421,2011-04-15,2,0,4,19,41,168,209,267.6666666666667
2422,2011-04-15,2,0,4,20,26,92,118,196.66666666666666
2423,2011-04-15,2,0,4,21,25,77,102,143.0
2424,2011-04-15,2,0,4,22,16,64,80,100.0
2425,2011-04-15,2,0,4,23,8,56,64,82.0
2426,2011-04-16,2,0,4,0,7,36,43,62.333333333333336
2427,2011-04-16,2,0,4,1,5,28,33,46.666666666666664
2428,2011-04-16,2,0,4,2,5,19,24,33.333333333333336
2429,2011-04-16,2,0,4,3,5,9,14,23.666666666666668
2430,2011-04-16,2,0,4,4,1,4,5,14.333333333333334
2431,2011-04-16,2,0,4,5,1,3,4,7.666666666666667
2432,2011-04-16,2,0,4,6,1,9,10,6.333333333333333
2433,2011-04-16,2,0,4,7,3,18,21,11.666666666666666
2434,2011-04-16,2,0,4,8,7,38,45,25.333333333333332
2435,2011-04-16,2,0,4,9,2,27,29,31.666666666666668
2436,2011-04-16,2,0,4,10,1,21,22,32.0
2437,2011-04-16,2,0,4,11,4,27,31,27.333333333333332
2438,2011-04-16,2,0,4,12,6,26,32,28.333333333333332
2439,2011-04-16,2,0,4,13,9,49,58,40.333333333333336
2440,2011-04-16,2,0,4,14,14,49,63,51.0
2441,2011-04-16,2,0,4,15,16,62,78,66.33333333333333
2442,2011-04-16,2,0,4,16,6,27,33,58.0
2443,2011-04-16,2,0,4,17,1,14,15,42.0
2444,2011-04-16,2,0,4,18,6,32,38,28.666666666666668
2445,2011-04-16,2,0,4,19,9,62,71,41.333333333333336
2446,2011-04-16,2,0,4,20,4,49,53,54.0
2447,2011-04-16,2,0,4,21,1,13,14,46.0
2448,2011-04-16,2,0,4,22,2,22,24,30.333333333333332
2449,2011-04-16,2,0,4,23,5,30,35,24.333333333333332
2450,2011-04-17,2,0,4,0,4,29,33,30.666666666666668
2451,2011-04-17,2,0,4,1,6,25,31,33.0
2452,2011-04-17,2,0,4,2,4,25,29,31.0
2453,2011-04-17,2,0,4,3,12,13,25,28.333333333333332
2454,2011-04-17,2,0,4,4,2,5,7,20.333333333333332
2455,2011-04-17,2,0,4,5,2,1,3,11.666666666666666
2456,2011-04-17,2,0,4,6,3,5,8,6.0
2457,2011-04-17,2,0,4,7,2,14,16,9.0
2458,2011-04-17,2,0,4,8,7,36,43,22.333333333333332
2459,2011-04-17,2,0,4,9,31,71,102,53.666666666666664
2460,2011-04-17,2,0,4,10,91,120,211,118.66666666666667
2461,2011-04-17,2,0,4,11,119,185,304,205.66666666666666
2462,2011-04-17,2,0,4,12,167,187,354,289.6666666666667
2463,2011-04-17,2,0,4,13,181,162,343,333.6666666666667
2464,2011-04-17,2,0,4,14,170,191,361,352.6666666666667
2465,2011-04-17,2,0,4,15,179,209,388,364.0
2466,2011-04-17,2,0,4,16,161,182,343,364.0
2467,2011-04-17,2,0,4,17,143,163,306,345.6666666666667
2468,2011-04-17,2,0,4,18,102,175,277,308.6666666666667
2469,2011-04-17,2,0,4,19,75,135,210,264.3333333333333
2470,2011-04-17,2,0,4,20,44,97,141,209.33333333333334
2471,2011-04-17,2,0,4,21,13,70,83,144.66666666666666
2472,2011-04-17,2,0,4,22,21,49,70,98.0
2473,2011-04-17,2,0,4,23,19,37,56,69.66666666666667
2474,2011-04-18,2,0,4,0,15,24,39,55.0
2475,2011-04-18,2,0,4,1,11,8,19,38.0
2476,2011-04-18,2,0,4,2,14,2,16,24.666666666666668
2477,2011-04-18,2,0,4,3,6,1,7,14.0
2478,2011-04-18,2,0,4,4,2,4,6,9.666666666666666
2479,2011-04-18,2,0,4,5,0,16,16,9.666666666666666
2480,2011-04-18,2,0,4,6,3,51,54,25.333333333333332
2481,2011-04-18,2,0,4,7,12,156,168,79.33333333333333
2482,2011-04-18,2,0,4,8,20,277,297,173.0
2483,2011-04-18,2,0,4,9,37,132,169,211.33333333333334
2484,2011-04-18,2,0,4,10,41,68,109,191.66666666666666
2485,2011-04-18,2,0,4,11,36,87,123,133.66666666666666
2486,2011-04-18,2,0,4,12,60,124,184,138.66666666666666
2487,2011-04-18,2,0,4,13,41,128,169,158.66666666666666
2488,2011-04-18,2,0,4,14,49,95,144,165.66666666666666
2489,2011-04-18,2,0,4,15,64,112,176,163.0
2490,2011-04-18,2,0,4,16,40,165,205,175.0
2491,2011-04-18,2,0,4,17,66,362,428,269.6666666666667
2492,2011-04-18,2,0,4,18,41,321,362,331.6666666666667
2493,2011-04-18,2,0,4,19,42,244,286,358.6666666666667
2494,2011-04-18,2,0,4,20,29,136,165,271.0
2495,2011-04-18,2,0,4,21,20,131,151,200.66666666666666
2496,2011-04-18,2,0,4,22,9,81,90,135.33333333333334
2497,2011-04-18,2,0,4,23,11,35,46,95.66666666666667
2498,2011-04-19,2,0,4,0,2,23,25,53.666666666666664
2499,2011-04-19,2,0,4,1,5,2,7,26.0
2500,2011-04-19,2,0,4,2,8,5,13,15.0
2501,2011-04-19,2,0,4,3,0,3,3,7.666666666666667
2502,2011-04-19,2,0,4,4,1,4,5,7.0
2503,2011-04-19,2,0,4,5,1,17,18,8.666666666666666
2504,2011-04-19,2,0,4,6,2,63,65,29.333333333333332
2505,2011-04-19,2,0,4,7,22,166,188,90.33333333333333
2506,2011-04-19,2,0,4,8,20,331,351,201.33333333333334
2507,2011-04-19,2,0,4,9,23,139,162,233.66666666666666
2508,2011-04-19,2,0,4,10,15,60,75,196.0
2509,2011-04-19,2,0,4,11,19,53,72,103.0
2510,2011-04-19,2,0,4,12,19,84,103,83.33333333333333
2511,2011-04-19,2,0,4,13,26,103,129,101.33333333333333
2512,2011-04-19,2,0,4,14,19,88,107,113.0
2513,2011-04-19,2,0,4,15,44,83,127,121.0
2514,2011-04-19,2,0,4,16,30,162,192,142.0
2515,2011-04-19,2,0,4,17,39,372,411,243.33333333333334
2516,2011-04-19,2,0,4,18,44,377,421,341.3333333333333
2517,2011-04-19,2,0,4,19,28,248,276,369.3333333333333
2518,2011-04-19,2,0,4,20,20,148,168,288.3333333333333
2519,2011-04-19,2,0,4,21,8,114,122,188.66666666666666
2520,2011-04-19,2,0,4,22,3,109,112,134.0
2521,2011-04-19,2,0,4,23,11,41,52,95.33333333333333
2522,2011-04-20,2,0,4,0,4,29,33,65.66666666666667
2523,2011-04-20,2,0,4,1,2,5,7,30.666666666666668
2524,2011-04-20,2,0,4,2,0,2,2,14.0
2525,2011-04-20,2,0,4,3,0,2,2,3.6666666666666665
2526,2011-04-20,2,0,4,4,5,4,9,4.333333333333333
2527,2011-04-20,2,0,4,5,1,14,15,8.666666666666666
2528,2011-04-20,2,0,4,6,2,62,64,29.333333333333332
2529,2011-04-20,2,0,4,7,26,211,237,105.33333333333333
2530,2011-04-20,2,0,4,8,22,374,396,232.33333333333334
2531,2011-04-20,2,0,4,9,27,170,197,276.6666666666667
2532,2011-04-20,2,0,4,10,45,86,131,241.33333333333334
2533,2011-04-20,2,0,4,11,31,87,118,148.66666666666666
2534,2011-04-20,2,0,4,12,28,117,145,131.33333333333334
2535,2011-04-20,2,0,4,13,42,135,177,146.66666666666666
2536,2011-04-20,2,0,4,14,33,115,148,156.66666666666666
2537,2011-04-20,2,0,4,15,32,113,145,156.66666666666666
2538,2011-04-20,2,0,4,16,54,201,255,182.66666666666666
2539,2011-04-20,2,0,4,17,34,398,432,277.3333333333333
2540,2011-04-20,2,0,4,18,56,385,441,376.0
2541,2011-04-20,2,0,4,19,74,309,383,418.6666666666667
2542,2011-04-20,2,0,4,20,31,194,225,349.6666666666667
2543,2011-04-20,2,0,4,21,38,134,172,260.0
2544,2011-04-20,2,0,4,22,12,105,117,171.33333333333334
2545,2011-04-20,2,0,4,23,14,79,93,127.33333333333333
2546,2011-04-21,2,0,4,0,11,33,44,84.66666666666667
2547,2011-04-21,2,0,4,1,6,20,26,54.333333333333336
2548,2011-04-21,2,0,4,2,3,10,13,27.666666666666668
2549,2011-04-21,2,0,4,3,4,3,7,15.333333333333334
2550,2011-04-21,2,0,4,4,2,4,6,8.666666666666666
2551,2011-04-21,2,0,4,5,0,14,14,9.0
2552,2011-04-21,2,0,4,6,2,73,75,31.666666666666668
2553,2011-04-21,2,0,4,7,15,183,198,95.66666666666667
2554,2011-04-21,2,0,4,8,19,346,365,212.66666666666666
2555,2011-04-21,2,0,4,9,18,178,196,253.0
2556,2011-04-21,2,0,4,10,25,73,98,219.66666666666666
2557,2011-04-21,2,0,4,11,34,99,133,142.33333333333334
2558,2011-04-21,2,0,4,12,49,150,199,143.33333333333334
2559,2011-04-21,2,0,4,13,55,122,177,169.66666666666666
2560,2011-04-21,2,0,4,14,68,160,228,201.33333333333334
2561,2011-04-21,2,0,4,15,69,166,235,213.33333333333334
2562,2011-04-21,2,0,4,16,66,228,294,252.33333333333334
2563,2011-04-21,2,0,4,17,79,402,481,336.6666666666667
2564,2011-04-21,2,0,4,18,71,381,452,409.0
2565,2011-04-21,2,0,4,19,52,272,324,419.0
2566,2011-04-21,2,0,4,20,28,176,204,326.6666666666667
2567,2011-04-21,2,0,4,21,25,159,184,237.33333333333334
2568,2011-04-21,2,0,4,22,31,106,137,175.0
2569,2011-04-21,2,0,4,23,13,86,99,140.0
2570,2011-04-22,2,0,4,0,3,30,33,89.66666666666667
2571,2011-04-22,2,0,4,1,2,22,24,52.0
2572,2011-04-22,2,0,4,2,2,7,9,22.0
2573,2011-04-22,2,0,4,3,0,2,2,11.666666666666666
2574,2011-04-22,2,0,4,4,1,2,3,4.666666666666667
2575,2011-04-22,2,0,4,5,0,16,16,7.0
2576,2011-04-22,2,0,4,6,2,47,49,22.666666666666668
2577,2011-04-22,2,0,4,7,5,175,180,81.66666666666667
2578,2011-04-22,2,0,4,8,15,331,346,191.66666666666666
2579,2011-04-22,2,0,4,9,17,178,195,240.33333333333334
2580,2011-04-22,2,0,4,10,32,104,136,225.66666666666666
2581,2011-04-22,2,0,4,11,23,83,106,145.66666666666666
2582,2011-04-22,2,0,4,12,19,61,80,107.33333333333333
2583,2011-04-22,2,0,4,13,3,37,40,75.33333333333333
2584,2011-04-22,2,0,4,14,3,33,36,52.0
2585,2011-04-22,2,0,4,15,13,62,75,50.333333333333336
2586,2011-04-22,2,0,4,16,4,58,62,57.666666666666664
2587,2011-04-22,2,0,4,17,6,63,69,68.66666666666667
2588,2011-04-22,2,0,4,18,4,47,51,60.666666666666664
2589,2011-04-22,2,0,4,19,7,48,55,58.333333333333336
2590,2011-04-22,2,0,4,20,8,39,47,51.0
2591,2011-04-22,2,0,4,21,5,23,28,43.333333333333336
2592,2011-04-22,2,0,4,22,3,21,24,33.0
2593,2011-04-22,2,0,4,23,0,17,17,23.0
2594,2011-04-23,2,0,4,0,0,18,18,19.666666666666668
2595,2011-04-23,2,0,4,1,5,11,16,17.0
2596,2011-04-23,2,0,4,2,3,14,17,17.0
2597,2011-04-23,2,0,4,3,0,4,4,12.333333333333334
2598,2011-04-23,2,0,4,4,2,3,5,8.666666666666666
2599,2011-04-23,2,0,4,5,1,6,7,5.333333333333333
2600,2011-04-23,2,0,4,6,0,11,11,7.666666666666667
2601,2011-04-23,2,0,4,7,2,17,19,12.333333333333334
2602,2011-04-23,2,0,4,8,15,32,47,25.666666666666668
2603,2011-04-23,2,0,4,9,13,55,68,44.666666666666664
2604,2011-04-23,2,0,4,10,36,93,129,81.33333333333333
2605,2011-04-23,2,0,4,11,68,164,232,143.0
2606,2011-04-23,2,0,4,12,94,197,291,217.33333333333334
2607,2011-04-23,2,0,4,13,126,186,312,278.3333333333333
2608,2011-04-23,2,0,4,14,182,209,391,331.3333333333333
2609,2011-04-23,2,0,4,15,171,226,397,366.6666666666667
2610,2011-04-23,2,0,4,16,180,246,426,404.6666666666667
2611,2011-04-23,2,0,4,17,168,215,383,402.0
2612,2011-04-23,2,0,4,18,149,227,376,395.0
2613,2011-04-23,2,0,4,19,84,199,283,347.3333333333333
2614,2011-04-23,2,0,4,20,45,138,183,280.6666666666667
2615,2011-04-23,2,0,4,21,32,103,135,200.33333333333334
2616,2011-04-23,2,0,4,22,55,114,169,162.33333333333334
2617,2011-04-23,2,0,4,23,31,86,117,140.33333333333334
2618,2011-04-24,2,0,4,0,30,66,96,127.33333333333333
2619,2011-04-24,2,0,4,1,14,40,54,89.0
2620,2011-04-24,2,0,4,2,27,45,72,74.0
2621,2011-04-24,2,0,4,3,4,20,24,50.0
2622,2011-04-24,2,0,4,4,0,5,5,33.666666666666664
2623,2011-04-24,2,0,4,5,5,7,12,13.666666666666666
2624,2011-04-24,2,0,4,6,10,3,13,10.0
2625,2011-04-24,2,0,4,7,16,11,27,17.333333333333332
2626,2011-04-24,2,0,4,8,38,42,80,40.0
2627,2011-04-24,2,0,4,9,73,104,177,94.66666666666667
2628,2011-04-24,2,0,4,10,118,171,289,182.0
2629,2011-04-24,2,0,4,11,124,193,317,261.0
2630,2011-04-24,2,0,4,12,168,220,388,331.3333333333333
2631,2011-04-24,2,0,4,13,205,236,441,382.0
2632,2011-04-24,2,0,4,14,197,223,420,416.3333333333333
2633,2011-04-24,2,0,4,15,167,202,369,410.0
2634,2011-04-24,2,0,4,16,162,197,359,382.6666666666667
2635,2011-04-24,2,0,4,17,142,189,331,353.0
2636,2011-04-24,2,0,4,18,96,174,270,320.0
2637,2011-04-24,2,0,4,19,62,132,194,265.0
2638,2011-04-24,2,0,4,20,34,71,105,189.66666666666666
2639,2011-04-24,2,0,4,21,8,53,61,120.0
2640,2011-04-24,2,0,4,22,5,40,45,70.33333333333333
2641,2011-04-24,2,0,4,23,5,37,42,49.333333333333336
2642,2011-04-25,2,0,4,0,2,10,12,33.0
2643,2011-04-25,2,0,4,1,2,8,10,21.333333333333332
2644,2011-04-25,2,0,4,2,1,9,10,10.666666666666666
2645,2011-04-25,2,0,4,3,2,8,10,10.0
2646,2011-04-25,2,0,4,4,1,4,5,8.333333333333334
2647,2011-04-25,2,0,4,5,3,14,17,10.666666666666666
2648,2011-04-25,2,0,4,6,7,59,66,29.333333333333332
2649,2011-04-25,2,0,4,7,13,183,196,93.0
2650,2011-04-25,2,0,4,8,27,326,353,205.0
2651,2011-04-25,2,0,4,9,27,147,174,241.0
2652,2011-04-25,2,0,4,10,61,64,125,217.33333333333334
2653,2011-04-25,2,0,4,11,53,94,147,148.66666666666666
2654,2011-04-25,2,0,4,12,48,140,188,153.33333333333334
2655,2011-04-25,2,0,4,13,57,146,203,179.33333333333334
2656,2011-04-25,2,0,4,14,47,99,146,179.0
2657,2011-04-25,2,0,4,15,50,125,175,174.66666666666666
2658,2011-04-25,2,0,4,16,41,198,239,186.66666666666666
2659,2011-04-25,2,0,4,17,80,441,521,311.6666666666667
2660,2011-04-25,2,0,4,18,74,425,499,419.6666666666667
2661,2011-04-25,2,0,4,19,62,320,382,467.3333333333333
2662,2011-04-25,2,0,4,20,42,195,237,372.6666666666667
2663,2011-04-25,2,0,4,21,41,149,190,269.6666666666667
2664,2011-04-25,2,0,4,22,23,83,106,177.66666666666666
2665,2011-04-25,2,0,4,23,9,53,62,119.33333333333333
2666,2011-04-26,2,0,4,0,10,17,27,65.0
2667,2011-04-26,2,0,4,1,16,5,21,36.666666666666664
2668,2011-04-26,2,0,4,2,17,9,26,24.666666666666668
2669,2011-04-26,2,0,4,3,17,4,21,22.666666666666668
2670,2011-04-26,2,0,4,4,2,4,6,17.666666666666668
2671,2011-04-26,2,0,4,5,0,16,16,14.333333333333334
2672,2011-04-26,2,0,4,6,0,80,80,34.0
2673,2011-04-26,2,0,4,7,16,254,270,122.0
2674,2011-04-26,2,0,4,8,32,417,449,266.3333333333333
2675,2011-04-26,2,0,4,9,35,164,199,306.0
2676,2011-04-26,2,0,4,10,22,98,120,256.0
2677,2011-04-26,2,0,4,11,40,132,172,163.66666666666666
2678,2011-04-26,2,0,4,12,40,146,186,159.33333333333334
2679,2011-04-26,2,0,4,13,37,139,176,178.0
2680,2011-04-26,2,0,4,14,40,115,155,172.33333333333334
2681,2011-04-26,2,0,4,15,34,119,153,161.33333333333334
2682,2011-04-26,2,0,4,16,40,251,291,199.66666666666666
2683,2011-04-26,2,0,4,17,66,455,521,321.6666666666667
2684,2011-04-26,2,0,4,18,65,463,528,446.6666666666667
2685,2011-04-26,2,0,4,19,42,286,328,459.0
2686,2011-04-26,2,0,4,20,35,199,234,363.3333333333333
2687,2011-04-26,2,0,4,21,33,162,195,252.33333333333334
2688,2011-04-26,2,0,4,22,32,116,148,192.33333333333334
2689,2011-04-26,2,0,4,23,7,71,78,140.33333333333334
2690,2011-04-27,2,0,4,0,3,24,27,84.33333333333333
2691,2011-04-27,2,0,4,1,2,15,17,40.666666666666664
2692,2011-04-27,2,0,4,2,0,5,5,16.333333333333332
2693,2011-04-27,2,0,4,3,3,4,7,9.666666666666666
2694,2011-04-27,2,0,4,4,0,6,6,6.0
2695,2011-04-27,2,0,4,5,1,16,17,10.0
2696,2011-04-27,2,0,4,6,5,79,84,35.666666666666664
2697,2011-04-27,2,0,4,7,17,229,246,115.66666666666667
2698,2011-04-27,2,0,4,8,31,413,444,258.0
2699,2011-04-27,2,0,4,9,20,161,181,290.3333333333333
2700,2011-04-27,2,0,4,10,26,66,92,239.0
2701,2011-04-27,2,0,4,11,53,103,156,143.0
2702,2011-04-27,2,0,4,12,38,135,173,140.33333333333334
2703,2011-04-27,2,0,4,13,31,119,150,159.66666666666666
2704,2011-04-27,2,0,4,14,29,119,148,157.0
2705,2011-04-27,2,0,4,15,18,120,138,145.33333333333334
2706,2011-04-27,2,0,4,16,29,189,218,168.0
2707,2011-04-27,2,0,4,17,63,458,521,292.3333333333333
2708,2011-04-27,2,0,4,18,46,366,412,383.6666666666667
2709,2011-04-27,2,0,4,19,40,220,260,397.6666666666667
2710,2011-04-27,2,0,4,20,30,188,218,296.6666666666667
2711,2011-04-27,2,0,4,21,19,126,145,207.66666666666666
2712,2011-04-27,2,0,4,22,18,111,129,164.0
2713,2011-04-27,2,0,4,23,25,53,78,117.33333333333333
2714,2011-04-28,2,0,4,0,13,41,54,87.0
2715,2011-04-28,2,0,4,1,8,12,20,50.666666666666664
2716,2011-04-28,2,0,4,2,14,7,21,31.666666666666668
2717,2011-04-28,2,0,4,3,2,1,3,14.666666666666666
2718,2011-04-28,2,0,4,4,4,5,9,11.0
2719,2011-04-28,2,0,4,5,0,13,13,8.333333333333334
2720,2011-04-28,2,0,4,6,7,79,86,36.0
2721,2011-04-28,2,0,4,7,14,201,215,104.66666666666667
2722,2011-04-28,2,0,4,8,31,367,398,233.0
2723,2011-04-28,2,0,4,9,18,165,183,265.3333333333333
2724,2011-04-28,2,0,4,10,9,45,54,211.66666666666666
2725,2011-04-28,2,0,4,11,10,74,84,107.0
2726,2011-04-28,2,0,4,12,23,84,107,81.66666666666667
2727,2011-04-28,2,0,4,13,18,103,121,104.0
2728,2011-04-28,2,0,4,14,21,121,142,123.33333333333333
2729,2011-04-28,2,0,4,15,46,117,163,142.0
2730,2011-04-28,2,0,4,16,42,228,270,191.66666666666666
2731,2011-04-28,2,0,4,17,49,406,455,296.0
2732,2011-04-28,2,0,4,18,44,486,530,418.3333333333333
2733,2011-04-28,2,0,4,19,57,347,404,463.0
2734,2011-04-28,2,0,4,20,49,220,269,401.0
2735,2011-04-28,2,0,4,21,27,167,194,289.0
2736,2011-04-28,2,0,4,22,34,119,153,205.33333333333334
2737,2011-04-28,2,0,4,23,29,81,110,152.33333333333334
2738,2011-04-29,2,0,4,0,11,37,48,103.66666666666667
2739,2011-04-29,2,0,4,1,10,21,31,63.0
2740,2011-04-29,2,0,4,2,2,8,10,29.666666666666668
2741,2011-04-29,2,0,4,3,1,4,5,15.333333333333334
2742,2011-04-29,2,0,4,4,0,6,6,7.0
2743,2011-04-29,2,0,4,5,0,25,25,12.0
2744,2011-04-29,2,0,4,6,4,67,71,34.0
2745,2011-04-29,2,0,4,7,18,222,240,112.0
2746,2011-04-29,2,0,4,8,35,386,421,244.0
2747,2011-04-29,2,0,4,9,45,185,230,297.0
2748,2011-04-29,2,0,4,10,57,99,156,269.0
2749,2011-04-29,2,0,4,11,49,108,157,181.0
2750,2011-04-29,2,0,4,12,63,160,223,178.66666666666666
2751,2011-04-29,2,0,4,13,74,234,308,229.33333333333334
2752,2011-04-29,2,0,4,14,58,190,248,259.6666666666667
2753,2011-04-29,2,0,4,15,77,175,252,269.3333333333333
2754,2011-04-29,2,0,4,16,59,240,299,266.3333333333333
2755,2011-04-29,2,0,4,17,75,433,508,353.0
2756,2011-04-29,2,0,4,18,55,384,439,415.3333333333333
2757,2011-04-29,2,0,4,19,40,230,270,405.6666666666667
2758,2011-04-29,2,0,4,20,34,160,194,301.0
2759,2011-04-29,2,0,4,21,50,145,195,219.66666666666666
2760,2011-04-29,2,0,4,22,36,110,146,178.33333333333334
2761,2011-04-29,2,0,4,23,25,88,113,151.33333333333334
2762,2011-04-30,2,0,4,0,33,73,106,121.66666666666667
2763,2011-04-30,2,0,4,1,15,59,74,97.66666666666667
2764,2011-04-30,2,0,4,2,12,53,65,81.66666666666667
2765,2011-04-30,2,0,4,3,4,13,17,52.0
2766,2011-04-30,2,0,4,4,2,5,7,29.666666666666668
2767,2011-04-30,2,0,4,5,3,4,7,10.333333333333334
2768,2011-04-30,2,0,4,6,10,11,21,11.666666666666666
2769,2011-04-30,2,0,4,7,21,27,48,25.333333333333332
2770,2011-04-30,2,0,4,8,21,70,91,53.333333333333336
2771,2011-04-30,2,0,4,9,35,121,156,98.33333333333333
2772,2011-04-30,2,0,4,10,94,185,279,175.33333333333334
2773,2011-04-30,2,0,4,11,120,201,321,252.0
2774,2011-04-30,2,0,4,12,178,238,416,338.6666666666667
2775,2011-04-30,2,0,4,13,185,270,455,397.3333333333333
2776,2011-04-30,2,0,4,14,184,268,452,441.0
2777,2011-04-30,2,0,4,15,217,282,499,468.6666666666667
2778,2011-04-30,2,0,4,16,191,273,464,471.6666666666667
2779,2011-04-30,2,0,4,17,162,245,407,456.6666666666667
2780,2011-04-30,2,0,4,18,134,237,371,414.0
2781,2011-04-30,2,0,4,19,150,237,387,388.3333333333333
2782,2011-04-30,2,0,4,20,65,159,224,327.3333333333333
2783,2011-04-30,2,0,4,21,58,119,177,262.6666666666667
2784,2011-04-30,2,0,4,22,37,106,143,181.33333333333334
2785,2011-04-30,2,0,4,23,34,91,125,148.33333333333334
2786,2011-05-01,2,0,5,0,19,77,96,121.33333333333333
2787,2011-05-01,2,0,5,1,9,50,59,93.33333333333333
2788,2011-05-01,2,0,5,2,7,43,50,68.33333333333333
2789,2011-05-01,2,0,5,3,8,15,23,44.0
2790,2011-05-01,2,0,5,4,6,11,17,30.0
2791,2011-05-01,2,0,5,5,0,10,10,16.666666666666668
2792,2011-05-01,2,0,5,6,4,9,13,13.333333333333334
2793,2011-05-01,2,0,5,7,7,26,33,18.666666666666668
2794,2011-05-01,2,0,5,8,16,43,59,35.0
2795,2011-05-01,2,0,5,9,45,96,141,77.66666666666667
2796,2011-05-01,2,0,5,10,109,155,264,154.66666666666666
2797,2011-05-01,2,0,5,11,109,141,250,218.33333333333334
2798,2011-05-01,2,0,5,12,109,172,281,265.0
2799,2011-05-01,2,0,5,13,123,209,332,287.6666666666667
2800,2011-05-01,2,0,5,14,85,153,238,283.6666666666667
2801,2011-05-01,2,0,5,15,113,153,266,278.6666666666667
2802,2011-05-01,2,0,5,16,75,139,214,239.33333333333334
2803,2011-05-01,2,0,5,17,60,136,196,225.33333333333334
2804,2011-05-01,2,0,5,18,33,126,159,189.66666666666666
2805,2011-05-01,2,0,5,19,47,131,178,177.66666666666666
2806,2011-05-01,2,0,5,20,35,86,121,152.66666666666666
2807,2011-05-01,2,0,5,21,23,82,105,134.66666666666666
2808,2011-05-01,2,0,5,22,32,68,100,108.66666666666667
2809,2011-05-01,2,0,5,23,64,82,146,117.0
2810,2011-05-02,2,0,5,0,68,109,177,141.0
2811,2011-05-02,2,0,5,1,41,73,114,145.66666666666666
2812,2011-05-02,2,0,5,2,16,19,35,108.66666666666667
2813,2011-05-02,2,0,5,3,9,7,16,55.0
2814,2011-05-02,2,0,5,4,9,8,17,22.666666666666668
2815,2011-05-02,2,0,5,5,4,16,20,17.666666666666668
2816,2011-05-02,2,0,5,6,3,59,62,33.0
2817,2011-05-02,2,0,5,7,16,193,209,97.0
2818,2011-05-02,2,0,5,8,21,350,371,214.0
2819,2011-05-02,2,0,5,9,41,131,172,250.66666666666666
2820,2011-05-02,2,0,5,10,31,77,108,217.0
2821,2011-05-02,2,0,5,11,34,96,130,136.66666666666666
2822,2011-05-02,2,0,5,12,40,147,187,141.66666666666666
2823,2011-05-02,2,0,5,13,51,119,170,162.33333333333334
2824,2011-05-02,2,0,5,14,48,133,181,179.33333333333334
2825,2011-05-02,2,0,5,15,45,110,155,168.66666666666666
2826,2011-05-02,2,0,5,16,49,220,269,201.66666666666666
2827,2011-05-02,2,0,5,17,65,472,537,320.3333333333333
2828,2011-05-02,2,0,5,18,68,450,518,441.3333333333333
2829,2011-05-02,2,0,5,19,46,268,314,456.3333333333333
2830,2011-05-02,2,0,5,20,44,174,218,350.0
2831,2011-05-02,2,0,5,21,54,178,232,254.66666666666666
2832,2011-05-02,2,0,5,22,28,97,125,191.66666666666666
2833,2011-05-02,2,0,5,23,16,48,64,140.33333333333334
2834,2011-05-03,2,0,5,0,0,16,16,68.33333333333333
2835,2011-05-03,2,0,5,1,0,14,14,31.333333333333332
2836,2011-05-03,2,0,5,2,0,5,5,11.666666666666666
2837,2011-05-03,2,0,5,3,0,2,2,7.0
2838,2011-05-03,2,0,5,4,3,1,4,3.6666666666666665
2839,2011-05-03,2,0,5,5,0,14,14,6.666666666666667
2840,2011-05-03,2,0,5,6,7,102,109,42.333333333333336
2841,2011-05-03,2,0,5,7,17,248,265,129.33333333333334
2842,2011-05-03,2,0,5,8,24,435,459,277.6666666666667
2843,2011-05-03,2,0,5,9,29,157,186,303.3333333333333
2844,2011-05-03,2,0,5,10,36,91,127,257.3333333333333
2845,2011-05-03,2,0,5,11,20,120,140,151.0
2846,2011-05-03,2,0,5,12,48,169,217,161.33333333333334
2847,2011-05-03,2,0,5,13,50,144,194,183.66666666666666
2848,2011-05-03,2,0,5,14,36,122,158,189.66666666666666
2849,2011-05-03,2,0,5,15,37,117,154,168.66666666666666
2850,2011-05-03,2,0,5,16,46,225,271,194.33333333333334
2851,2011-05-03,2,0,5,17,53,464,517,314.0
2852,2011-05-03,2,0,5,18,59,485,544,444.0
2853,2011-05-03,2,0,5,19,42,323,365,475.3333333333333
2854,2011-05-03,2,0,5,20,28,262,290,399.6666666666667
2855,2011-05-03,2,0,5,21,42,183,225,293.3333333333333
2856,2011-05-03,2,0,5,22,14,99,113,209.33333333333334
2857,2011-05-03,2,0,5,23,12,50,62,133.33333333333334
2858,2011-05-04,2,0,5,0,5,22,27,67.33333333333333
2859,2011-05-04,2,0,5,1,1,6,7,32.0
2860,2011-05-04,2,0,5,2,0,4,4,12.666666666666666
2861,2011-05-04,2,0,5,3,0,1,1,4.0
2862,2011-05-04,2,0,5,4,1,2,3,2.6666666666666665
2863,2011-05-04,2,0,5,5,1,8,9,4.333333333333333
2864,2011-05-04,2,0,5,6,0,21,21,11.0
2865,2011-05-04,2,0,5,7,6,46,52,27.333333333333332
2866,2011-05-04,2,0,5,8,5,74,79,50.666666666666664
2867,2011-05-04,2,0,5,9,5,35,40,57.0
2868,2011-05-04,2,0,5,10,5,26,31,50.0
2869,2011-05-04,2,0,5,11,3,69,72,47.666666666666664
2870,2011-05-04,2,0,5,12,19,105,124,75.66666666666667
2871,2011-05-04,2,0,5,13,15,128,143,113.0
2872,2011-05-04,2,0,5,14,13,94,107,124.66666666666667
2873,2011-05-04,2,0,5,15,22,107,129,126.33333333333333
2874,2011-05-04,2,0,5,16,22,173,195,143.66666666666666
2875,2011-05-04,2,0,5,17,22,388,410,244.66666666666666
2876,2011-05-04,2,0,5,18,29,367,396,333.6666666666667
2877,2011-05-04,2,0,5,19,30,266,296,367.3333333333333
2878,2011-05-04,2,0,5,20,17,174,191,294.3333333333333
2879,2011-05-04,2,0,5,21,17,133,150,212.33333333333334
2880,2011-05-04,2,0,5,22,9,80,89,143.33333333333334
2881,2011-05-04,2,0,5,23,8,49,57,98.66666666666667
2882,2011-05-05,2,0,5,0,4,23,27,57.666666666666664
2883,2011-05-05,2,0,5,1,4,6,10,31.333333333333332
2884,2011-05-05,2,0,5,2,1,4,5,14.0
2885,2011-05-05,2,0,5,3,0,4,4,6.333333333333333
2886,2011-05-05,2,0,5,4,4,3,7,5.333333333333333
2887,2011-05-05,2,0,5,5,1,29,30,13.666666666666666
2888,2011-05-05,2,0,5,6,3,86,89,42.0
2889,2011-05-05,2,0,5,7,16,255,271,130.0
2890,2011-05-05,2,0,5,8,25,415,440,266.6666666666667
2891,2011-05-05,2,0,5,9,20,164,184,298.3333333333333
2892,2011-05-05,2,0,5,10,30,98,128,250.66666666666666
2893,2011-05-05,2,0,5,11,43,105,148,153.33333333333334
2894,2011-05-05,2,0,5,12,27,169,196,157.33333333333334
2895,2011-05-05,2,0,5,13,50,142,192,178.66666666666666
2896,2011-05-05,2,0,5,14,19,135,154,180.66666666666666
2897,2011-05-05,2,0,5,15,27,120,147,164.33333333333334
2898,2011-05-05,2,0,5,16,36,233,269,190.0
2899,2011-05-05,2,0,5,17,66,467,533,316.3333333333333
2900,2011-05-05,2,0,5,18,64,456,520,440.6666666666667
2901,2011-05-05,2,0,5,19,56,305,361,471.3333333333333
2902,2011-05-05,2,0,5,20,33,225,258,379.6666666666667
2903,2011-05-05,2,0,5,21,39,141,180,266.3333333333333
2904,2011-05-05,2,0,5,22,30,135,165,201.0
2905,2011-05-05,2,0,5,23,16,99,115,153.33333333333334
2906,2011-05-06,2,0,5,0,13,43,56,112.0
2907,2011-05-06,2,0,5,1,8,24,32,67.66666666666667
2908,2011-05-06,2,0,5,2,1,15,16,34.666666666666664
2909,2011-05-06,2,0,5,3,3,6,9,19.0
2910,2011-05-06,2,0,5,4,0,1,1,8.666666666666666
2911,2011-05-06,2,0,5,5,0,16,16,8.666666666666666
2912,2011-05-06,2,0,5,6,8,74,82,33.0
2913,2011-05-06,2,0,5,7,20,202,222,106.66666666666667
2914,2011-05-06,2,0,5,8,35,415,450,251.33333333333334
2915,2011-05-06,2,0,5,9,27,161,188,286.6666666666667
2916,2011-05-06,2,0,5,10,30,97,127,255.0
2917,2011-05-06,2,0,5,11,42,123,165,160.0
2918,2011-05-06,2,0,5,12,48,198,246,179.33333333333334
2919,2011-05-06,2,0,5,13,71,182,253,221.33333333333334
2920,2011-05-06,2,0,5,14,86,127,213,237.33333333333334
2921,2011-05-06,2,0,5,15,89,171,260,242.0
2922,2011-05-06,2,0,5,16,82,262,344,272.3333333333333
2923,2011-05-06,2,0,5,17,83,470,553,385.6666666666667
2924,2011-05-06,2,0,5,18,85,385,470,455.6666666666667
2925,2011-05-06,2,0,5,19,39,253,292,438.3333333333333
2926,2011-05-06,2,0,5,20,29,161,190,317.3333333333333
2927,2011-05-06,2,0,5,21,22,130,152,211.33333333333334
2928,2011-05-06,2,0,5,22,46,105,151,164.33333333333334
2929,2011-05-06,2,0,5,23,27,93,120,141.0
2930,2011-05-07,2,0,5,0,10,76,86,119.0
2931,2011-05-07,2,0,5,1,8,50,58,88.0
2932,2011-05-07,2,0,5,2,5,47,52,65.33333333333333
2933,2011-05-07,2,0,5,3,9,9,18,42.666666666666664
2934,2011-05-07,2,0,5,4,1,4,5,25.0
2935,2011-05-07,2,0,5,5,4,3,7,10.0
2936,2011-05-07,2,0,5,6,1,12,13,8.333333333333334
2937,2011-05-07,2,0,5,7,8,32,40,20.0
2938,2011-05-07,2,0,5,8,19,96,115,56.0
2939,2011-05-07,2,0,5,9,54,164,218,124.33333333333333
2940,2011-05-07,2,0,5,10,90,208,298,210.33333333333334
2941,2011-05-07,2,0,5,11,132,215,347,287.6666666666667
2942,2011-05-07,2,0,5,12,129,244,373,339.3333333333333
2943,2011-05-07,2,0,5,13,196,240,436,385.3333333333333
2944,2011-05-07,2,0,5,14,143,235,378,395.6666666666667
2945,2011-05-07,2,0,5,15,148,230,378,397.3333333333333
2946,2011-05-07,2,0,5,16,119,223,342,366.0
2947,2011-05-07,2,0,5,17,138,216,354,358.0
2948,2011-05-07,2,0,5,18,114,175,289,328.3333333333333
2949,2011-05-07,2,0,5,19,88,179,267,303.3333333333333
2950,2011-05-07,2,0,5,20,82,137,219,258.3333333333333
2951,2011-05-07,2,0,5,21,58,124,182,222.66666666666666
2952,2011-05-07,2,0,5,22,26,94,120,173.66666666666666
2953,2011-05-07,2,0,5,23,30,89,119,140.33333333333334
2954,2011-05-08,2,0,5,0,22,78,100,113.0
2955,2011-05-08,2,0,5,1,8,56,64,94.33333333333333
2956,2011-05-08,2,0,5,2,17,42,59,74.33333333333333
2957,2011-05-08,2,0,5,3,10,21,31,51.333333333333336
2958,2011-05-08,2,0,5,4,2,8,10,33.333333333333336
2959,2011-05-08,2,0,5,5,0,5,5,15.333333333333334
2960,2011-05-08,2,0,5,6,2,4,6,7.0
2961,2011-05-08,2,0,5,7,8,15,23,11.333333333333334
2962,2011-05-08,2,0,5,8,28,58,86,38.333333333333336
2963,2011-05-08,2,0,5,9,48,112,160,89.66666666666667
2964,2011-05-08,2,0,5,10,91,153,244,163.33333333333334
2965,2011-05-08,2,0,5,11,142,198,340,248.0
2966,2011-05-08,2,0,5,12,139,243,382,322.0
2967,2011-05-08,2,0,5,13,166,224,390,370.6666666666667
2968,2011-05-08,2,0,5,14,126,240,366,379.3333333333333
2969,2011-05-08,2,0,5,15,128,230,358,371.3333333333333
2970,2011-05-08,2,0,5,16,122,263,385,369.6666666666667
2971,2011-05-08,2,0,5,17,106,245,351,364.6666666666667
2972,2011-05-08,2,0,5,18,63,205,268,334.6666666666667
2973,2011-05-08,2,0,5,19,61,178,239,286.0
2974,2011-05-08,2,0,5,20,42,132,174,227.0
2975,2011-05-08,2,0,5,21,32,95,127,180.0
2976,2011-05-08,2,0,5,22,29,86,115,138.66666666666666
2977,2011-05-08,2,0,5,23,9,41,50,97.33333333333333
2978,2011-05-09,2,0,5,0,31,22,53,72.66666666666667
2979,2011-05-09,2,0,5,1,25,8,33,45.333333333333336
2980,2011-05-09,2,0,5,2,6,2,8,31.333333333333332
2981,2011-05-09,2,0,5,3,0,7,7,16.0
2982,2011-05-09,2,0,5,4,0,4,4,6.333333333333333
2983,2011-05-09,2,0,5,5,0,23,23,11.333333333333334
2984,2011-05-09,2,0,5,6,2,87,89,38.666666666666664
2985,2011-05-09,2,0,5,7,16,221,237,116.33333333333333
2986,2011-05-09,2,0,5,8,23,351,374,233.33333333333334
2987,2011-05-09,2,0,5,9,36,142,178,263.0
2988,2011-05-09,2,0,5,10,24,95,119,223.66666666666666
2989,2011-05-09,2,0,5,11,26,99,125,140.66666666666666
2990,2011-05-09,2,0,5,12,35,160,195,146.33333333333334
2991,2011-05-09,2,0,5,13,36,138,174,164.66666666666666
2992,2011-05-09,2,0,5,14,44,118,162,177.0
2993,2011-05-09,2,0,5,15,51,148,199,178.33333333333334
2994,2011-05-09,2,0,5,16,49,255,304,221.66666666666666
2995,2011-05-09,2,0,5,17,59,539,598,367.0
2996,2011-05-09,2,0,5,18,66,458,524,475.3333333333333
2997,2011-05-09,2,0,5,19,45,339,384,502.0
2998,2011-05-09,2,0,5,20,25,214,239,382.3333333333333
2999,2011-05-09,2,0,5,21,28,128,156,259.6666666666667
3000,2011-05-09,2,0,5,22,21,95,116,170.33333333333334
3001,2011-05-09,2,0,5,23,16,45,61,111.0
3002,2011-05-10,2,0,5,0,6,12,18,65.0
3003,2011-05-10,2,0,5,1,3,12,15,31.333333333333332
3004,2011-05-10,2,0,5,2,1,4,5,12.666666666666666
3005,2011-05-10,2,0,5,3,1,3,4,8.0
3006,2011-05-10,2,0,5,4,0,2,2,3.6666666666666665
3007,2011-05-10,2,0,5,5,1,28,29,11.666666666666666
3008,2011-05-10,2,0,5,6,9,103,112,47.666666666666664
3009,2011-05-10,2,0,5,7,13,301,314,151.66666666666666
3010,2011-05-10,2,0,5,8,28,397,425,283.6666666666667
3011,2011-05-10,2,0,5,9,29,176,205,314.6666666666667
3012,2011-05-10,2,0,5,10,27,100,127,252.33333333333334
3013,2011-05-10,2,0,5,11,17,108,125,152.33333333333334
3014,2011-05-10,2,0,5,12,47,170,217,156.33333333333334
3015,2011-05-10,2,0,5,13,50,152,202,181.33333333333334
3016,2011-05-10,2,0,5,14,42,134,176,198.33333333333334
3017,2011-05-10,2,0,5,15,28,152,180,186.0
3018,2011-05-10,2,0,5,16,56,271,327,227.66666666666666
3019,2011-05-10,2,0,5,17,79,532,611,372.6666666666667
3020,2011-05-10,2,0,5,18,70,480,550,496.0
3021,2011-05-10,2,0,5,19,69,365,434,531.6666666666666
3022,2011-05-10,2,0,5,20,50,241,291,425.0
3023,2011-05-10,2,0,5,21,30,173,203,309.3333333333333
3024,2011-05-10,2,0,5,22,29,121,150,214.66666666666666
3025,2011-05-10,2,0,5,23,9,72,81,144.66666666666666
3026,2011-05-11,2,0,5,0,8,30,38,89.66666666666667
3027,2011-05-11,2,0,5,1,4,16,20,46.333333333333336
3028,2011-05-11,2,0,5,2,6,4,10,22.666666666666668
3029,2011-05-11,2,0,5,3,0,3,3,11.0
3030,2011-05-11,2,0,5,4,0,2,2,5.0
3031,2011-05-11,2,0,5,5,0,20,20,8.333333333333334
3032,2011-05-11,2,0,5,6,6,93,99,40.333333333333336
3033,2011-05-11,2,0,5,7,25,293,318,145.66666666666666
3034,2011-05-11,2,0,5,8,21,421,442,286.3333333333333
3035,2011-05-11,2,0,5,9,21,182,203,321.0
3036,2011-05-11,2,0,5,10,30,124,154,266.3333333333333
3037,2011-05-11,2,0,5,11,18,123,141,166.0
3038,2011-05-11,2,0,5,12,41,185,226,173.66666666666666
3039,2011-05-11,2,0,5,13,36,157,193,186.66666666666666
3040,2011-05-11,2,0,5,14,36,141,177,198.66666666666666
3041,2011-05-11,2,0,5,15,48,131,179,183.0
3042,2011-05-11,2,0,5,16,49,240,289,215.0
3043,2011-05-11,2,0,5,17,17,242,259,242.33333333333334
3044,2011-05-11,2,0,5,18,40,234,274,274.0
3045,2011-05-11,2,0,5,19,60,341,401,311.3333333333333
3046,2011-05-11,2,0,5,20,28,245,273,316.0
3047,2011-05-11,2,0,5,21,32,202,234,302.6666666666667
3048,2011-05-11,2,0,5,22,12,134,146,217.66666666666666
3049,2011-05-11,2,0,5,23,12,69,81,153.66666666666666
3050,2011-05-12,2,0,5,0,5,39,44,90.33333333333333
3051,2011-05-12,2,0,5,1,1,16,17,47.333333333333336
3052,2011-05-12,2,0,5,2,1,14,15,25.333333333333332
3053,2011-05-12,2,0,5,3,0,5,5,12.333333333333334
3054,2011-05-12,2,0,5,4,1,5,6,8.666666666666666
3055,2011-05-12,2,0,5,5,2,27,29,13.333333333333334
3056,2011-05-12,2,0,5,6,9,103,112,49.0
3057,2011-05-12,2,0,5,7,14,283,297,146.0
3058,2011-05-12,2,0,5,8,27,394,421,276.6666666666667
3059,2011-05-12,2,0,5,9,21,191,212,310.0
3060,2011-05-12,2,0,5,10,28,119,147,260.0
3061,2011-05-12,2,0,5,11,43,136,179,179.33333333333334
3062,2011-05-12,2,0,5,12,43,164,207,177.66666666666666
3063,2011-05-12,2,0,5,13,48,170,218,201.33333333333334
3064,2011-05-12,2,0,5,14,43,148,191,205.33333333333334
3065,2011-05-12,2,0,5,15,54,163,217,208.66666666666666
3066,2011-05-12,2,0,5,16,50,238,288,232.0
3067,2011-05-12,2,0,5,17,54,540,594,366.3333333333333
3068,2011-05-12,2,0,5,18,64,463,527,469.6666666666667
3069,2011-05-12,2,0,5,19,59,305,364,495.0
3070,2011-05-12,2,0,5,20,56,220,276,389.0
3071,2011-05-12,2,0,5,21,31,192,223,287.6666666666667
3072,2011-05-12,2,0,5,22,25,147,172,223.66666666666666
3073,2011-05-12,2,0,5,23,16,87,103,166.0
3074,2011-05-13,2,0,5,0,6,46,52,109.0
3075,2011-05-13,2,0,5,1,5,15,20,58.333333333333336
3076,2011-05-13,2,0,5,2,3,8,11,27.666666666666668
3077,2011-05-13,2,0,5,3,2,2,4,11.666666666666666
3078,2011-05-13,2,0,5,4,2,3,5,6.666666666666667
3079,2011-05-13,2,0,5,5,1,24,25,11.333333333333334
3080,2011-05-13,2,0,5,6,6,76,82,37.333333333333336
3081,2011-05-13,2,0,5,7,16,141,157,88.0
3082,2011-05-13,2,0,5,8,26,361,387,208.66666666666666
3083,2011-05-13,2,0,5,9,18,215,233,259.0
3084,2011-05-13,2,0,5,10,31,99,130,250.0
3085,2011-05-13,2,0,5,11,56,90,146,169.66666666666666
3086,2011-05-13,2,0,5,12,53,170,223,166.33333333333334
3087,2011-05-13,2,0,5,13,69,157,226,198.33333333333334
3088,2011-05-13,2,0,5,14,70,120,190,213.0
3089,2011-05-13,2,0,5,15,56,142,198,204.66666666666666
3090,2011-05-13,2,0,5,16,44,256,300,229.33333333333334
3091,2011-05-13,2,0,5,17,62,429,491,329.6666666666667
3092,2011-05-13,2,0,5,18,39,359,398,396.3333333333333
3093,2011-05-13,2,0,5,19,25,245,270,386.3333333333333
3094,2011-05-13,2,0,5,20,22,130,152,273.3333333333333
3095,2011-05-13,2,0,5,21,24,130,154,192.0
3096,2011-05-13,2,0,5,22,25,107,132,146.0
3097,2011-05-13,2,0,5,23,31,88,119,135.0
3098,2011-05-14,2,0,5,0,24,78,102,117.66666666666667
3099,2011-05-14,2,0,5,1,18,64,82,101.0
3100,2011-05-14,2,0,5,2,15,37,52,78.66666666666667
3101,2011-05-14,2,0,5,3,5,30,35,56.333333333333336
3102,2011-05-14,2,0,5,4,1,4,5,30.666666666666668
3103,2011-05-14,2,0,5,5,7,7,14,18.0
3104,2011-05-14,2,0,5,6,2,9,11,10.0
3105,2011-05-14,2,0,5,7,4,28,32,19.0
3106,2011-05-14,2,0,5,8,16,72,88,43.666666666666664
3107,2011-05-14,2,0,5,9,14,86,100,73.33333333333333
3108,2011-05-14,2,0,5,10,34,133,167,118.33333333333333
3109,2011-05-14,2,0,5,11,72,207,279,182.0
3110,2011-05-14,2,0,5,12,75,204,279,241.66666666666666
3111,2011-05-14,2,0,5,13,68,180,248,268.6666666666667
3112,2011-05-14,2,0,5,14,57,159,216,247.66666666666666
3113,2011-05-14,2,0,5,15,73,221,294,252.66666666666666
3114,2011-05-14,2,0,5,16,107,188,295,268.3333333333333
3115,2011-05-14,2,0,5,17,78,194,272,287.0
3116,2011-05-14,2,0,5,18,88,216,304,290.3333333333333
3117,2011-05-14,2,0,5,19,69,179,248,274.6666666666667
3118,2011-05-14,2,0,5,20,42,115,157,236.33333333333334
3119,2011-05-14,2,0,5,21,15,44,59,154.66666666666666
3120,2011-05-14,2,0,5,22,7,19,26,80.66666666666667
3121,2011-05-14,2,0,5,23,11,33,44,43.0
3122,2011-05-15,2,0,5,0,5,34,39,36.333333333333336
3123,2011-05-15,2,0,5,1,4,43,47,43.333333333333336
3124,2011-05-15,2,0,5,2,13,37,50,45.333333333333336
3125,2011-05-15,2,0,5,3,11,21,32,43.0
3126,2011-05-15,2,0,5,4,5,8,13,31.666666666666668
3127,2011-05-15,2,0,5,5,3,11,14,19.666666666666668
3128,2011-05-15,2,0,5,6,3,14,17,14.666666666666666
3129,2011-05-15,2,0,5,7,4,38,42,24.333333333333332
3130,2011-05-15,2,0,5,8,24,46,70,43.0
3131,2011-05-15,2,0,5,9,36,98,134,82.0
3132,2011-05-15,2,0,5,10,73,153,226,143.33333333333334
3133,2011-05-15,2,0,5,11,120,202,322,227.33333333333334
3134,2011-05-15,2,0,5,12,120,247,367,305.0
3135,2011-05-15,2,0,5,13,195,261,456,381.6666666666667
3136,2011-05-15,2,0,5,14,183,254,437,420.0
3137,2011-05-15,2,0,5,15,206,253,459,450.6666666666667
3138,2011-05-15,2,0,5,16,158,282,440,445.3333333333333
3139,2011-05-15,2,0,5,17,137,255,392,430.3333333333333
3140,2011-05-15,2,0,5,18,60,177,237,356.3333333333333
3141,2011-05-15,2,0,5,19,78,153,231,286.6666666666667
3142,2011-05-15,2,0,5,20,53,138,191,219.66666666666666
3143,2011-05-15,2,0,5,21,44,107,151,191.0
3144,2011-05-15,2,0,5,22,29,88,117,153.0
3145,2011-05-15,2,0,5,23,18,51,69,112.33333333333333
3146,2011-05-16,2,0,5,0,17,21,38,74.66666666666667
3147,2011-05-16,2,0,5,1,6,8,14,40.333333333333336
3148,2011-05-16,2,0,5,2,4,9,13,21.666666666666668
3149,2011-05-16,2,0,5,3,1,3,4,10.333333333333334
3150,2011-05-16,2,0,5,4,1,5,6,7.666666666666667
3151,2011-05-16,2,0,5,5,1,20,21,10.333333333333334
3152,2011-05-16,2,0,5,6,11,93,104,43.666666666666664
3153,2011-05-16,2,0,5,7,27,245,272,132.33333333333334
3154,2011-05-16,2,0,5,8,28,366,394,256.6666666666667
3155,2011-05-16,2,0,5,9,38,156,194,286.6666666666667
3156,2011-05-16,2,0,5,10,37,75,112,233.33333333333334
3157,2011-05-16,2,0,5,11,56,129,185,163.66666666666666
3158,2011-05-16,2,0,5,12,72,137,209,168.66666666666666
3159,2011-05-16,2,0,5,13,61,153,214,202.66666666666666
3160,2011-05-16,2,0,5,14,76,117,193,205.33333333333334
3161,2011-05-16,2,0,5,15,55,110,165,190.66666666666666
3162,2011-05-16,2,0,5,16,45,181,226,194.66666666666666
3163,2011-05-16,2,0,5,17,47,227,274,221.66666666666666
3164,2011-05-16,2,0,5,18,55,398,453,317.6666666666667
3165,2011-05-16,2,0,5,19,36,272,308,345.0
3166,2011-05-16,2,0,5,20,31,167,198,319.6666666666667
3167,2011-05-16,2,0,5,21,28,149,177,227.66666666666666
3168,2011-05-16,2,0,5,22,22,105,127,167.33333333333334
3169,2011-05-16,2,0,5,23,18,39,57,120.33333333333333
3170,2011-05-17,2,0,5,0,13,18,31,71.66666666666667
3171,2011-05-17,2,0,5,1,7,6,13,33.666666666666664
3172,2011-05-17,2,0,5,2,4,4,8,17.333333333333332
3173,2011-05-17,2,0,5,3,1,3,4,8.333333333333334
3174,2011-05-17,2,0,5,4,2,2,4,5.333333333333333
3175,2011-05-17,2,0,5,5,0,22,22,10.0
3176,2011-05-17,2,0,5,6,0,49,49,25.0
3177,2011-05-17,2,0,5,7,13,138,151,74.0
3178,2011-05-17,2,0,5,8,22,325,347,182.33333333333334
3179,2011-05-17,2,0,5,9,17,190,207,235.0
3180,2011-05-17,2,0,5,10,31,73,104,219.33333333333334
3181,2011-05-17,2,0,5,11,26,104,130,147.0
3182,2011-05-17,2,0,5,12,38,115,153,129.0
3183,2011-05-17,2,0,5,13,31,141,172,151.66666666666666
3184,2011-05-17,2,0,5,14,61,123,184,169.66666666666666
3185,2011-05-17,2,0,5,15,79,131,210,188.66666666666666
3186,2011-05-17,2,0,5,16,73,217,290,228.0
3187,2011-05-17,2,0,5,17,83,521,604,368.0
3188,2011-05-17,2,0,5,18,54,426,480,458.0
3189,2011-05-17,2,0,5,19,51,298,349,477.6666666666667
3190,2011-05-17,2,0,5,20,30,253,283,370.6666666666667
3191,2011-05-17,2,0,5,21,23,151,174,268.6666666666667
3192,2011-05-17,2,0,5,22,12,86,98,185.0
3193,2011-05-17,2,0,5,23,7,49,56,109.33333333333333
3194,2011-05-18,2,0,5,0,8,15,23,59.0
3195,2011-05-18,2,0,5,1,3,9,12,30.333333333333332
3196,2011-05-18,2,0,5,2,1,5,6,13.666666666666666
3197,2011-05-18,2,0,5,3,6,3,9,9.0
3198,2011-05-18,2,0,5,4,1,2,3,6.0
3199,2011-05-18,2,0,5,5,0,9,9,7.0
3200,2011-05-18,2,0,5,6,2,99,101,37.666666666666664
3201,2011-05-18,2,0,5,7,14,260,274,128.0
3202,2011-05-18,2,0,5,8,25,428,453,276.0
3203,2011-05-18,2,0,5,9,26,176,202,309.6666666666667
3204,2011-05-18,2,0,5,10,33,73,106,253.66666666666666
3205,2011-05-18,2,0,5,11,6,17,23,110.33333333333333
3206,2011-05-18,2,0,5,12,12,42,54,61.0
3207,2011-05-18,2,0,5,13,30,92,122,66.33333333333333
3208,2011-05-18,2,0,5,14,44,94,138,104.66666666666667
3209,2011-05-18,2,0,5,15,34,133,167,142.33333333333334
3210,2011-05-18,2,0,5,16,53,241,294,199.66666666666666
3211,2011-05-18,2,0,5,17,78,487,565,342.0
3212,2011-05-18,2,0,5,18,58,431,489,449.3333333333333
3213,2011-05-18,2,0,5,19,43,288,331,461.6666666666667
3214,2011-05-18,2,0,5,20,24,189,213,344.3333333333333
3215,2011-05-18,2,0,5,21,11,74,85,209.66666666666666
3216,2011-05-18,2,0,5,22,14,103,117,138.33333333333334
3217,2011-05-18,2,0,5,23,10,49,59,87.0
3218,2011-05-19,2,0,5,0,6,23,29,68.33333333333333
3219,2011-05-19,2,0,5,1,2,4,6,31.333333333333332
3220,2011-05-19,2,0,5,2,3,12,15,16.666666666666668
3221,2011-05-19,2,0,5,3,1,3,4,8.333333333333334
3222,2011-05-19,2,0,5,4,2,3,5,8.0
3223,2011-05-19,2,0,5,5,2,24,26,11.666666666666666
3224,2011-05-19,2,0,5,6,17,86,103,44.666666666666664
3225,2011-05-19,2,0,5,7,18,239,257,128.66666666666666
3226,2011-05-19,2,0,5,8,34,453,487,282.3333333333333
3227,2011-05-19,2,0,5,9,40,176,216,320.0
3228,2011-05-19,2,0,5,10,35,95,130,277.6666666666667
3229,2011-05-19,2,0,5,11,53,111,164,170.0
3230,2011-05-19,2,0,5,12,38,130,168,154.0
3231,2011-05-19,2,0,5,13,44,139,183,171.66666666666666
3232,2011-05-19,2,0,5,14,43,137,180,177.0
3233,2011-05-19,2,0,5,15,63,125,188,183.66666666666666
3234,2011-05-19,2,0,5,16,55,247,302,223.33333333333334
3235,2011-05-19,2,0,5,17,60,487,547,345.6666666666667
3236,2011-05-19,2,0,5,18,59,454,513,454.0
3237,2011-05-19,2,0,5,19,65,345,410,490.0
3238,2011-05-19,2,0,5,20,46,236,282,401.6666666666667
3239,2011-05-19,2,0,5,21,29,180,209,300.3333333333333
3240,2011-05-19,2,0,5,22,11,68,79,190.0
3241,2011-05-19,2,0,5,23,9,63,72,120.0
3242,2011-05-20,2,0,5,0,15,33,48,66.33333333333333
3243,2011-05-20,2,0,5,1,8,17,25,48.333333333333336
3244,2011-05-20,2,0,5,2,4,4,8,27.0
3245,2011-05-20,2,0,5,3,1,4,5,12.666666666666666
3246,2011-05-20,2,0,5,4,1,4,5,6.0
3247,2011-05-20,2,0,5,5,0,28,28,12.666666666666666
3248,2011-05-20,2,0,5,6,15,102,117,50.0
3249,2011-05-20,2,0,5,7,30,289,319,154.66666666666666
3250,2011-05-20,2,0,5,8,41,476,517,317.6666666666667
3251,2011-05-20,2,0,5,9,35,199,234,356.6666666666667
3252,2011-05-20,2,0,5,10,44,104,148,299.6666666666667
3253,2011-05-20,2,0,5,11,63,133,196,192.66666666666666
3254,2011-05-20,2,0,5,12,69,186,255,199.66666666666666
3255,2011-05-20,2,0,5,13,60,172,232,227.66666666666666
3256,2011-05-20,2,0,5,14,66,131,197,228.0
3257,2011-05-20,2,0,5,15,74,168,242,223.66666666666666
3258,2011-05-20,2,0,5,16,61,269,330,256.3333333333333
3259,2011-05-20,2,0,5,17,71,483,554,375.3333333333333
3260,2011-05-20,2,0,5,18,79,394,473,452.3333333333333
3261,2011-05-20,2,0,5,19,49,253,302,443.0
3262,2011-05-20,2,0,5,20,40,180,220,331.6666666666667
3263,2011-05-20,2,0,5,21,40,155,195,239.0
3264,2011-05-20,2,0,5,22,28,124,152,189.0
3265,2011-05-20,2,0,5,23,15,100,115,154.0
3266,2011-05-21,2,0,5,0,20,78,98,121.66666666666667
3267,2011-05-21,2,0,5,1,8,64,72,95.0
3268,2011-05-21,2,0,5,2,5,35,40,70.0
3269,2011-05-21,2,0,5,3,7,12,19,43.666666666666664
3270,2011-05-21,2,0,5,4,1,6,7,22.0
3271,2011-05-21,2,0,5,5,1,4,5,10.333333333333334
3272,2011-05-21,2,0,5,6,6,22,28,13.333333333333334
3273,2011-05-21,2,0,5,7,10,33,43,25.333333333333332
3274,2011-05-21,2,0,5,8,29,97,126,65.66666666666667
3275,2011-05-21,2,0,5,9,60,165,225,131.33333333333334
3276,2011-05-21,2,0,5,10,122,201,323,224.66666666666666
3277,2011-05-21,2,0,5,11,173,245,418,322.0
3278,2011-05-21,2,0,5,12,222,271,493,411.3333333333333
3279,2011-05-21,2,0,5,13,191,271,462,457.6666666666667
3280,2011-05-21,2,0,5,14,187,269,456,470.3333333333333
3281,2011-05-21,2,0,5,15,232,274,506,474.6666666666667
3282,2011-05-21,2,0,5,16,204,267,471,477.6666666666667
3283,2011-05-21,2,0,5,17,191,253,444,473.6666666666667
3284,2011-05-21,2,0,5,18,191,253,444,453.0
3285,2011-05-21,2,0,5,19,117,184,301,396.3333333333333
3286,2011-05-21,2,0,5,20,84,164,248,331.0
3287,2011-05-21,2,0,5,21,77,150,227,258.6666666666667
3288,2011-05-21,2,0,5,22,78,126,204,226.33333333333334
3289,2011-05-21,2,0,5,23,42,103,145,192.0
3290,2011-05-22,2,0,5,0,31,100,131,160.0
3291,2011-05-22,2,0,5,1,17,81,98,124.66666666666667
3292,2011-05-22,2,0,5,2,18,50,68,99.0
3293,2011-05-22,2,0,5,3,10,23,33,66.33333333333333
3294,2011-05-22,2,0,5,4,3,9,12,37.666666666666664
3295,2011-05-22,2,0,5,5,1,5,6,17.0
3296,2011-05-22,2,0,5,6,5,13,18,12.0
3297,2011-05-22,2,0,5,7,13,27,40,21.333333333333332
3298,2011-05-22,2,0,5,8,29,65,94,50.666666666666664
3299,2011-05-22,2,0,5,9,59,130,189,107.66666666666667
3300,2011-05-22,2,0,5,10,135,170,305,196.0
3301,2011-05-22,2,0,5,11,164,209,373,289.0
3302,2011-05-22,2,0,5,12,146,255,401,359.6666666666667
3303,2011-05-22,2,0,5,13,180,275,455,409.6666666666667
3304,2011-05-22,2,0,5,14,125,191,316,390.6666666666667
3305,2011-05-22,2,0,5,15,110,221,331,367.3333333333333
3306,2011-05-22,2,0,5,16,72,201,273,306.6666666666667
3307,2011-05-22,2,0,5,17,93,213,306,303.3333333333333
3308,2011-05-22,2,0,5,18,120,238,358,312.3333333333333
3309,2011-05-22,2,0,5,19,107,193,300,321.3333333333333
3310,2011-05-22,2,0,5,20,57,174,231,296.3333333333333
3311,2011-05-22,2,0,5,21,27,109,136,222.33333333333334
3312,2011-05-22,2,0,5,22,35,86,121,162.66666666666666
3313,2011-05-22,2,0,5,23,19,46,65,107.33333333333333
3314,2011-05-23,2,0,5,0,23,18,41,75.66666666666667
3315,2011-05-23,2,0,5,1,4,5,9,38.333333333333336
3316,2011-05-23,2,0,5,2,2,3,5,18.333333333333332
3317,2011-05-23,2,0,5,3,0,4,4,6.0
3318,2011-05-23,2,0,5,4,2,2,4,4.333333333333333
3319,2011-05-23,2,0,5,5,0,11,11,6.333333333333333
3320,2011-05-23,2,0,5,6,4,92,96,37.0
3321,2011-05-23,2,0,5,7,13,223,236,114.33333333333333
3322,2011-05-23,2,0,5,8,50,359,409,247.0
3323,2011-05-23,2,0,5,9,36,131,167,270.6666666666667
3324,2011-05-23,2,0,5,10,49,72,121,232.33333333333334
3325,2011-05-23,2,0,5,11,73,107,180,156.0
3326,2011-05-23,2,0,5,12,65,139,204,168.33333333333334
3327,2011-05-23,2,0,5,13,49,155,204,196.0
3328,2011-05-23,2,0,5,14,57,130,187,198.33333333333334
3329,2011-05-23,2,0,5,15,57,119,176,189.0
3330,2011-05-23,2,0,5,16,56,223,279,214.0
3331,2011-05-23,2,0,5,17,56,373,429,294.6666666666667
3332,2011-05-23,2,0,5,18,68,385,453,387.0
3333,2011-05-23,2,0,5,19,56,302,358,413.3333333333333
3334,2011-05-23,2,0,5,20,39,271,310,373.6666666666667
3335,2011-05-23,2,0,5,21,33,155,188,285.3333333333333
3336,2011-05-23,2,0,5,22,25,106,131,209.66666666666666
3337,2011-05-23,2,0,5,23,19,53,72,130.33333333333334
3338,2011-05-24,2,0,5,0,12,23,35,79.33333333333333
3339,2011-05-24,2,0,5,1,6,9,15,40.666666666666664
3340,2011-05-24,2,0,5,2,2,8,10,20.0
3341,2011-05-24,2,0,5,3,0,2,2,9.0
3342,2011-05-24,2,0,5,4,1,3,4,5.333333333333333
3343,2011-05-24,2,0,5,5,2,22,24,10.0
3344,2011-05-24,2,0,5,6,10,102,112,46.666666666666664
3345,2011-05-24,2,0,5,7,26,288,314,150.0
3346,2011-05-24,2,0,5,8,31,403,434,286.6666666666667
3347,2011-05-24,2,0,5,9,27,111,138,295.3333333333333
3348,2011-05-24,2,0,5,10,18,90,108,226.66666666666666
3349,2011-05-24,2,0,5,11,33,142,175,140.33333333333334
3350,2011-05-24,2,0,5,12,41,129,170,151.0
3351,2011-05-24,2,0,5,13,38,152,190,178.33333333333334
3352,2011-05-24,2,0,5,14,27,126,153,171.0
3353,2011-05-24,2,0,5,15,59,129,188,177.0
3354,2011-05-24,2,0,5,16,52,225,277,206.0
3355,2011-05-24,2,0,5,17,56,492,548,337.6666666666667
3356,2011-05-24,2,0,5,18,74,490,564,463.0
3357,2011-05-24,2,0,5,19,45,310,355,489.0
3358,2011-05-24,2,0,5,20,39,241,280,399.6666666666667
3359,2011-05-24,2,0,5,21,21,168,189,274.6666666666667
3360,2011-05-24,2,0,5,22,26,115,141,203.33333333333334
3361,2011-05-24,2,0,5,23,13,53,66,132.0
3362,2011-05-25,2,0,5,0,3,32,35,80.66666666666667
3363,2011-05-25,2,0,5,1,6,2,8,36.333333333333336
3364,2011-05-25,2,0,5,2,0,8,8,17.0
3365,2011-05-25,2,0,5,3,0,9,9,8.333333333333334
3366,2011-05-25,2,0,5,4,0,3,3,6.666666666666667
3367,2011-05-25,2,0,5,5,2,23,25,12.333333333333334
3368,2011-05-25,2,0,5,6,4,113,117,48.333333333333336
3369,2011-05-25,2,0,5,7,29,284,313,151.66666666666666
3370,2011-05-25,2,0,5,8,36,495,531,320.3333333333333
3371,2011-05-25,2,0,5,9,27,207,234,359.3333333333333
3372,2011-05-25,2,0,5,10,30,105,135,300.0
3373,2011-05-25,2,0,5,11,36,104,140,169.66666666666666
3374,2011-05-25,2,0,5,12,32,178,210,161.66666666666666
3375,2011-05-25,2,0,5,13,39,163,202,184.0
3376,2011-05-25,2,0,5,14,47,121,168,193.33333333333334
3377,2011-05-25,2,0,5,15,37,145,182,184.0
3378,2011-05-25,2,0,5,16,61,238,299,216.33333333333334
3379,2011-05-25,2,0,5,17,77,524,601,360.6666666666667
3380,2011-05-25,2,0,5,18,66,451,517,472.3333333333333
3381,2011-05-25,2,0,5,19,73,332,405,507.6666666666667
3382,2011-05-25,2,0,5,20,56,284,340,420.6666666666667
3383,2011-05-25,2,0,5,21,33,203,236,327.0
3384,2011-05-25,2,0,5,22,34,140,174,250.0
3385,2011-05-25,2,0,5,23,12,74,86,165.33333333333334
3386,2011-05-26,2,0,5,0,11,34,45,101.66666666666667
3387,2011-05-26,2,0,5,1,3,13,16,49.0
3388,2011-05-26,2,0,5,2,7,7,14,25.0
3389,2011-05-26,2,0,5,3,0,4,4,11.333333333333334
3390,2011-05-26,2,0,5,4,0,2,2,6.666666666666667
3391,2011-05-26,2,0,5,5,2,25,27,11.0
3392,2011-05-26,2,0,5,6,4,94,98,42.333333333333336
3393,2011-05-26,2,0,5,7,16,270,286,137.0
3394,2011-05-26,2,0,5,8,31,458,489,291.0
3395,2011-05-26,2,0,5,9,22,194,216,330.3333333333333
3396,2011-05-26,2,0,5,10,49,94,143,282.6666666666667
3397,2011-05-26,2,0,5,11,36,124,160,173.0
3398,2011-05-26,2,0,5,12,53,141,194,165.66666666666666
3399,2011-05-26,2,0,5,13,52,145,197,183.66666666666666
3400,2011-05-26,2,0,5,14,44,145,189,193.33333333333334
3401,2011-05-26,2,0,5,15,40,101,141,175.66666666666666
3402,2011-05-26,2,0,5,16,58,233,291,207.0
3403,2011-05-26,2,0,5,17,49,445,494,308.6666666666667
3404,2011-05-26,2,0,5,18,74,404,478,421.0
3405,2011-05-26,2,0,5,19,67,311,378,450.0
3406,2011-05-26,2,0,5,20,55,267,322,392.6666666666667
3407,2011-05-26,2,0,5,21,45,178,223,307.6666666666667
3408,2011-05-26,2,0,5,22,23,157,180,241.66666666666666
3409,2011-05-26,2,0,5,23,17,73,90,164.33333333333334
3410,2011-05-27,2,0,5,0,14,55,69,113.0
3411,2011-05-27,2,0,5,1,14,36,50,69.66666666666667
3412,2011-05-27,2,0,5,2,6,12,18,45.666666666666664
3413,2011-05-27,2,0,5,3,1,11,12,26.666666666666668
3414,2011-05-27,2,0,5,4,2,5,7,12.333333333333334
3415,2011-05-27,2,0,5,5,2,29,31,16.666666666666668
3416,2011-05-27,2,0,5,6,8,73,81,39.666666666666664
3417,2011-05-27,2,0,5,7,20,229,249,120.33333333333333
3418,2011-05-27,2,0,5,8,25,393,418,249.33333333333334
3419,2011-05-27,2,0,5,9,37,190,227,298.0
3420,2011-05-27,2,0,5,10,42,111,153,266.0
3421,2011-05-27,2,0,5,11,40,126,166,182.0
3422,2011-05-27,2,0,5,12,53,190,243,187.33333333333334
3423,2011-05-27,2,0,5,13,51,158,209,206.0
3424,2011-05-27,2,0,5,14,51,188,239,230.33333333333334
3425,2011-05-27,2,0,5,15,98,258,356,268.0
3426,2011-05-27,2,0,5,16,63,356,419,338.0
3427,2011-05-27,2,0,5,17,77,414,491,422.0
3428,2011-05-27,2,0,5,18,89,310,399,436.3333333333333
3429,2011-05-27,2,0,5,19,69,210,279,389.6666666666667
3430,2011-05-27,2,0,5,20,24,120,144,274.0
3431,2011-05-27,2,0,5,21,37,114,151,191.33333333333334
3432,2011-05-27,2,0,5,22,25,116,141,145.33333333333334
3433,2011-05-27,2,0,5,23,23,104,127,139.66666666666666
3434,2011-05-28,2,0,5,0,15,79,94,120.66666666666667
3435,2011-05-28,2,0,5,1,8,47,55,92.0
3436,2011-05-28,2,0,5,2,13,35,48,65.66666666666667
3437,2011-05-28,2,0,5,3,2,13,15,39.333333333333336
3438,2011-05-28,2,0,5,4,0,4,4,22.333333333333332
3439,2011-05-28,2,0,5,5,4,3,7,8.666666666666666
3440,2011-05-28,2,0,5,6,3,16,19,10.0
3441,2011-05-28,2,0,5,7,17,33,50,25.333333333333332
3442,2011-05-28,2,0,5,8,27,75,102,57.0
3443,2011-05-28,2,0,5,9,61,116,177,109.66666666666667
3444,2011-05-28,2,0,5,10,110,166,276,185.0
3445,2011-05-28,2,0,5,11,171,178,349,267.3333333333333
3446,2011-05-28,2,0,5,12,145,213,358,327.6666666666667
3447,2011-05-28,2,0,5,13,168,217,385,364.0
3448,2011-05-28,2,0,5,14,172,210,382,375.0
3449,2011-05-28,2,0,5,15,187,187,374,380.3333333333333
3450,2011-05-28,2,0,5,16,201,201,402,386.0
3451,2011-05-28,2,0,5,17,180,161,341,372.3333333333333
3452,2011-05-28,2,0,5,18,173,212,385,376.0
3453,2011-05-28,2,0,5,19,99,153,252,326.0
3454,2011-05-28,2,0,5,20,68,128,196,277.6666666666667
3455,2011-05-28,2,0,5,21,87,114,201,216.33333333333334
3456,2011-05-28,2,0,5,22,46,115,161,186.0
3457,2011-05-28,2,0,5,23,44,81,125,162.33333333333334
3458,2011-05-29,2,0,5,0,32,51,83,123.0
3459,2011-05-29,2,0,5,1,17,49,66,91.33333333333333
3460,2011-05-29,2,0,5,2,12,49,61,70.0
3461,2011-05-29,2,0,5,3,2,24,26,51.0
3462,2011-05-29,2,0,5,4,13,10,23,36.666666666666664
3463,2011-05-29,2,0,5,5,3,3,6,18.333333333333332
3464,2011-05-29,2,0,5,6,5,10,15,14.666666666666666
3465,2011-05-29,2,0,5,7,13,17,30,17.0
3466,2011-05-29,2,0,5,8,34,62,96,47.0
3467,2011-05-29,2,0,5,9,74,78,152,92.66666666666667
3468,2011-05-29,2,0,5,10,130,121,251,166.33333333333334
3469,2011-05-29,2,0,5,11,139,180,319,240.66666666666666
3470,2011-05-29,2,0,5,12,216,186,402,324.0
3471,2011-05-29,2,0,5,13,237,181,418,379.6666666666667
3472,2011-05-29,2,0,5,14,183,168,351,390.3333333333333
3473,2011-05-29,2,0,5,15,221,155,376,381.6666666666667
3474,2011-05-29,2,0,5,16,194,167,361,362.6666666666667
3475,2011-05-29,2,0,5,17,214,169,383,373.3333333333333
3476,2011-05-29,2,0,5,18,151,177,328,357.3333333333333
3477,2011-05-29,2,0,5,19,141,146,287,332.6666666666667
3478,2011-05-29,2,0,5,20,91,128,219,278.0
3479,2011-05-29,2,0,5,21,107,122,229,245.0
3480,2011-05-29,2,0,5,22,78,93,171,206.33333333333334
3481,2011-05-29,2,0,5,23,48,87,135,178.33333333333334
3482,2011-05-30,2,0,5,0,38,65,103,136.33333333333334
3483,2011-05-30,2,0,5,1,26,53,79,105.66666666666667
3484,2011-05-30,2,0,5,2,17,28,45,75.66666666666667
3485,2011-05-30,2,0,5,3,10,8,18,47.333333333333336
3486,2011-05-30,2,0,5,4,2,4,6,23.0
3487,2011-05-30,2,0,5,5,1,6,7,10.333333333333334
3488,2011-05-30,2,0,5,6,6,10,16,9.666666666666666
3489,2011-05-30,2,0,5,7,12,19,31,18.0
3490,2011-05-30,2,0,5,8,36,58,94,47.0
3491,2011-05-30,2,0,5,9,47,81,128,84.33333333333333
3492,2011-05-30,2,0,5,10,116,153,269,163.66666666666666
3493,2011-05-30,2,0,5,11,153,168,321,239.33333333333334
3494,2011-05-30,2,0,5,12,179,187,366,318.6666666666667
3495,2011-05-30,2,0,5,13,133,217,350,345.6666666666667
3496,2011-05-30,2,0,5,14,142,185,327,347.6666666666667
3497,2011-05-30,2,0,5,15,132,179,311,329.3333333333333
3498,2011-05-30,2,0,5,16,101,208,309,315.6666666666667
3499,2011-05-30,2,0,5,17,102,202,304,308.0
3500,2011-05-30,2,0,5,18,77,172,249,287.3333333333333
3501,2011-05-30,2,0,5,19,68,157,225,259.3333333333333
3502,2011-05-30,2,0,5,20,69,168,237,237.0
3503,2011-05-30,2,0,5,21,42,107,149,203.66666666666666
3504,2011-05-30,2,0,5,22,26,80,106,164.0
3505,2011-05-30,2,0,5,23,14,34,48,101.0
3506,2011-05-31,2,0,5,0,9,20,29,61.0
3507,2011-05-31,2,0,5,1,8,9,17,31.333333333333332
3508,2011-05-31,2,0,5,2,5,7,12,19.333333333333332
3509,2011-05-31,2,0,5,3,1,3,4,11.0
3510,2011-05-31,2,0,5,4,0,3,3,6.333333333333333
3511,2011-05-31,2,0,5,5,0,26,26,11.0
3512,2011-05-31,2,0,5,6,11,98,109,46.0
3513,2011-05-31,2,0,5,7,16,219,235,123.33333333333333
3514,2011-05-31,2,0,5,8,34,372,406,250.0
3515,2011-05-31,2,0,5,9,22,153,175,272.0
3516,2011-05-31,2,0,5,10,37,72,109,230.0
3517,2011-05-31,2,0,5,11,28,78,106,130.0
3518,2011-05-31,2,0,5,12,37,125,162,125.66666666666667
3519,2011-05-31,2,0,5,13,37,110,147,138.33333333333334
3520,2011-05-31,2,0,5,14,41,99,140,149.66666666666666
3521,2011-05-31,2,0,5,15,42,133,175,154.0
3522,2011-05-31,2,0,5,16,44,205,249,188.0
3523,2011-05-31,2,0,5,17,67,428,495,306.3333333333333
3524,2011-05-31,2,0,5,18,55,362,417,387.0
3525,2011-05-31,2,0,5,19,39,246,285,399.0
3526,2011-05-31,2,0,5,20,38,213,251,317.6666666666667
3527,2011-05-31,2,0,5,21,45,165,210,248.66666666666666
3528,2011-05-31,2,0,5,22,42,117,159,206.66666666666666
3529,2011-05-31,2,0,5,23,15,46,61,143.33333333333334
3530,2011-06-01,2,0,6,0,9,25,34,84.66666666666667
3531,2011-06-01,2,0,6,1,8,9,17,37.333333333333336
3532,2011-06-01,2,0,6,2,0,3,3,18.0
3533,2011-06-01,2,0,6,3,0,6,6,8.666666666666666
3534,2011-06-01,2,0,6,4,0,4,4,4.333333333333333
3535,2011-06-01,2,0,6,5,2,19,21,10.333333333333334
3536,2011-06-01,2,0,6,6,7,121,128,51.0
3537,2011-06-01,2,0,6,7,19,265,284,144.33333333333334
3538,2011-06-01,2,0,6,8,37,417,454,288.6666666666667
3539,2011-06-01,2,0,6,9,34,173,207,315.0
3540,2011-06-01,2,0,6,10,31,84,115,258.6666666666667
3541,2011-06-01,2,0,6,11,26,86,112,144.66666666666666
3542,2011-06-01,2,0,6,12,32,137,169,132.0
3543,2011-06-01,2,0,6,13,29,125,154,145.0
3544,2011-06-01,2,0,6,14,40,105,145,156.0
3545,2011-06-01,2,0,6,15,25,127,152,150.33333333333334
3546,2011-06-01,2,0,6,16,39,227,266,187.66666666666666
3547,2011-06-01,2,0,6,17,52,434,486,301.3333333333333
3548,2011-06-01,2,0,6,18,31,278,309,353.6666666666667
3549,2011-06-01,2,0,6,19,16,248,264,353.0
3550,2011-06-01,2,0,6,20,23,233,256,276.3333333333333
3551,2011-06-01,2,0,6,21,29,161,190,236.66666666666666
3552,2011-06-01,2,0,6,22,14,115,129,191.66666666666666
3553,2011-06-01,2,0,6,23,10,59,69,129.33333333333334
3554,2011-06-02,2,0,6,0,11,31,42,80.0
3555,2011-06-02,2,0,6,1,3,12,15,42.0
3556,2011-06-02,2,0,6,2,0,6,6,21.0
3557,2011-06-02,2,0,6,3,0,4,4,8.333333333333334
3558,2011-06-02,2,0,6,4,0,3,3,4.333333333333333
3559,2011-06-02,2,0,6,5,3,28,31,12.666666666666666
3560,2011-06-02,2,0,6,6,7,106,113,49.0
3561,2011-06-02,2,0,6,7,19,285,304,149.33333333333334
3562,2011-06-02,2,0,6,8,25,442,467,294.6666666666667
3563,2011-06-02,2,0,6,9,28,197,225,332.0
3564,2011-06-02,2,0,6,10,33,106,139,277.0
3565,2011-06-02,2,0,6,11,42,123,165,176.33333333333334
3566,2011-06-02,2,0,6,12,39,193,232,178.66666666666666
3567,2011-06-02,2,0,6,13,35,168,203,200.0
3568,2011-06-02,2,0,6,14,43,142,185,206.66666666666666
3569,2011-06-02,2,0,6,15,44,144,188,192.0
3570,2011-06-02,2,0,6,16,63,255,318,230.33333333333334
3571,2011-06-02,2,0,6,17,88,484,572,359.3333333333333
3572,2011-06-02,2,0,6,18,74,451,525,471.6666666666667
3573,2011-06-02,2,0,6,19,58,321,379,492.0
3574,2011-06-02,2,0,6,20,51,286,337,413.6666666666667
3575,2011-06-02,2,0,6,21,33,215,248,321.3333333333333
3576,2011-06-02,2,0,6,22,14,141,155,246.66666666666666
3577,2011-06-02,2,0,6,23,23,89,112,171.66666666666666
3578,2011-06-03,2,0,6,0,15,53,68,111.66666666666667
3579,2011-06-03,2,0,6,1,7,15,22,67.33333333333333
3580,2011-06-03,2,0,6,2,0,12,12,34.0
3581,2011-06-03,2,0,6,3,0,5,5,13.0
3582,2011-06-03,2,0,6,4,1,5,6,7.666666666666667
3583,2011-06-03,2,0,6,5,4,24,28,13.0
3584,2011-06-03,2,0,6,6,8,98,106,46.666666666666664
3585,2011-06-03,2,0,6,7,25,252,277,137.0
3586,2011-06-03,2,0,6,8,31,471,502,295.0
3587,2011-06-03,2,0,6,9,36,194,230,336.3333333333333
3588,2011-06-03,2,0,6,10,54,107,161,297.6666666666667
3589,2011-06-03,2,0,6,11,57,135,192,194.33333333333334
3590,2011-06-03,2,0,6,12,51,208,259,204.0
3591,2011-06-03,2,0,6,13,58,190,248,233.0
3592,2011-06-03,2,0,6,14,66,174,240,249.0
3593,2011-06-03,2,0,6,15,56,156,212,233.33333333333334
3594,2011-06-03,2,0,6,16,63,286,349,267.0
3595,2011-06-03,2,0,6,17,73,485,558,373.0
3596,2011-06-03,2,0,6,18,76,488,564,490.3333333333333
3597,2011-06-03,2,0,6,19,53,338,391,504.3333333333333
3598,2011-06-03,2,0,6,20,57,236,293,416.0
3599,2011-06-03,2,0,6,21,51,196,247,310.3333333333333
3600,2011-06-03,2,0,6,22,26,145,171,237.0
3601,2011-06-03,2,0,6,23,30,141,171,196.33333333333334
3602,2011-06-04,2,0,6,0,24,69,93,145.0
3603,2011-06-04,2,0,6,1,14,80,94,119.33333333333333
3604,2011-06-04,2,0,6,2,18,41,59,82.0
3605,2011-06-04,2,0,6,3,8,10,18,57.0
3606,2011-06-04,2,0,6,4,4,11,15,30.666666666666668
3607,2011-06-04,2,0,6,5,3,5,8,13.666666666666666
3608,2011-06-04,2,0,6,6,11,17,28,17.0
3609,2011-06-04,2,0,6,7,27,60,87,41.0
3610,2011-06-04,2,0,6,8,29,96,125,80.0
3611,2011-06-04,2,0,6,9,55,169,224,145.33333333333334
3612,2011-06-04,2,0,6,10,115,202,317,222.0
3613,2011-06-04,2,0,6,11,120,249,369,303.3333333333333
3614,2011-06-04,2,0,6,12,150,270,420,368.6666666666667
3615,2011-06-04,2,0,6,13,188,268,456,415.0
3616,2011-06-04,2,0,6,14,193,258,451,442.3333333333333
3617,2011-06-04,2,0,6,15,180,224,404,437.0
3618,2011-06-04,2,0,6,16,168,272,440,431.6666666666667
3619,2011-06-04,2,0,6,17,142,202,344,396.0
3620,2011-06-04,2,0,6,18,127,214,341,375.0
3621,2011-06-04,2,0,6,19,79,206,285,323.3333333333333
3622,2011-06-04,2,0,6,20,90,149,239,288.3333333333333
3623,2011-06-04,2,0,6,21,46,139,185,236.33333333333334
3624,2011-06-04,2,0,6,22,49,141,190,204.66666666666666
3625,2011-06-04,2,0,6,23,29,121,150,175.0
3626,2011-06-05,2,0,6,0,23,90,113,151.0
3627,2011-06-05,2,0,6,1,26,70,96,119.66666666666667
3628,2011-06-05,2,0,6,2,16,48,64,91.0
3629,2011-06-05,2,0,6,3,22,25,47,69.0
3630,2011-06-05,2,0,6,4,4,8,12,41.0
3631,2011-06-05,2,0,6,5,1,5,6,21.666666666666668
3632,2011-06-05,2,0,6,6,10,11,21,13.0
3633,2011-06-05,2,0,6,7,8,19,27,18.0
3634,2011-06-05,2,0,6,8,24,74,98,48.666666666666664
3635,2011-06-05,2,0,6,9,53,111,164,96.33333333333333
3636,2011-06-05,2,0,6,10,83,168,251,171.0
3637,2011-06-05,2,0,6,11,121,214,335,250.0
3638,2011-06-05,2,0,6,12,123,212,335,307.0
3639,2011-06-05,2,0,6,13,154,213,367,345.6666666666667
3640,2011-06-05,2,0,6,14,161,224,385,362.3333333333333
3641,2011-06-05,2,0,6,15,161,256,417,389.6666666666667
3642,2011-06-05,2,0,6,16,138,260,398,400.0
3643,2011-06-05,2,0,6,17,126,264,390,401.6666666666667
3644,2011-06-05,2,0,6,18,124,239,363,383.6666666666667
3645,2011-06-05,2,0,6,19,108,249,357,370.0
3646,2011-06-05,2,0,6,20,84,195,279,333.0
3647,2011-06-05,2,0,6,21,54,111,165,267.0
3648,2011-06-05,2,0,6,22,36,94,130,191.33333333333334
3649,2011-06-05,2,0,6,23,25,61,86,127.0
3650,2011-06-06,2,0,6,0,11,18,29,81.66666666666667
3651,2011-06-06,2,0,6,1,9,5,14,43.0
3652,2011-06-06,2,0,6,2,4,4,8,17.0
3653,2011-06-06,2,0,6,3,2,3,5,9.0
3654,2011-06-06,2,0,6,4,4,4,8,7.0
3655,2011-06-06,2,0,6,5,7,24,31,14.666666666666666
3656,2011-06-06,2,0,6,6,11,101,112,50.333333333333336
3657,2011-06-06,2,0,6,7,18,281,299,147.33333333333334
3658,2011-06-06,2,0,6,8,28,410,438,283.0
3659,2011-06-06,2,0,6,9,26,162,188,308.3333333333333
3660,2011-06-06,2,0,6,10,31,64,95,240.33333333333334
3661,2011-06-06,2,0,6,11,39,72,111,131.33333333333334
3662,2011-06-06,2,0,6,12,25,128,153,119.66666666666667
3663,2011-06-06,2,0,6,13,28,152,180,148.0
3664,2011-06-06,2,0,6,14,46,99,145,159.33333333333334
3665,2011-06-06,2,0,6,15,38,127,165,163.33333333333334
3666,2011-06-06,2,0,6,16,34,233,267,192.33333333333334
3667,2011-06-06,2,0,6,17,63,516,579,337.0
3668,2011-06-06,2,0,6,18,56,500,556,467.3333333333333
3669,2011-06-06,2,0,6,19,64,343,407,514.0
3670,2011-06-06,2,0,6,20,59,277,336,433.0
3671,2011-06-06,2,0,6,21,29,160,189,310.6666666666667
3672,2011-06-06,2,0,6,22,36,137,173,232.66666666666666
3673,2011-06-06,2,0,6,23,5,55,60,140.66666666666666
3674,2011-06-07,2,0,6,0,5,15,20,84.33333333333333
3675,2011-06-07,2,0,6,1,2,2,4,28.0
3676,2011-06-07,2,0,6,2,3,2,5,9.666666666666666
3677,2011-06-07,2,0,6,3,1,1,2,3.6666666666666665
3678,2011-06-07,2,0,6,4,2,3,5,4.0
3679,2011-06-07,2,0,6,5,2,30,32,13.0
3680,2011-06-07,2,0,6,6,10,116,126,54.333333333333336
3681,2011-06-07,2,0,6,7,23,311,334,164.0
3682,2011-06-07,2,0,6,8,45,432,477,312.3333333333333
3683,2011-06-07,2,0,6,9,27,190,217,342.6666666666667
3684,2011-06-07,2,0,6,10,37,86,123,272.3333333333333
3685,2011-06-07,2,0,6,11,38,113,151,163.66666666666666
3686,2011-06-07,2,0,6,12,42,141,183,152.33333333333334
3687,2011-06-07,2,0,6,13,55,141,196,176.66666666666666
3688,2011-06-07,2,0,6,14,34,112,146,175.0
3689,2011-06-07,2,0,6,15,56,127,183,175.0
3690,2011-06-07,2,0,6,16,55,253,308,212.33333333333334
3691,2011-06-07,2,0,6,17,64,475,539,343.3333333333333
3692,2011-06-07,2,0,6,18,72,479,551,466.0
3693,2011-06-07,2,0,6,19,69,355,424,504.6666666666667
3694,2011-06-07,2,0,6,20,45,301,346,440.3333333333333
3695,2011-06-07,2,0,6,21,31,187,218,329.3333333333333
3696,2011-06-07,2,0,6,22,27,126,153,239.0
3697,2011-06-07,2,0,6,23,18,72,90,153.66666666666666
3698,2011-06-08,2,0,6,0,12,29,41,94.66666666666667
3699,2011-06-08,2,0,6,1,3,20,23,51.333333333333336
3700,2011-06-08,2,0,6,2,0,7,7,23.666666666666668
3701,2011-06-08,2,0,6,3,2,1,3,11.0
3702,2011-06-08,2,0,6,4,0,6,6,5.333333333333333
3703,2011-06-08,2,0,6,5,0,21,21,10.0
3704,2011-06-08,2,0,6,6,13,103,116,47.666666666666664
3705,2011-06-08,2,0,6,7,24,329,353,163.33333333333334
3706,2011-06-08,2,0,6,8,46,435,481,316.6666666666667
3707,2011-06-08,2,0,6,9,34,168,202,345.3333333333333
3708,2011-06-08,2,0,6,10,27,63,90,257.6666666666667
3709,2011-06-08,2,0,6,11,28,106,134,142.0
3710,2011-06-08,2,0,6,12,15,134,149,124.33333333333333
3711,2011-06-08,2,0,6,13,20,116,136,139.66666666666666
3712,2011-06-08,2,0,6,14,44,111,155,146.66666666666666
3713,2011-06-08,2,0,6,15,28,100,128,139.66666666666666
3714,2011-06-08,2,0,6,16,34,199,233,172.0
3715,2011-06-08,2,0,6,17,80,426,506,289.0
3716,2011-06-08,2,0,6,18,61,398,459,399.3333333333333
3717,2011-06-08,2,0,6,19,61,323,384,449.6666666666667
3718,2011-06-08,2,0,6,20,55,225,280,374.3333333333333
3719,2011-06-08,2,0,6,21,34,168,202,288.6666666666667
3720,2011-06-08,2,0,6,22,37,139,176,219.33333333333334
3721,2011-06-08,2,0,6,23,18,98,116,164.66666666666666
3722,2011-06-09,2,0,6,0,7,40,47,113.0
3723,2011-06-09,2,0,6,1,3,13,16,59.666666666666664
3724,2011-06-09,2,0,6,2,0,6,6,23.0
3725,2011-06-09,2,0,6,3,0,2,2,8.0
3726,2011-06-09,2,0,6,4,2,4,6,4.666666666666667
3727,2011-06-09,2,0,6,5,1,19,20,9.333333333333334
3728,2011-06-09,2,0,6,6,13,105,118,48.0
3729,2011-06-09,2,0,6,7,31,283,314,150.66666666666666
3730,2011-06-09,2,0,6,8,32,400,432,288.0
3731,2011-06-09,2,0,6,9,20,148,168,304.6666666666667
3732,2011-06-09,2,0,6,10,20,74,94,231.33333333333334
3733,2011-06-09,2,0,6,11,36,82,118,126.66666666666667
3734,2011-06-09,2,0,6,12,40,100,140,117.33333333333333
3735,2011-06-09,2,0,6,13,18,118,136,131.33333333333334
3736,2011-06-09,2,0,6,14,25,93,118,131.33333333333334
3737,2011-06-09,2,0,6,15,18,86,104,119.33333333333333
3738,2011-06-09,2,0,6,16,30,170,200,140.66666666666666
3739,2011-06-09,2,0,6,17,54,355,409,237.66666666666666
3740,2011-06-09,2,0,6,18,52,414,466,358.3333333333333
3741,2011-06-09,2,0,6,19,55,271,326,400.3333333333333
3742,2011-06-09,2,0,6,20,40,214,254,348.6666666666667
3743,2011-06-09,2,0,6,21,29,142,171,250.33333333333334
3744,2011-06-09,2,0,6,22,22,131,153,192.66666666666666
3745,2011-06-09,2,0,6,23,15,82,97,140.33333333333334
3746,2011-06-10,2,0,6,0,8,61,69,106.33333333333333
3747,2011-06-10,2,0,6,1,5,18,23,63.0
3748,2011-06-10,2,0,6,2,6,7,13,35.0
3749,2011-06-10,2,0,6,3,3,3,6,14.0
3750,2011-06-10,2,0,6,4,0,4,4,7.666666666666667
3751,2011-06-10,2,0,6,5,0,28,28,12.666666666666666
3752,2011-06-10,2,0,6,6,10,94,104,45.333333333333336
3753,2011-06-10,2,0,6,7,25,242,267,133.0
3754,2011-06-10,2,0,6,8,29,423,452,274.3333333333333
3755,2011-06-10,2,0,6,9,37,176,213,310.6666666666667
3756,2011-06-10,2,0,6,10,23,88,111,258.6666666666667
3757,2011-06-10,2,0,6,11,46,107,153,159.0
3758,2011-06-10,2,0,6,12,40,167,207,157.0
3759,2011-06-10,2,0,6,13,40,149,189,183.0
3760,2011-06-10,2,0,6,14,44,121,165,187.0
3761,2011-06-10,2,0,6,15,49,163,212,188.66666666666666
3762,2011-06-10,2,0,6,16,46,239,285,220.66666666666666
3763,2011-06-10,2,0,6,17,63,454,517,338.0
3764,2011-06-10,2,0,6,18,96,367,463,421.6666666666667
3765,2011-06-10,2,0,6,19,61,245,306,428.6666666666667
3766,2011-06-10,2,0,6,20,53,197,250,339.6666666666667
3767,2011-06-10,2,0,6,21,55,163,218,258.0
3768,2011-06-10,2,0,6,22,40,145,185,217.66666666666666
3769,2011-06-10,2,0,6,23,36,110,146,183.0
3770,2011-06-11,2,0,6,0,28,89,117,149.33333333333334
3771,2011-06-11,2,0,6,1,10,67,77,113.33333333333333
3772,2011-06-11,2,0,6,2,10,50,60,84.66666666666667
3773,2011-06-11,2,0,6,3,10,18,28,55.0
3774,2011-06-11,2,0,6,4,4,9,13,33.666666666666664
3775,2011-06-11,2,0,6,5,4,12,16,19.0
3776,2011-06-11,2,0,6,6,9,31,40,23.0
3777,2011-06-11,2,0,6,7,18,50,68,41.333333333333336
3778,2011-06-11,2,0,6,8,32,111,143,83.66666666666667
3779,2011-06-11,2,0,6,9,59,171,230,147.0
3780,2011-06-11,2,0,6,10,91,173,264,212.33333333333334
3781,2011-06-11,2,0,6,11,110,215,325,273.0
3782,2011-06-11,2,0,6,12,112,235,347,312.0
3783,2011-06-11,2,0,6,13,150,237,387,353.0
3784,2011-06-11,2,0,6,14,148,232,380,371.3333333333333
3785,2011-06-11,2,0,6,15,142,232,374,380.3333333333333
3786,2011-06-11,2,0,6,16,169,225,394,382.6666666666667
3787,2011-06-11,2,0,6,17,147,190,337,368.3333333333333
3788,2011-06-11,2,0,6,18,131,155,286,339.0
3789,2011-06-11,2,0,6,19,97,167,264,295.6666666666667
3790,2011-06-11,2,0,6,20,95,180,275,275.0
3791,2011-06-11,2,0,6,21,76,144,220,253.0
3792,2011-06-11,2,0,6,22,53,137,190,228.33333333333334
3793,2011-06-11,2,0,6,23,24,107,131,180.33333333333334
3794,2011-06-12,2,0,6,0,19,100,119,146.66666666666666
3795,2011-06-12,2,0,6,1,19,74,93,114.33333333333333
3796,2011-06-12,2,0,6,2,9,57,66,92.66666666666667
3797,2011-06-12,2,0,6,3,8,20,28,62.333333333333336
3798,2011-06-12,2,0,6,4,8,6,14,36.0
3799,2011-06-12,2,0,6,5,5,5,10,17.333333333333332
3800,2011-06-12,2,0,6,6,5,9,14,12.666666666666666
3801,2011-06-12,2,0,6,7,7,27,34,19.333333333333332
3802,2011-06-12,2,0,6,8,28,64,92,46.666666666666664
3803,2011-06-12,2,0,6,9,75,107,182,102.66666666666667
3804,2011-06-12,2,0,6,10,120,191,311,195.0
3805,2011-06-12,2,0,6,11,131,236,367,286.6666666666667
3806,2011-06-12,2,0,6,12,176,244,420,366.0
3807,2011-06-12,2,0,6,13,109,264,373,386.6666666666667
3808,2011-06-12,2,0,6,14,96,219,315,369.3333333333333
3809,2011-06-12,2,0,6,15,142,218,360,349.3333333333333
3810,2011-06-12,2,0,6,16,115,235,350,341.6666666666667
3811,2011-06-12,2,0,6,17,94,158,252,320.6666666666667
3812,2011-06-12,2,0,6,18,69,187,256,286.0
3813,2011-06-12,2,0,6,19,67,156,223,243.66666666666666
3814,2011-06-12,2,0,6,20,62,144,206,228.33333333333334
3815,2011-06-12,2,0,6,21,39,101,140,189.66666666666666
3816,2011-06-12,2,0,6,22,31,97,128,158.0
3817,2011-06-12,2,0,6,23,33,74,107,125.0
3818,2011-06-13,2,0,6,0,8,20,28,87.66666666666667
3819,2011-06-13,2,0,6,1,6,10,16,50.333333333333336
3820,2011-06-13,2,0,6,2,2,8,10,18.0
3821,2011-06-13,2,0,6,3,1,6,7,11.0
3822,2011-06-13,2,0,6,4,1,3,4,7.0
3823,2011-06-13,2,0,6,5,2,27,29,13.333333333333334
3824,2011-06-13,2,0,6,6,7,98,105,46.0
3825,2011-06-13,2,0,6,7,26,302,328,154.0
3826,2011-06-13,2,0,6,8,44,432,476,303.0
3827,2011-06-13,2,0,6,9,35,189,224,342.6666666666667
3828,2011-06-13,2,0,6,10,38,80,118,272.6666666666667
3829,2011-06-13,2,0,6,11,53,106,159,167.0
3830,2011-06-13,2,0,6,12,35,161,196,157.66666666666666
3831,2011-06-13,2,0,6,13,53,174,227,194.0
3832,2011-06-13,2,0,6,14,55,145,200,207.66666666666666
3833,2011-06-13,2,0,6,15,58,127,185,204.0
3834,2011-06-13,2,0,6,16,64,262,326,237.0
3835,2011-06-13,2,0,6,17,72,529,601,370.6666666666667
3836,2011-06-13,2,0,6,18,76,510,586,504.3333333333333
3837,2011-06-13,2,0,6,19,75,348,423,536.6666666666666
3838,2011-06-13,2,0,6,20,78,253,331,446.6666666666667
3839,2011-06-13,2,0,6,21,40,178,218,324.0
3840,2011-06-13,2,0,6,22,20,114,134,227.66666666666666
3841,2011-06-13,2,0,6,23,14,75,89,147.0
3842,2011-06-14,2,0,6,0,13,18,31,84.66666666666667
3843,2011-06-14,2,0,6,1,3,10,13,44.333333333333336
3844,2011-06-14,2,0,6,2,2,8,10,18.0
3845,2011-06-14,2,0,6,3,1,1,2,8.333333333333334
3846,2011-06-14,2,0,6,4,0,3,3,5.0
3847,2011-06-14,2,0,6,5,3,23,26,10.333333333333334
3848,2011-06-14,2,0,6,6,6,107,113,47.333333333333336
3849,2011-06-14,2,0,6,7,19,346,365,168.0
3850,2011-06-14,2,0,6,8,45,441,486,321.3333333333333
3851,2011-06-14,2,0,6,9,19,174,193,348.0
3852,2011-06-14,2,0,6,10,33,97,130,269.6666666666667
3853,2011-06-14,2,0,6,11,40,103,143,155.33333333333334
3854,2011-06-14,2,0,6,12,30,139,169,147.33333333333334
3855,2011-06-14,2,0,6,13,33,176,209,173.66666666666666
3856,2011-06-14,2,0,6,14,41,118,159,179.0
3857,2011-06-14,2,0,6,15,42,136,178,182.0
3858,2011-06-14,2,0,6,16,51,279,330,222.33333333333334
3859,2011-06-14,2,0,6,17,85,484,569,359.0
3860,2011-06-14,2,0,6,18,65,473,538,479.0
3861,2011-06-14,2,0,6,19,51,335,386,497.6666666666667
3862,2011-06-14,2,0,6,20,60,237,297,407.0
3863,2011-06-14,2,0,6,21,37,206,243,308.6666666666667
3864,2011-06-14,2,0,6,22,29,159,188,242.66666666666666
3865,2011-06-14,2,0,6,23,19,91,110,180.33333333333334
3866,2011-06-15,2,0,6,0,8,44,52,116.66666666666667
3867,2011-06-15,2,0,6,1,0,14,14,58.666666666666664
3868,2011-06-15,2,0,6,2,0,9,9,25.0
3869,2011-06-15,2,0,6,3,0,1,1,8.0
3870,2011-06-15,2,0,6,4,0,4,4,4.666666666666667
3871,2011-06-15,2,0,6,5,1,20,21,8.666666666666666
3872,2011-06-15,2,0,6,6,11,110,121,48.666666666666664
3873,2011-06-15,2,0,6,7,22,348,370,170.66666666666666
3874,2011-06-15,2,0,6,8,53,445,498,329.6666666666667
3875,2011-06-15,2,0,6,9,22,185,207,358.3333333333333
3876,2011-06-15,2,0,6,10,27,108,135,280.0
3877,2011-06-15,2,0,6,11,49,115,164,168.66666666666666
3878,2011-06-15,2,0,6,12,33,178,211,170.0
3879,2011-06-15,2,0,6,13,43,146,189,188.0
3880,2011-06-15,2,0,6,14,50,128,178,192.66666666666666
3881,2011-06-15,2,0,6,15,33,131,164,177.0
3882,2011-06-15,2,0,6,16,47,265,312,218.0
3883,2011-06-15,2,0,6,17,83,555,638,371.3333333333333
3884,2011-06-15,2,0,6,18,80,527,607,519.0
3885,2011-06-15,2,0,6,19,54,362,416,553.6666666666666
3886,2011-06-15,2,0,6,20,57,273,330,451.0
3887,2011-06-15,2,0,6,21,48,209,257,334.3333333333333
3888,2011-06-15,2,0,6,22,31,144,175,254.0
3889,2011-06-15,2,0,6,23,17,90,107,179.66666666666666
3890,2011-06-16,2,0,6,0,9,38,47,109.66666666666667
3891,2011-06-16,2,0,6,1,4,13,17,57.0
3892,2011-06-16,2,0,6,2,1,4,5,23.0
3893,2011-06-16,2,0,6,3,0,4,4,8.666666666666666
3894,2011-06-16,2,0,6,4,0,6,6,5.0
3895,2011-06-16,2,0,6,5,7,18,25,11.666666666666666
3896,2011-06-16,2,0,6,6,8,104,112,47.666666666666664
3897,2011-06-16,2,0,6,7,16,172,188,108.33333333333333
3898,2011-06-16,2,0,6,8,24,364,388,229.33333333333334
3899,2011-06-16,2,0,6,9,29,232,261,279.0
3900,2011-06-16,2,0,6,10,18,103,121,256.6666666666667
3901,2011-06-16,2,0,6,11,33,117,150,177.33333333333334
3902,2011-06-16,2,0,6,12,41,165,206,159.0
3903,2011-06-16,2,0,6,13,37,114,151,169.0
3904,2011-06-16,2,0,6,14,39,114,153,170.0
3905,2011-06-16,2,0,6,15,32,127,159,154.33333333333334
3906,2011-06-16,2,0,6,16,36,258,294,202.0
3907,2011-06-16,2,0,6,17,42,230,272,241.66666666666666
3908,2011-06-16,2,0,6,18,26,299,325,297.0
3909,2011-06-16,2,0,6,19,58,269,327,308.0
3910,2011-06-16,2,0,6,20,25,176,201,284.3333333333333
3911,2011-06-16,2,0,6,21,34,154,188,238.66666666666666
3912,2011-06-16,2,0,6,22,24,127,151,180.0
3913,2011-06-16,2,0,6,23,2,14,16,118.33333333333333
3914,2011-06-17,2,0,6,0,3,21,24,63.666666666666664
3915,2011-06-17,2,0,6,1,4,19,23,21.0
3916,2011-06-17,2,0,6,2,2,11,13,20.0
3917,2011-06-17,2,0,6,3,1,5,6,14.0
3918,2011-06-17,2,0,6,4,1,5,6,8.333333333333334
3919,2011-06-17,2,0,6,5,1,12,13,8.333333333333334
3920,2011-06-17,2,0,6,6,8,89,97,38.666666666666664
3921,2011-06-17,2,0,6,7,25,225,250,120.0
3922,2011-06-17,2,0,6,8,28,426,454,267.0
3923,2011-06-17,2,0,6,9,28,196,224,309.3333333333333
3924,2011-06-17,2,0,6,10,44,126,170,282.6666666666667
3925,2011-06-17,2,0,6,11,43,138,181,191.66666666666666
3926,2011-06-17,2,0,6,12,49,194,243,198.0
3927,2011-06-17,2,0,6,13,48,156,204,209.33333333333334
3928,2011-06-17,2,0,6,14,73,142,215,220.66666666666666
3929,2011-06-17,2,0,6,15,62,181,243,220.66666666666666
3930,2011-06-17,2,0,6,16,69,286,355,271.0
3931,2011-06-17,2,0,6,17,85,467,552,383.3333333333333
3932,2011-06-17,2,0,6,18,62,388,450,452.3333333333333
3933,2011-06-17,2,0,6,19,53,275,328,443.3333333333333
3934,2011-06-17,2,0,6,20,40,192,232,336.6666666666667
3935,2011-06-17,2,0,6,21,49,159,208,256.0
3936,2011-06-17,2,0,6,22,48,127,175,205.0
3937,2011-06-17,2,0,6,23,37,141,178,187.0
3938,2011-06-18,2,0,6,0,21,83,104,152.33333333333334
3939,2011-06-18,2,0,6,1,15,80,95,125.66666666666667
3940,2011-06-18,2,0,6,2,16,37,53,84.0
3941,2011-06-18,2,0,6,3,4,16,20,56.0
3942,2011-06-18,2,0,6,4,1,4,5,26.0
3943,2011-06-18,2,0,6,5,1,6,7,10.666666666666666
3944,2011-06-18,2,0,6,6,9,18,27,13.0
3945,2011-06-18,2,0,6,7,12,45,57,30.333333333333332
3946,2011-06-18,2,0,6,8,28,103,131,71.66666666666667
3947,2011-06-18,2,0,6,9,62,156,218,135.33333333333334
3948,2011-06-18,2,0,6,10,68,176,244,197.66666666666666
3949,2011-06-18,2,0,6,11,134,270,404,288.6666666666667
3950,2011-06-18,2,0,6,12,162,258,420,356.0
3951,2011-06-18,2,0,6,13,135,192,327,383.6666666666667
3952,2011-06-18,2,0,6,14,138,196,334,360.3333333333333
3953,2011-06-18,2,0,6,15,153,214,367,342.6666666666667
3954,2011-06-18,2,0,6,16,193,275,468,389.6666666666667
3955,2011-06-18,2,0,6,17,210,239,449,428.0
3956,2011-06-18,2,0,6,18,118,263,381,432.6666666666667
3957,2011-06-18,2,0,6,19,99,227,326,385.3333333333333
3958,2011-06-18,2,0,6,20,61,127,188,298.3333333333333
3959,2011-06-18,2,0,6,21,58,125,183,232.33333333333334
3960,2011-06-18,2,0,6,22,56,105,161,177.33333333333334
3961,2011-06-18,2,0,6,23,53,97,150,164.66666666666666
3962,2011-06-19,2,0,6,0,18,71,89,133.33333333333334
3963,2011-06-19,2,0,6,1,17,59,76,105.0
3964,2011-06-19,2,0,6,2,13,59,72,79.0
3965,2011-06-19,2,0,6,3,14,16,30,59.333333333333336
3966,2011-06-19,2,0,6,4,7,10,17,39.666666666666664
3967,2011-06-19,2,0,6,5,7,12,19,22.0
3968,2011-06-19,2,0,6,6,11,22,33,23.0
3969,2011-06-19,2,0,6,7,35,36,71,41.0
3970,2011-06-19,2,0,6,8,25,59,84,62.666666666666664
3971,2011-06-19,2,0,6,9,58,111,169,108.0
3972,2011-06-19,2,0,6,10,86,158,244,165.66666666666666
3973,2011-06-19,2,0,6,11,141,236,377,263.3333333333333
3974,2011-06-19,2,0,6,12,141,255,396,339.0
3975,2011-06-19,2,0,6,13,149,214,363,378.6666666666667
3976,2011-06-19,2,0,6,14,124,193,317,358.6666666666667
3977,2011-06-19,2,0,6,15,146,216,362,347.3333333333333
3978,2011-06-19,2,0,6,16,121,257,378,352.3333333333333
3979,2011-06-19,2,0,6,17,159,238,397,379.0
3980,2011-06-19,2,0,6,18,78,218,296,357.0
3981,2011-06-19,2,0,6,19,94,217,311,334.6666666666667
3982,2011-06-19,2,0,6,20,86,146,232,279.6666666666667
3983,2011-06-19,2,0,6,21,57,110,167,236.66666666666666
3984,2011-06-19,2,0,6,22,38,114,152,183.66666666666666
3985,2011-06-19,2,0,6,23,14,78,92,137.0
3986,2011-06-20,2,0,6,0,7,19,26,90.0
3987,2011-06-20,2,0,6,1,9,3,12,43.333333333333336
3988,2011-06-20,2,0,6,2,2,0,2,13.333333333333334
3989,2011-06-20,2,0,6,3,1,0,1,5.0
3990,2011-06-20,2,0,6,4,1,2,3,2.0
3991,2011-06-20,2,0,6,5,0,3,3,2.3333333333333335
3992,2011-06-20,2,0,6,6,1,25,26,10.666666666666666
3993,2011-06-20,2,0,6,7,0,46,46,25.0
3994,2011-06-20,2,0,6,8,12,209,221,97.66666666666667
3995,2011-06-20,2,0,6,9,19,200,219,162.0
3996,2011-06-20,2,0,6,10,33,58,91,177.0
3997,2011-06-20,2,0,6,11,27,67,94,134.66666666666666
3998,2011-06-20,2,0,6,12,33,129,162,115.66666666666667
3999,2011-06-20,2,0,6,13,50,129,179,145.0
4000,2011-06-20,2,0,6,14,45,130,175,172.0
4001,2011-06-20,2,0,6,15,66,139,205,186.33333333333334
4002,2011-06-20,2,0,6,16,61,238,299,226.33333333333334
4003,2011-06-20,2,0,6,17,81,484,565,356.3333333333333
4004,2011-06-20,2,0,6,18,64,474,538,467.3333333333333
4005,2011-06-20,2,0,6,19,62,369,431,511.3333333333333
4006,2011-06-20,2,0,6,20,52,264,316,428.3333333333333
4007,2011-06-20,2,0,6,21,39,167,206,317.6666666666667
4008,2011-06-20,2,0,6,22,24,106,130,217.33333333333334
4009,2011-06-20,2,0,6,23,10,50,60,132.0
4010,2011-06-21,3,0,6,0,10,23,33,74.33333333333333
4011,2011-06-21,3,0,6,1,2,12,14,35.666666666666664
4012,2011-06-21,3,0,6,2,1,5,6,17.666666666666668
4013,2011-06-21,3,0,6,3,0,2,2,7.333333333333333
4014,2011-06-21,3,0,6,4,2,7,9,5.666666666666667
4015,2011-06-21,3,0,6,5,3,22,25,12.0
4016,2011-06-21,3,0,6,6,8,107,115,49.666666666666664
4017,2011-06-21,3,0,6,7,21,288,309,149.66666666666666
4018,2011-06-21,3,0,6,8,33,368,401,275.0
4019,2011-06-21,3,0,6,9,32,243,275,328.3333333333333
4020,2011-06-21,3,0,6,10,41,120,161,279.0
4021,2011-06-21,3,0,6,11,52,119,171,202.33333333333334
4022,2011-06-21,3,0,6,12,40,149,189,173.66666666666666
4023,2011-06-21,3,0,6,13,49,158,207,189.0
4024,2011-06-21,3,0,6,14,44,108,152,182.66666666666666
4025,2011-06-21,3,0,6,15,42,128,170,176.33333333333334
4026,2011-06-21,3,0,6,16,62,273,335,219.0
4027,2011-06-21,3,0,6,17,65,507,572,359.0
4028,2011-06-21,3,0,6,18,67,469,536,481.0
4029,2011-06-21,3,0,6,19,67,358,425,511.0
4030,2011-06-21,3,0,6,20,72,254,326,429.0
4031,2011-06-21,3,0,6,21,38,191,229,326.6666666666667
4032,2011-06-21,3,0,6,22,12,97,109,221.33333333333334
4033,2011-06-21,3,0,6,23,11,53,64,134.0
4034,2011-06-22,3,0,6,0,15,18,33,68.66666666666667
4035,2011-06-22,3,0,6,1,2,19,21,39.333333333333336
4036,2011-06-22,3,0,6,2,2,5,7,20.333333333333332
4037,2011-06-22,3,0,6,3,0,7,7,11.666666666666666
4038,2011-06-22,3,0,6,4,3,8,11,8.333333333333334
4039,2011-06-22,3,0,6,5,2,21,23,13.666666666666666
4040,2011-06-22,3,0,6,6,12,110,122,52.0
4041,2011-06-22,3,0,6,7,23,288,311,152.0
4042,2011-06-22,3,0,6,8,27,396,423,285.3333333333333
4043,2011-06-22,3,0,6,9,14,205,219,317.6666666666667
4044,2011-06-22,3,0,6,10,31,104,135,259.0
4045,2011-06-22,3,0,6,11,37,108,145,166.33333333333334
4046,2011-06-22,3,0,6,12,44,144,188,156.0
4047,2011-06-22,3,0,6,13,34,113,147,160.0
4048,2011-06-22,3,0,6,14,32,113,145,160.0
4049,2011-06-22,3,0,6,15,32,114,146,146.0
4050,2011-06-22,3,0,6,16,34,224,258,183.0
4051,2011-06-22,3,0,6,17,67,462,529,311.0
4052,2011-06-22,3,0,6,18,66,447,513,433.3333333333333
4053,2011-06-22,3,0,6,19,62,280,342,461.3333333333333
4054,2011-06-22,3,0,6,20,52,230,282,379.0
4055,2011-06-22,3,0,6,21,31,216,247,290.3333333333333
4056,2011-06-22,3,0,6,22,25,123,148,225.66666666666666
4057,2011-06-22,3,0,6,23,14,91,105,166.66666666666666
4058,2011-06-23,3,0,6,0,5,44,49,100.66666666666667
4059,2011-06-23,3,0,6,1,5,26,31,61.666666666666664
4060,2011-06-23,3,0,6,2,0,4,4,28.0
4061,2011-06-23,3,0,6,3,1,4,5,13.333333333333334
4062,2011-06-23,3,0,6,4,0,7,7,5.333333333333333
4063,2011-06-23,3,0,6,5,2,22,24,12.0
4064,2011-06-23,3,0,6,6,8,92,100,43.666666666666664
4065,2011-06-23,3,0,6,7,26,301,327,150.33333333333334
4066,2011-06-23,3,0,6,8,20,412,432,286.3333333333333
4067,2011-06-23,3,0,6,9,33,194,227,328.6666666666667
4068,2011-06-23,3,0,6,10,39,88,127,262.0
4069,2011-06-23,3,0,6,11,28,108,136,163.33333333333334
4070,2011-06-23,3,0,6,12,30,130,160,141.0
4071,2011-06-23,3,0,6,13,37,149,186,160.66666666666666
4072,2011-06-23,3,0,6,14,46,103,149,165.0
4073,2011-06-23,3,0,6,15,62,127,189,174.66666666666666
4074,2011-06-23,3,0,6,16,58,217,275,204.33333333333334
4075,2011-06-23,3,0,6,17,74,495,569,344.3333333333333
4076,2011-06-23,3,0,6,18,57,483,540,461.3333333333333
4077,2011-06-23,3,0,6,19,56,344,400,503.0
4078,2011-06-23,3,0,6,20,75,277,352,430.6666666666667
4079,2011-06-23,3,0,6,21,46,188,234,328.6666666666667
4080,2011-06-23,3,0,6,22,23,139,162,249.33333333333334
4081,2011-06-23,3,0,6,23,15,90,105,167.0
4082,2011-06-24,3,0,6,0,10,53,63,110.0
4083,2011-06-24,3,0,6,1,8,20,28,65.33333333333333
4084,2011-06-24,3,0,6,2,4,10,14,35.0
4085,2011-06-24,3,0,6,3,1,4,5,15.666666666666666
4086,2011-06-24,3,0,6,4,1,8,9,9.333333333333334
4087,2011-06-24,3,0,6,5,2,18,20,11.333333333333334
4088,2011-06-24,3,0,6,6,4,87,91,40.0
4089,2011-06-24,3,0,6,7,21,247,268,126.33333333333333
4090,2011-06-24,3,0,6,8,27,439,466,275.0
4091,2011-06-24,3,0,6,9,28,203,231,321.6666666666667
4092,2011-06-24,3,0,6,10,43,102,145,280.6666666666667
4093,2011-06-24,3,0,6,11,56,147,203,193.0
4094,2011-06-24,3,0,6,12,51,150,201,183.0
4095,2011-06-24,3,0,6,13,43,178,221,208.33333333333334
4096,2011-06-24,3,0,6,14,67,162,229,217.0
4097,2011-06-24,3,0,6,15,69,147,216,222.0
4098,2011-06-24,3,0,6,16,80,247,327,257.3333333333333
4099,2011-06-24,3,0,6,17,85,472,557,366.6666666666667
4100,2011-06-24,3,0,6,18,87,365,452,445.3333333333333
4101,2011-06-24,3,0,6,19,92,293,385,464.6666666666667
4102,2011-06-24,3,0,6,20,66,222,288,375.0
4103,2011-06-24,3,0,6,21,50,183,233,302.0
4104,2011-06-24,3,0,6,22,41,126,167,229.33333333333334
4105,2011-06-24,3,0,6,23,33,139,172,190.66666666666666
4106,2011-06-25,3,0,6,0,19,97,116,151.66666666666666
4107,2011-06-25,3,0,6,1,20,75,95,127.66666666666667
4108,2011-06-25,3,0,6,2,8,51,59,90.0
4109,2011-06-25,3,0,6,3,18,21,39,64.33333333333333
4110,2011-06-25,3,0,6,4,7,4,11,36.333333333333336
4111,2011-06-25,3,0,6,5,6,8,14,21.333333333333332
4112,2011-06-25,3,0,6,6,12,17,29,18.0
4113,2011-06-25,3,0,6,7,7,35,42,28.333333333333332
4114,2011-06-25,3,0,6,8,27,85,112,61.0
4115,2011-06-25,3,0,6,9,47,139,186,113.33333333333333
4116,2011-06-25,3,0,6,10,99,203,302,200.0
4117,2011-06-25,3,0,6,11,122,209,331,273.0
4118,2011-06-25,3,0,6,12,140,252,392,341.6666666666667
4119,2011-06-25,3,0,6,13,140,231,371,364.6666666666667
4120,2011-06-25,3,0,6,14,151,232,383,382.0
4121,2011-06-25,3,0,6,15,157,235,392,382.0
4122,2011-06-25,3,0,6,16,175,235,410,395.0
4123,2011-06-25,3,0,6,17,152,247,399,400.3333333333333
4124,2011-06-25,3,0,6,18,108,199,307,372.0
4125,2011-06-25,3,0,6,19,121,254,375,360.3333333333333
4126,2011-06-25,3,0,6,20,74,195,269,317.0
4127,2011-06-25,3,0,6,21,62,140,202,282.0
4128,2011-06-25,3,0,6,22,61,126,187,219.33333333333334
4129,2011-06-25,3,0,6,23,49,130,179,189.33333333333334
4130,2011-06-26,3,0,6,0,30,85,115,160.33333333333334
4131,2011-06-26,3,0,6,1,17,73,90,128.0
4132,2011-06-26,3,0,6,2,17,70,87,97.33333333333333
4133,2011-06-26,3,0,6,3,12,22,34,70.33333333333333
4134,2011-06-26,3,0,6,4,3,8,11,44.0
4135,2011-06-26,3,0,6,5,3,9,12,19.0
4136,2011-06-26,3,0,6,6,7,13,20,14.333333333333334
4137,2011-06-26,3,0,6,7,24,27,51,27.666666666666668
4138,2011-06-26,3,0,6,8,29,78,107,59.333333333333336
4139,2011-06-26,3,0,6,9,75,131,206,121.33333333333333
4140,2011-06-26,3,0,6,10,136,196,332,215.0
4141,2011-06-26,3,0,6,11,127,219,346,294.6666666666667
4142,2011-06-26,3,0,6,12,175,268,443,373.6666666666667
4143,2011-06-26,3,0,6,13,197,245,442,410.3333333333333
4144,2011-06-26,3,0,6,14,197,246,443,442.6666666666667
4145,2011-06-26,3,0,6,15,174,229,403,429.3333333333333
4146,2011-06-26,3,0,6,16,177,278,455,433.6666666666667
4147,2011-06-26,3,0,6,17,178,243,421,426.3333333333333
4148,2011-06-26,3,0,6,18,117,265,382,419.3333333333333
4149,2011-06-26,3,0,6,19,89,228,317,373.3333333333333
4150,2011-06-26,3,0,6,20,55,158,213,304.0
4151,2011-06-26,3,0,6,21,48,135,183,237.66666666666666
4152,2011-06-26,3,0,6,22,19,95,114,170.0
4153,2011-06-26,3,0,6,23,14,64,78,125.0
4154,2011-06-27,3,0,6,0,7,25,32,74.66666666666667
4155,2011-06-27,3,0,6,1,4,11,15,41.666666666666664
4156,2011-06-27,3,0,6,2,3,3,6,17.666666666666668
4157,2011-06-27,3,0,6,3,0,2,2,7.666666666666667
4158,2011-06-27,3,0,6,4,1,8,9,5.666666666666667
4159,2011-06-27,3,0,6,5,1,21,22,11.0
4160,2011-06-27,3,0,6,6,4,90,94,41.666666666666664
4161,2011-06-27,3,0,6,7,14,247,261,125.66666666666667
4162,2011-06-27,3,0,6,8,29,418,447,267.3333333333333
4163,2011-06-27,3,0,6,9,37,150,187,298.3333333333333
4164,2011-06-27,3,0,6,10,55,95,150,261.3333333333333
4165,2011-06-27,3,0,6,11,55,95,150,162.33333333333334
4166,2011-06-27,3,0,6,12,40,130,170,156.66666666666666
4167,2011-06-27,3,0,6,13,37,127,164,161.33333333333334
4168,2011-06-27,3,0,6,14,58,100,158,164.0
4169,2011-06-27,3,0,6,15,76,126,202,174.66666666666666
4170,2011-06-27,3,0,6,16,53,222,275,211.66666666666666
4171,2011-06-27,3,0,6,17,90,514,604,360.3333333333333
4172,2011-06-27,3,0,6,18,79,512,591,490.0
4173,2011-06-27,3,0,6,19,56,340,396,530.3333333333334
4174,2011-06-27,3,0,6,20,54,251,305,430.6666666666667
4175,2011-06-27,3,0,6,21,52,190,242,314.3333333333333
4176,2011-06-27,3,0,6,22,33,112,145,230.66666666666666
4177,2011-06-27,3,0,6,23,16,65,81,156.0
4178,2011-06-28,3,0,6,0,5,25,30,85.33333333333333
4179,2011-06-28,3,0,6,1,5,8,13,41.333333333333336
4180,2011-06-28,3,0,6,2,2,9,11,18.0
4181,2011-06-28,3,0,6,3,0,2,2,8.666666666666666
4182,2011-06-28,3,0,6,4,1,7,8,7.0
4183,2011-06-28,3,0,6,5,1,20,21,10.333333333333334
4184,2011-06-28,3,0,6,6,7,117,124,51.0
4185,2011-06-28,3,0,6,7,27,320,347,164.0
4186,2011-06-28,3,0,6,8,39,417,456,309.0
4187,2011-06-28,3,0,6,9,38,208,246,349.6666666666667
4188,2011-06-28,3,0,6,10,45,112,157,286.3333333333333
4189,2011-06-28,3,0,6,11,49,118,167,190.0
4190,2011-06-28,3,0,6,12,41,161,202,175.33333333333334
4191,2011-06-28,3,0,6,13,33,156,189,186.0
4192,2011-06-28,3,0,6,14,43,117,160,183.66666666666666
4193,2011-06-28,3,0,6,15,39,127,166,171.66666666666666
4194,2011-06-28,3,0,6,16,41,220,261,195.66666666666666
4195,2011-06-28,3,0,6,17,70,509,579,335.3333333333333
4196,2011-06-28,3,0,6,18,68,436,504,448.0
4197,2011-06-28,3,0,6,19,44,255,299,460.6666666666667
4198,2011-06-28,3,0,6,20,50,246,296,366.3333333333333
4199,2011-06-28,3,0,6,21,31,164,195,263.3333333333333
4200,2011-06-28,3,0,6,22,30,104,134,208.33333333333334
4201,2011-06-28,3,0,6,23,23,58,81,136.66666666666666
4202,2011-06-29,3,0,6,0,11,25,36,83.66666666666667
4203,2011-06-29,3,0,6,1,10,18,28,48.333333333333336
4204,2011-06-29,3,0,6,2,7,9,16,26.666666666666668
4205,2011-06-29,3,0,6,3,2,3,5,16.333333333333332
4206,2011-06-29,3,0,6,4,0,5,5,8.666666666666666
4207,2011-06-29,3,0,6,5,3,19,22,10.666666666666666
4208,2011-06-29,3,0,6,6,12,104,116,47.666666666666664
4209,2011-06-29,3,0,6,7,18,318,336,158.0
4210,2011-06-29,3,0,6,8,41,499,540,330.6666666666667
4211,2011-06-29,3,0,6,9,32,189,221,365.6666666666667
4212,2011-06-29,3,0,6,10,31,95,126,295.6666666666667
4213,2011-06-29,3,0,6,11,53,117,170,172.33333333333334
4214,2011-06-29,3,0,6,12,55,188,243,179.66666666666666
4215,2011-06-29,3,0,6,13,45,186,231,214.66666666666666
4216,2011-06-29,3,0,6,14,50,138,188,220.66666666666666
4217,2011-06-29,3,0,6,15,43,146,189,202.66666666666666
4218,2011-06-29,3,0,6,16,60,268,328,235.0
4219,2011-06-29,3,0,6,17,78,492,570,362.3333333333333
4220,2011-06-29,3,0,6,18,78,510,588,495.3333333333333
4221,2011-06-29,3,0,6,19,60,341,401,519.6666666666666
4222,2011-06-29,3,0,6,20,69,264,333,440.6666666666667
4223,2011-06-29,3,0,6,21,26,195,221,318.3333333333333
4224,2011-06-29,3,0,6,22,32,151,183,245.66666666666666
4225,2011-06-29,3,0,6,23,32,97,129,177.66666666666666
4226,2011-06-30,3,0,6,0,15,39,54,122.0
4227,2011-06-30,3,0,6,1,13,19,32,71.66666666666667
4228,2011-06-30,3,0,6,2,2,6,8,31.333333333333332
4229,2011-06-30,3,0,6,3,2,7,9,16.333333333333332
4230,2011-06-30,3,0,6,4,2,4,6,7.666666666666667
4231,2011-06-30,3,0,6,5,1,24,25,13.333333333333334
4232,2011-06-30,3,0,6,6,4,119,123,51.333333333333336
4233,2011-06-30,3,0,6,7,29,291,320,156.0
4234,2011-06-30,3,0,6,8,44,511,555,332.6666666666667
4235,2011-06-30,3,0,6,9,33,227,260,378.3333333333333
4236,2011-06-30,3,0,6,10,35,97,132,315.6666666666667
4237,2011-06-30,3,0,6,11,47,122,169,187.0
4238,2011-06-30,3,0,6,12,50,183,233,178.0
4239,2011-06-30,3,0,6,13,70,162,232,211.33333333333334
4240,2011-06-30,3,0,6,14,46,117,163,209.33333333333334
4241,2011-06-30,3,0,6,15,64,176,240,211.66666666666666
4242,2011-06-30,3,0,6,16,63,260,323,242.0
4243,2011-06-30,3,0,6,17,98,496,594,385.6666666666667
4244,2011-06-30,3,0,6,18,114,472,586,501.0
4245,2011-06-30,3,0,6,19,89,366,455,545.0
4246,2011-06-30,3,0,6,20,55,285,340,460.3333333333333
4247,2011-06-30,3,0,6,21,81,242,323,372.6666666666667
4248,2011-06-30,3,0,6,22,43,164,207,290.0
4249,2011-06-30,3,0,6,23,27,99,126,218.66666666666666
4250,2011-07-01,3,0,7,0,20,48,68,133.66666666666666
4251,2011-07-01,3,0,7,1,15,16,31,75.0
4252,2011-07-01,3,0,7,2,6,7,13,37.333333333333336
4253,2011-07-01,3,0,7,3,5,6,11,18.333333333333332
4254,2011-07-01,3,0,7,4,1,5,6,10.0
4255,2011-07-01,3,0,7,5,3,27,30,15.666666666666666
4256,2011-07-01,3,0,7,6,11,97,108,48.0
4257,2011-07-01,3,0,7,7,25,218,243,127.0
4258,2011-07-01,3,0,7,8,39,453,492,281.0
4259,2011-07-01,3,0,7,9,58,202,260,331.6666666666667
4260,2011-07-01,3,0,7,10,61,109,170,307.3333333333333
4261,2011-07-01,3,0,7,11,68,146,214,214.66666666666666
4262,2011-07-01,3,0,7,12,83,180,263,215.66666666666666
4263,2011-07-01,3,0,7,13,83,209,292,256.3333333333333
4264,2011-07-01,3,0,7,14,78,225,303,286.0
4265,2011-07-01,3,0,7,15,82,299,381,325.3333333333333
4266,2011-07-01,3,0,7,16,85,342,427,370.3333333333333
4267,2011-07-01,3,0,7,17,99,362,461,423.0
4268,2011-07-01,3,0,7,18,98,324,422,436.6666666666667
4269,2011-07-01,3,0,7,19,80,238,318,400.3333333333333
4270,2011-07-01,3,0,7,20,84,185,269,336.3333333333333
4271,2011-07-01,3,0,7,21,69,149,218,268.3333333333333
4272,2011-07-01,3,0,7,22,49,173,222,236.33333333333334
4273,2011-07-01,3,0,7,23,44,96,140,193.33333333333334
4274,2011-07-02,3,0,7,0,31,84,115,159.0
4275,2011-07-02,3,0,7,1,20,58,78,111.0
4276,2011-07-02,3,0,7,2,9,43,52,81.66666666666667
4277,2011-07-02,3,0,7,3,5,21,26,52.0
4278,2011-07-02,3,0,7,4,3,8,11,29.666666666666668
4279,2011-07-02,3,0,7,5,1,13,14,17.0
4280,2011-07-02,3,0,7,6,11,21,32,19.0
4281,2011-07-02,3,0,7,7,10,35,45,30.333333333333332
4282,2011-07-02,3,0,7,8,38,94,132,69.66666666666667
4283,2011-07-02,3,0,7,9,55,124,179,118.66666666666667
4284,2011-07-02,3,0,7,10,103,168,271,194.0
4285,2011-07-02,3,0,7,11,144,213,357,269.0
4286,2011-07-02,3,0,7,12,142,232,374,334.0
4287,2011-07-02,3,0,7,13,178,226,404,378.3333333333333
4288,2011-07-02,3,0,7,14,177,215,392,390.0
4289,2011-07-02,3,0,7,15,168,163,331,375.6666666666667
4290,2011-07-02,3,0,7,16,206,192,398,373.6666666666667
4291,2011-07-02,3,0,7,17,179,170,349,359.3333333333333
4292,2011-07-02,3,0,7,18,193,190,383,376.6666666666667
4293,2011-07-02,3,0,7,19,156,149,305,345.6666666666667
4294,2011-07-02,3,0,7,20,136,148,284,324.0
4295,2011-07-02,3,0,7,21,95,137,232,273.6666666666667
4296,2011-07-02,3,0,7,22,78,123,201,239.0
4297,2011-07-02,3,0,7,23,66,88,154,195.66666666666666
4298,2011-07-03,3,0,7,0,47,97,144,166.33333333333334
4299,2011-07-03,3,0,7,1,23,55,78,125.33333333333333
4300,2011-07-03,3,0,7,2,19,50,69,97.0
4301,2011-07-03,3,0,7,3,8,25,33,60.0
4302,2011-07-03,3,0,7,4,3,2,5,35.666666666666664
4303,2011-07-03,3,0,7,5,0,1,1,13.0
4304,2011-07-03,3,0,7,6,0,3,3,3.0
4305,2011-07-03,3,0,7,7,3,22,25,9.666666666666666
4306,2011-07-03,3,0,7,8,39,53,92,40.0
4307,2011-07-03,3,0,7,9,82,99,181,99.33333333333333
4308,2011-07-03,3,0,7,10,131,133,264,179.0
4309,2011-07-03,3,0,7,11,215,175,390,278.3333333333333
4310,2011-07-03,3,0,7,12,198,206,404,352.6666666666667
4311,2011-07-03,3,0,7,13,248,173,421,405.0
4312,2011-07-03,3,0,7,14,225,150,375,400.0
4313,2011-07-03,3,0,7,15,194,182,376,390.6666666666667
4314,2011-07-03,3,0,7,16,195,219,414,388.3333333333333
4315,2011-07-03,3,0,7,17,181,177,358,382.6666666666667
4316,2011-07-03,3,0,7,18,74,107,181,317.6666666666667
4317,2011-07-03,3,0,7,19,100,83,183,240.66666666666666
4318,2011-07-03,3,0,7,20,83,93,176,180.0
4319,2011-07-03,3,0,7,21,75,92,167,175.33333333333334
4320,2011-07-03,3,0,7,22,69,93,162,168.33333333333334
4321,2011-07-03,3,0,7,23,70,77,147,158.66666666666666
4322,2011-07-04,3,0,7,0,63,77,140,149.66666666666666
4323,2011-07-04,3,0,7,1,43,76,119,135.33333333333334
4324,2011-07-04,3,0,7,2,33,30,63,107.33333333333333
4325,2011-07-04,3,0,7,3,13,13,26,69.33333333333333
4326,2011-07-04,3,0,7,4,8,4,12,33.666666666666664
4327,2011-07-04,3,0,7,5,1,3,4,14.0
4328,2011-07-04,3,0,7,6,5,11,16,10.666666666666666
4329,2011-07-04,3,0,7,7,17,19,36,18.666666666666668
4330,2011-07-04,3,0,7,8,42,44,86,46.0
4331,2011-07-04,3,0,7,9,142,96,238,120.0
4332,2011-07-04,3,0,7,10,166,114,280,201.33333333333334
4333,2011-07-04,3,0,7,11,177,172,349,289.0
4334,2011-07-04,3,0,7,12,237,210,447,358.6666666666667
4335,2011-07-04,3,0,7,13,242,181,423,406.3333333333333
4336,2011-07-04,3,0,7,14,235,173,408,426.0
4337,2011-07-04,3,0,7,15,224,184,408,413.0
4338,2011-07-04,3,0,7,16,236,216,452,422.6666666666667
4339,2011-07-04,3,0,7,17,240,196,436,432.0
4340,2011-07-04,3,0,7,18,222,196,418,435.3333333333333
4341,2011-07-04,3,0,7,19,170,205,375,409.6666666666667
4342,2011-07-04,3,0,7,20,195,191,386,393.0
4343,2011-07-04,3,0,7,21,195,262,457,406.0
4344,2011-07-04,3,0,7,22,115,211,326,389.6666666666667
4345,2011-07-04,3,0,7,23,44,94,138,307.0
4346,2011-07-05,3,0,7,0,19,36,55,173.0
4347,2011-07-05,3,0,7,1,15,24,39,77.33333333333333
4348,2011-07-05,3,0,7,2,8,5,13,35.666666666666664
4349,2011-07-05,3,0,7,3,1,7,8,20.0
4350,2011-07-05,3,0,7,4,1,4,5,8.666666666666666
4351,2011-07-05,3,0,7,5,1,19,20,11.0
4352,2011-07-05,3,0,7,6,3,91,94,39.666666666666664
4353,2011-07-05,3,0,7,7,22,248,270,128.0
4354,2011-07-05,3,0,7,8,41,391,432,265.3333333333333
4355,2011-07-05,3,0,7,9,50,177,227,309.6666666666667
4356,2011-07-05,3,0,7,10,55,84,139,266.0
4357,2011-07-05,3,0,7,11,75,97,172,179.33333333333334
4358,2011-07-05,3,0,7,12,71,130,201,170.66666666666666
4359,2011-07-05,3,0,7,13,67,136,203,192.0
4360,2011-07-05,3,0,7,14,66,112,178,194.0
4361,2011-07-05,3,0,7,15,51,111,162,181.0
4362,2011-07-05,3,0,7,16,79,202,281,207.0
4363,2011-07-05,3,0,7,17,79,466,545,329.3333333333333
4364,2011-07-05,3,0,7,18,70,426,496,440.6666666666667
4365,2011-07-05,3,0,7,19,71,297,368,469.6666666666667
4366,2011-07-05,3,0,7,20,59,225,284,382.6666666666667
4367,2011-07-05,3,0,7,21,77,168,245,299.0
4368,2011-07-05,3,0,7,22,31,124,155,228.0
4369,2011-07-05,3,0,7,23,19,54,73,157.66666666666666
4370,2011-07-06,3,0,7,0,11,26,37,88.33333333333333
4371,2011-07-06,3,0,7,1,4,11,15,41.666666666666664
4372,2011-07-06,3,0,7,2,1,4,5,19.0
4373,2011-07-06,3,0,7,3,0,6,6,8.666666666666666
4374,2011-07-06,3,0,7,4,0,6,6,5.666666666666667
4375,2011-07-06,3,0,7,5,5,30,35,15.666666666666666
4376,2011-07-06,3,0,7,6,9,112,121,54.0
4377,2011-07-06,3,0,7,7,24,288,312,156.0
4378,2011-07-06,3,0,7,8,31,397,428,287.0
4379,2011-07-06,3,0,7,9,31,158,189,309.6666666666667
4380,2011-07-06,3,0,7,10,13,30,43,220.0
4381,2011-07-06,3,0,7,11,24,103,127,119.66666666666667
4382,2011-07-06,3,0,7,12,38,114,152,107.33333333333333
4383,2011-07-06,3,0,7,13,33,107,140,139.66666666666666
4384,2011-07-06,3,0,7,14,50,113,163,151.66666666666666
4385,2011-07-06,3,0,7,15,55,130,185,162.66666666666666
4386,2011-07-06,3,0,7,16,57,218,275,207.66666666666666
4387,2011-07-06,3,0,7,17,79,517,596,352.0
4388,2011-07-06,3,0,7,18,77,486,563,478.0
4389,2011-07-06,3,0,7,19,71,323,394,517.6666666666666
4390,2011-07-06,3,0,7,20,55,257,312,423.0
4391,2011-07-06,3,0,7,21,66,175,241,315.6666666666667
4392,2011-07-06,3,0,7,22,30,156,186,246.33333333333334
4393,2011-07-06,3,0,7,23,20,78,98,175.0
4394,2011-07-07,3,0,7,0,6,29,35,106.33333333333333
4395,2011-07-07,3,0,7,1,2,14,16,49.666666666666664
4396,2011-07-07,3,0,7,2,1,7,8,19.666666666666668
4397,2011-07-07,3,0,7,3,2,2,4,9.333333333333334
4398,2011-07-07,3,0,7,4,0,4,4,5.333333333333333
4399,2011-07-07,3,0,7,5,2,30,32,13.333333333333334
4400,2011-07-07,3,0,7,6,11,107,118,51.333333333333336
4401,2011-07-07,3,0,7,7,13,279,292,147.33333333333334
4402,2011-07-07,3,0,7,8,28,415,443,284.3333333333333
4403,2011-07-07,3,0,7,9,25,154,179,304.6666666666667
4404,2011-07-07,3,0,7,10,29,72,101,241.0
4405,2011-07-07,3,0,7,11,30,112,142,140.66666666666666
4406,2011-07-07,3,0,7,12,32,139,171,138.0
4407,2011-07-07,3,0,7,13,48,107,155,156.0
4408,2011-07-07,3,0,7,14,39,121,160,162.0
4409,2011-07-07,3,0,7,15,47,119,166,160.33333333333334
4410,2011-07-07,3,0,7,16,47,218,265,197.0
4411,2011-07-07,3,0,7,17,80,489,569,333.3333333333333
4412,2011-07-07,3,0,7,18,70,492,562,465.3333333333333
4413,2011-07-07,3,0,7,19,79,286,365,498.6666666666667
4414,2011-07-07,3,0,7,20,61,224,285,404.0
4415,2011-07-07,3,0,7,21,39,170,209,286.3333333333333
4416,2011-07-07,3,0,7,22,32,150,182,225.33333333333334
4417,2011-07-07,3,0,7,23,31,98,129,173.33333333333334
4418,2011-07-08,3,0,7,0,6,41,47,119.33333333333333
4419,2011-07-08,3,0,7,1,9,25,34,70.0
4420,2011-07-08,3,0,7,2,10,12,22,34.333333333333336
4421,2011-07-08,3,0,7,3,2,4,6,20.666666666666668
4422,2011-07-08,3,0,7,4,7,4,11,13.0
4423,2011-07-08,3,0,7,5,3,24,27,14.666666666666666
4424,2011-07-08,3,0,7,6,11,91,102,46.666666666666664
4425,2011-07-08,3,0,7,7,30,302,332,153.66666666666666
4426,2011-07-08,3,0,7,8,36,421,457,297.0
4427,2011-07-08,3,0,7,9,30,211,241,343.3333333333333
4428,2011-07-08,3,0,7,10,30,108,138,278.6666666666667
4429,2011-07-08,3,0,7,11,61,104,165,181.33333333333334
4430,2011-07-08,3,0,7,12,49,164,213,172.0
4431,2011-07-08,3,0,7,13,54,175,229,202.33333333333334
4432,2011-07-08,3,0,7,14,53,163,216,219.33333333333334
4433,2011-07-08,3,0,7,15,39,102,141,195.33333333333334
4434,2011-07-08,3,0,7,16,27,105,132,163.0
4435,2011-07-08,3,0,7,17,6,161,167,146.66666666666666
4436,2011-07-08,3,0,7,18,35,281,316,205.0
4437,2011-07-08,3,0,7,19,45,225,270,251.0
4438,2011-07-08,3,0,7,20,30,220,250,278.6666666666667
4439,2011-07-08,3,0,7,21,46,158,204,241.33333333333334
4440,2011-07-08,3,0,7,22,33,136,169,207.66666666666666
4441,2011-07-08,3,0,7,23,40,111,151,174.66666666666666
4442,2011-07-09,3,0,7,0,31,90,121,147.0
4443,2011-07-09,3,0,7,1,5,48,53,108.33333333333333
4444,2011-07-09,3,0,7,2,12,43,55,76.33333333333333
4445,2011-07-09,3,0,7,3,7,23,30,46.0
4446,2011-07-09,3,0,7,4,2,4,6,30.333333333333332
4447,2011-07-09,3,0,7,5,4,11,15,17.0
4448,2011-07-09,3,0,7,6,11,27,38,19.666666666666668
4449,2011-07-09,3,0,7,7,21,50,71,41.333333333333336
4450,2011-07-09,3,0,7,8,68,114,182,97.0
4451,2011-07-09,3,0,7,9,77,170,247,166.66666666666666
4452,2011-07-09,3,0,7,10,87,177,264,231.0
4453,2011-07-09,3,0,7,11,101,189,290,267.0
4454,2011-07-09,3,0,7,12,145,221,366,306.6666666666667
4455,2011-07-09,3,0,7,13,167,249,416,357.3333333333333
4456,2011-07-09,3,0,7,14,158,215,373,385.0
4457,2011-07-09,3,0,7,15,182,220,402,397.0
4458,2011-07-09,3,0,7,16,171,245,416,397.0
4459,2011-07-09,3,0,7,17,160,241,401,406.3333333333333
4460,2011-07-09,3,0,7,18,132,246,378,398.3333333333333
4461,2011-07-09,3,0,7,19,128,178,306,361.6666666666667
4462,2011-07-09,3,0,7,20,129,185,314,332.6666666666667
4463,2011-07-09,3,0,7,21,83,155,238,286.0
4464,2011-07-09,3,0,7,22,60,154,214,255.33333333333334
4465,2011-07-09,3,0,7,23,47,93,140,197.33333333333334
4466,2011-07-10,3,0,7,0,42,112,154,169.33333333333334
4467,2011-07-10,3,0,7,1,19,94,113,135.66666666666666
4468,2011-07-10,3,0,7,2,28,68,96,121.0
4469,2011-07-10,3,0,7,3,6,19,25,78.0
4470,2011-07-10,3,0,7,4,0,5,5,42.0
4471,2011-07-10,3,0,7,5,7,10,17,15.666666666666666
4472,2011-07-10,3,0,7,6,8,17,25,15.666666666666666
4473,2011-07-10,3,0,7,7,27,38,65,35.666666666666664
4474,2011-07-10,3,0,7,8,27,65,92,60.666666666666664
4475,2011-07-10,3,0,7,9,62,107,169,108.66666666666667
4476,2011-07-10,3,0,7,10,95,173,268,176.33333333333334
4477,2011-07-10,3,0,7,11,110,177,287,241.33333333333334
4478,2011-07-10,3,0,7,12,133,244,377,310.6666666666667
4479,2011-07-10,3,0,7,13,139,228,367,343.6666666666667
4480,2011-07-10,3,0,7,14,122,227,349,364.3333333333333
4481,2011-07-10,3,0,7,15,142,219,361,359.0
4482,2011-07-10,3,0,7,16,128,244,372,360.6666666666667
4483,2011-07-10,3,0,7,17,146,217,363,365.3333333333333
4484,2011-07-10,3,0,7,18,141,222,363,366.0
4485,2011-07-10,3,0,7,19,120,183,303,343.0
4486,2011-07-10,3,0,7,20,101,167,268,311.3333333333333
4487,2011-07-10,3,0,7,21,65,162,227,266.0
4488,2011-07-10,3,0,7,22,56,87,143,212.66666666666666
4489,2011-07-10,3,0,7,23,19,53,72,147.33333333333334
4490,2011-07-11,3,0,7,0,10,25,35,83.33333333333333
4491,2011-07-11,3,0,7,1,5,5,10,39.0
4492,2011-07-11,3,0,7,2,8,4,12,19.0
4493,2011-07-11,3,0,7,3,2,8,10,10.666666666666666
4494,2011-07-11,3,0,7,4,0,4,4,8.666666666666666
4495,2011-07-11,3,0,7,5,5,21,26,13.333333333333334
4496,2011-07-11,3,0,7,6,19,102,121,50.333333333333336
4497,2011-07-11,3,0,7,7,28,289,317,154.66666666666666
4498,2011-07-11,3,0,7,8,35,385,420,286.0
4499,2011-07-11,3,0,7,9,41,167,208,315.0
4500,2011-07-11,3,0,7,10,44,73,117,248.33333333333334
4501,2011-07-11,3,0,7,11,39,89,128,151.0
4502,2011-07-11,3,0,7,12,40,108,148,131.0
4503,2011-07-11,3,0,7,13,22,119,141,139.0
4504,2011-07-11,3,0,7,14,40,94,134,141.0
4505,2011-07-11,3,0,7,15,38,108,146,140.33333333333334
4506,2011-07-11,3,0,7,16,57,182,239,173.0
4507,2011-07-11,3,0,7,17,59,455,514,299.6666666666667
4508,2011-07-11,3,0,7,18,57,415,472,408.3333333333333
4509,2011-07-11,3,0,7,19,80,293,373,453.0
4510,2011-07-11,3,0,7,20,42,194,236,360.3333333333333
4511,2011-07-11,3,0,7,21,21,109,130,246.33333333333334
4512,2011-07-11,3,0,7,22,20,70,90,152.0
4513,2011-07-11,3,0,7,23,11,44,55,91.66666666666667
4514,2011-07-12,3,0,7,0,3,19,22,55.666666666666664
4515,2011-07-12,3,0,7,1,6,8,14,30.333333333333332
4516,2011-07-12,3,0,7,2,2,7,9,15.0
4517,2011-07-12,3,0,7,3,2,6,8,10.333333333333334
4518,2011-07-12,3,0,7,4,0,6,6,7.666666666666667
4519,2011-07-12,3,0,7,5,4,21,25,13.0
4520,2011-07-12,3,0,7,6,13,102,115,48.666666666666664
4521,2011-07-12,3,0,7,7,29,301,330,156.66666666666666
4522,2011-07-12,3,0,7,8,35,382,417,287.3333333333333
4523,2011-07-12,3,0,7,9,27,149,176,307.6666666666667
4524,2011-07-12,3,0,7,10,38,85,123,238.66666666666666
4525,2011-07-12,3,0,7,11,39,86,125,141.33333333333334
4526,2011-07-12,3,0,7,12,38,125,163,137.0
4527,2011-07-12,3,0,7,13,32,104,136,141.33333333333334
4528,2011-07-12,3,0,7,14,33,91,124,141.0
4529,2011-07-12,3,0,7,15,37,111,148,136.0
4530,2011-07-12,3,0,7,16,25,177,202,158.0
4531,2011-07-12,3,0,7,17,48,380,428,259.3333333333333
4532,2011-07-12,3,0,7,18,39,472,511,380.3333333333333
4533,2011-07-12,3,0,7,19,42,295,337,425.3333333333333
4534,2011-07-12,3,0,7,20,57,251,308,385.3333333333333
4535,2011-07-12,3,0,7,21,49,209,258,301.0
4536,2011-07-12,3,0,7,22,44,150,194,253.33333333333334
4537,2011-07-12,3,0,7,23,20,59,79,177.0
4538,2011-07-13,3,0,7,0,9,37,46,106.33333333333333
4539,2011-07-13,3,0,7,1,1,11,12,45.666666666666664
4540,2011-07-13,3,0,7,2,2,3,5,21.0
4541,2011-07-13,3,0,7,3,0,4,4,7.0
4542,2011-07-13,3,0,7,4,0,5,5,4.666666666666667
4543,2011-07-13,3,0,7,5,4,22,26,11.666666666666666
4544,2011-07-13,3,0,7,6,18,103,121,50.666666666666664
4545,2011-07-13,3,0,7,7,32,281,313,153.33333333333334
4546,2011-07-13,3,0,7,8,31,418,449,294.3333333333333
4547,2011-07-13,3,0,7,9,23,163,186,316.0
4548,2011-07-13,3,0,7,10,33,80,113,249.33333333333334
4549,2011-07-13,3,0,7,11,55,110,165,154.66666666666666
4550,2011-07-13,3,0,7,12,40,134,174,150.66666666666666
4551,2011-07-13,3,0,7,13,39,119,158,165.66666666666666
4552,2011-07-13,3,0,7,14,27,89,116,149.33333333333334
4553,2011-07-13,3,0,7,15,13,33,46,106.66666666666667
4554,2011-07-13,3,0,7,16,23,118,141,101.0
4555,2011-07-13,3,0,7,17,70,418,488,225.0
4556,2011-07-13,3,0,7,18,51,412,463,364.0
4557,2011-07-13,3,0,7,19,79,340,419,456.6666666666667
4558,2011-07-13,3,0,7,20,61,281,342,408.0
4559,2011-07-13,3,0,7,21,56,194,250,337.0
4560,2011-07-13,3,0,7,22,48,136,184,258.6666666666667
4561,2011-07-13,3,0,7,23,33,83,116,183.33333333333334
4562,2011-07-14,3,0,7,0,14,32,46,115.33333333333333
4563,2011-07-14,3,0,7,1,4,21,25,62.333333333333336
4564,2011-07-14,3,0,7,2,3,7,10,27.0
4565,2011-07-14,3,0,7,3,1,5,6,13.666666666666666
4566,2011-07-14,3,0,7,4,0,6,6,7.333333333333333
4567,2011-07-14,3,0,7,5,6,22,28,13.333333333333334
4568,2011-07-14,3,0,7,6,14,116,130,54.666666666666664
4569,2011-07-14,3,0,7,7,23,311,334,164.0
4570,2011-07-14,3,0,7,8,53,433,486,316.6666666666667
4571,2011-07-14,3,0,7,9,29,195,224,348.0
4572,2011-07-14,3,0,7,10,32,95,127,279.0
4573,2011-07-14,3,0,7,11,38,110,148,166.33333333333334
4574,2011-07-14,3,0,7,12,51,172,223,166.0
4575,2011-07-14,3,0,7,13,39,138,177,182.66666666666666
4576,2011-07-14,3,0,7,14,49,129,178,192.66666666666666
4577,2011-07-14,3,0,7,15,42,138,180,178.33333333333334
4578,2011-07-14,3,0,7,16,43,231,274,210.66666666666666
4579,2011-07-14,3,0,7,17,78,517,595,349.6666666666667
4580,2011-07-14,3,0,7,18,94,484,578,482.3333333333333
4581,2011-07-14,3,0,7,19,67,333,400,524.3333333333334
4582,2011-07-14,3,0,7,20,81,267,348,442.0
4583,2011-07-14,3,0,7,21,58,203,261,336.3333333333333
4584,2011-07-14,3,0,7,22,42,134,176,261.6666666666667
4585,2011-07-14,3,0,7,23,27,97,124,187.0
4586,2011-07-15,3,0,7,0,23,57,80,126.66666666666667
4587,2011-07-15,3,0,7,1,7,13,20,74.66666666666667
4588,2011-07-15,3,0,7,2,16,22,38,46.0
4589,2011-07-15,3,0,7,3,1,6,7,21.666666666666668
4590,2011-07-15,3,0,7,4,2,8,10,18.333333333333332
4591,2011-07-15,3,0,7,5,7,16,23,13.333333333333334
4592,2011-07-15,3,0,7,6,12,108,120,51.0
4593,2011-07-15,3,0,7,7,17,257,274,139.0
4594,2011-07-15,3,0,7,8,50,514,564,319.3333333333333
4595,2011-07-15,3,0,7,9,31,176,207,348.3333333333333
4596,2011-07-15,3,0,7,10,59,107,166,312.3333333333333
4597,2011-07-15,3,0,7,11,73,137,210,194.33333333333334
4598,2011-07-15,3,0,7,12,61,177,238,204.66666666666666
4599,2011-07-15,3,0,7,13,85,162,247,231.66666666666666
4600,2011-07-15,3,0,7,14,105,160,265,250.0
4601,2011-07-15,3,0,7,15,74,163,237,249.66666666666666
4602,2011-07-15,3,0,7,16,96,265,361,287.6666666666667
4603,2011-07-15,3,0,7,17,104,483,587,395.0
4604,2011-07-15,3,0,7,18,102,394,496,481.3333333333333
4605,2011-07-15,3,0,7,19,114,280,394,492.3333333333333
4606,2011-07-15,3,0,7,20,92,251,343,411.0
4607,2011-07-15,3,0,7,21,75,186,261,332.6666666666667
4608,2011-07-15,3,0,7,22,71,152,223,275.6666666666667
4609,2011-07-15,3,0,7,23,41,126,167,217.0
4610,2011-07-16,3,0,7,0,42,68,110,166.66666666666666
4611,2011-07-16,3,0,7,1,24,51,75,117.33333333333333
4612,2011-07-16,3,0,7,2,10,48,58,81.0
4613,2011-07-16,3,0,7,3,6,20,26,53.0
4614,2011-07-16,3,0,7,4,9,7,16,33.333333333333336
4615,2011-07-16,3,0,7,5,4,6,10,17.333333333333332
4616,2011-07-16,3,0,7,6,16,21,37,21.0
4617,2011-07-16,3,0,7,7,14,38,52,33.0
4618,2011-07-16,3,0,7,8,37,90,127,72.0
4619,2011-07-16,3,0,7,9,72,150,222,133.66666666666666
4620,2011-07-16,3,0,7,10,114,208,322,223.66666666666666
4621,2011-07-16,3,0,7,11,171,225,396,313.3333333333333
4622,2011-07-16,3,0,7,12,187,276,463,393.6666666666667
4623,2011-07-16,3,0,7,13,221,276,497,452.0
4624,2011-07-16,3,0,7,14,201,232,433,464.3333333333333
4625,2011-07-16,3,0,7,15,205,223,428,452.6666666666667
4626,2011-07-16,3,0,7,16,183,242,425,428.6666666666667
4627,2011-07-16,3,0,7,17,234,241,475,442.6666666666667
4628,2011-07-16,3,0,7,18,185,243,428,442.6666666666667
4629,2011-07-16,3,0,7,19,164,242,406,436.3333333333333
4630,2011-07-16,3,0,7,20,108,188,296,376.6666666666667
4631,2011-07-16,3,0,7,21,85,167,252,318.0
4632,2011-07-16,3,0,7,22,65,136,201,249.66666666666666
4633,2011-07-16,3,0,7,23,61,107,168,207.0
4634,2011-07-17,3,0,7,0,34,91,125,164.66666666666666
4635,2011-07-17,3,0,7,1,16,86,102,131.66666666666666
4636,2011-07-17,3,0,7,2,28,66,94,107.0
4637,2011-07-17,3,0,7,3,21,26,47,81.0
4638,2011-07-17,3,0,7,4,4,6,10,50.333333333333336
4639,2011-07-17,3,0,7,5,4,8,12,23.0
4640,2011-07-17,3,0,7,6,10,11,21,14.333333333333334
4641,2011-07-17,3,0,7,7,20,30,50,27.666666666666668
4642,2011-07-17,3,0,7,8,45,73,118,63.0
4643,2011-07-17,3,0,7,9,74,110,184,117.33333333333333
4644,2011-07-17,3,0,7,10,127,177,304,202.0
4645,2011-07-17,3,0,7,11,147,244,391,293.0
4646,2011-07-17,3,0,7,12,177,243,420,371.6666666666667
4647,2011-07-17,3,0,7,13,200,272,472,427.6666666666667
4648,2011-07-17,3,0,7,14,168,262,430,440.6666666666667
4649,2011-07-17,3,0,7,15,129,195,324,408.6666666666667
4650,2011-07-17,3,0,7,16,129,188,317,357.0
4651,2011-07-17,3,0,7,17,133,236,369,336.6666666666667
4652,2011-07-17,3,0,7,18,147,243,390,358.6666666666667
4653,2011-07-17,3,0,7,19,145,234,379,379.3333333333333
4654,2011-07-17,3,0,7,20,85,177,262,343.6666666666667
4655,2011-07-17,3,0,7,21,59,148,207,282.6666666666667
4656,2011-07-17,3,0,7,22,65,116,181,216.66666666666666
4657,2011-07-17,3,0,7,23,39,54,93,160.33333333333334
4658,2011-07-18,3,0,7,0,21,30,51,108.33333333333333
4659,2011-07-18,3,0,7,1,17,8,25,56.333333333333336
4660,2011-07-18,3,0,7,2,2,8,10,28.666666666666668
4661,2011-07-18,3,0,7,3,3,4,7,14.0
4662,2011-07-18,3,0,7,4,1,3,4,7.0
4663,2011-07-18,3,0,7,5,2,15,17,9.333333333333334
4664,2011-07-18,3,0,7,6,10,95,105,42.0
4665,2011-07-18,3,0,7,7,22,255,277,133.0
4666,2011-07-18,3,0,7,8,18,329,347,243.0
4667,2011-07-18,3,0,7,9,33,170,203,275.6666666666667
4668,2011-07-18,3,0,7,10,52,78,130,226.66666666666666
4669,2011-07-18,3,0,7,11,42,99,141,158.0
4670,2011-07-18,3,0,7,12,39,126,165,145.33333333333334
4671,2011-07-18,3,0,7,13,27,125,152,152.66666666666666
4672,2011-07-18,3,0,7,14,32,106,138,151.66666666666666
4673,2011-07-18,3,0,7,15,53,111,164,151.33333333333334
4674,2011-07-18,3,0,7,16,45,220,265,189.0
4675,2011-07-18,3,0,7,17,72,473,545,324.6666666666667
4676,2011-07-18,3,0,7,18,80,478,558,456.0
4677,2011-07-18,3,0,7,19,63,335,398,500.3333333333333
4678,2011-07-18,3,0,7,20,91,232,323,426.3333333333333
4679,2011-07-18,3,0,7,21,48,154,202,307.6666666666667
4680,2011-07-18,3,0,7,22,36,104,140,221.66666666666666
4681,2011-07-18,3,0,7,23,32,59,91,144.33333333333334
4682,2011-07-19,3,0,7,0,25,26,51,94.0
4683,2011-07-19,3,0,7,1,7,6,13,51.666666666666664
4684,2011-07-19,3,0,7,2,9,4,13,25.666666666666668
4685,2011-07-19,3,0,7,3,2,1,3,9.666666666666666
4686,2011-07-19,3,0,7,4,1,4,5,7.0
4687,2011-07-19,3,0,7,5,0,19,19,9.0
4688,2011-07-19,3,0,7,6,8,126,134,52.666666666666664
4689,2011-07-19,3,0,7,7,28,287,315,156.0
4690,2011-07-19,3,0,7,8,31,381,412,287.0
4691,2011-07-19,3,0,7,9,22,177,199,308.6666666666667
4692,2011-07-19,3,0,7,10,29,112,141,250.66666666666666
4693,2011-07-19,3,0,7,11,29,98,127,155.66666666666666
4694,2011-07-19,3,0,7,12,26,127,153,140.33333333333334
4695,2011-07-19,3,0,7,13,33,139,172,150.66666666666666
4696,2011-07-19,3,0,7,14,41,111,152,159.0
4697,2011-07-19,3,0,7,15,48,110,158,160.66666666666666
4698,2011-07-19,3,0,7,16,61,216,277,195.66666666666666
4699,2011-07-19,3,0,7,17,68,445,513,316.0
4700,2011-07-19,3,0,7,18,80,450,530,440.0
4701,2011-07-19,3,0,7,19,54,334,388,477.0
4702,2011-07-19,3,0,7,20,48,229,277,398.3333333333333
4703,2011-07-19,3,0,7,21,47,194,241,302.0
4704,2011-07-19,3,0,7,22,36,120,156,224.66666666666666
4705,2011-07-19,3,0,7,23,19,73,92,163.0
4706,2011-07-20,3,0,7,0,11,29,40,96.0
4707,2011-07-20,3,0,7,1,4,7,11,47.666666666666664
4708,2011-07-20,3,0,7,2,2,7,9,20.0
4709,2011-07-20,3,0,7,3,2,4,6,8.666666666666666
4710,2011-07-20,3,0,7,4,0,4,4,6.333333333333333
4711,2011-07-20,3,0,7,5,4,19,23,11.0
4712,2011-07-20,3,0,7,6,5,111,116,47.666666666666664
4713,2011-07-20,3,0,7,7,27,276,303,147.33333333333334
4714,2011-07-20,3,0,7,8,34,404,438,285.6666666666667
4715,2011-07-20,3,0,7,9,28,181,209,316.6666666666667
4716,2011-07-20,3,0,7,10,34,76,110,252.33333333333334
4717,2011-07-20,3,0,7,11,26,116,142,153.66666666666666
4718,2011-07-20,3,0,7,12,28,121,149,133.66666666666666
4719,2011-07-20,3,0,7,13,23,97,120,137.0
4720,2011-07-20,3,0,7,14,44,83,127,132.0
4721,2011-07-20,3,0,7,15,36,102,138,128.33333333333334
4722,2011-07-20,3,0,7,16,30,204,234,166.33333333333334
4723,2011-07-20,3,0,7,17,50,405,455,275.6666666666667
4724,2011-07-20,3,0,7,18,68,429,497,395.3333333333333
4725,2011-07-20,3,0,7,19,59,323,382,444.6666666666667
4726,2011-07-20,3,0,7,20,45,264,309,396.0
4727,2011-07-20,3,0,7,21,33,209,242,311.0
4728,2011-07-20,3,0,7,22,25,144,169,240.0
4729,2011-07-20,3,0,7,23,26,73,99,170.0
4730,2011-07-21,3,0,7,0,13,29,42,103.33333333333333
4731,2011-07-21,3,0,7,1,5,16,21,54.0
4732,2011-07-21,3,0,7,2,2,4,6,23.0
4733,2011-07-21,3,0,7,3,1,5,6,11.0
4734,2011-07-21,3,0,7,4,0,4,4,5.333333333333333
4735,2011-07-21,3,0,7,5,2,16,18,9.333333333333334
4736,2011-07-21,3,0,7,6,6,111,117,46.333333333333336
4737,2011-07-21,3,0,7,7,23,251,274,136.33333333333334
4738,2011-07-21,3,0,7,8,23,358,381,257.3333333333333
4739,2011-07-21,3,0,7,9,34,166,200,285.0
4740,2011-07-21,3,0,7,10,31,47,78,219.66666666666666
4741,2011-07-21,3,0,7,11,27,79,106,128.0
4742,2011-07-21,3,0,7,12,29,106,135,106.33333333333333
4743,2011-07-21,3,0,7,13,21,81,102,114.33333333333333
4744,2011-07-21,3,0,7,14,50,97,147,128.0
4745,2011-07-21,3,0,7,15,40,93,133,127.33333333333333
4746,2011-07-21,3,0,7,16,43,167,210,163.33333333333334
4747,2011-07-21,3,0,7,17,40,374,414,252.33333333333334
4748,2011-07-21,3,0,7,18,39,343,382,335.3333333333333
4749,2011-07-21,3,0,7,19,51,233,284,360.0
4750,2011-07-21,3,0,7,20,38,199,237,301.0
4751,2011-07-21,3,0,7,21,38,187,225,248.66666666666666
4752,2011-07-21,3,0,7,22,36,113,149,203.66666666666666
4753,2011-07-21,3,0,7,23,40,73,113,162.33333333333334
4754,2011-07-22,3,0,7,0,9,51,60,107.33333333333333
4755,2011-07-22,3,0,7,1,7,17,24,65.66666666666667
4756,2011-07-22,3,0,7,2,0,14,14,32.666666666666664
4757,2011-07-22,3,0,7,3,1,6,7,15.0
4758,2011-07-22,3,0,7,4,8,5,13,11.333333333333334
4759,2011-07-22,3,0,7,5,2,17,19,13.0
4760,2011-07-22,3,0,7,6,13,83,96,42.666666666666664
4761,2011-07-22,3,0,7,7,20,232,252,122.33333333333333
4762,2011-07-22,3,0,7,8,30,292,322,223.33333333333334
4763,2011-07-22,3,0,7,9,31,177,208,260.6666666666667
4764,2011-07-22,3,0,7,10,32,83,115,215.0
4765,2011-07-22,3,0,7,11,23,86,109,144.0
4766,2011-07-22,3,0,7,12,20,95,115,113.0
4767,2011-07-22,3,0,7,13,25,98,123,115.66666666666667
4768,2011-07-22,3,0,7,14,24,77,101,113.0
4769,2011-07-22,3,0,7,15,32,101,133,119.0
4770,2011-07-22,3,0,7,16,29,153,182,138.66666666666666
4771,2011-07-22,3,0,7,17,35,271,306,207.0
4772,2011-07-22,3,0,7,18,34,250,284,257.3333333333333
4773,2011-07-22,3,0,7,19,40,210,250,280.0
4774,2011-07-22,3,0,7,20,46,166,212,248.66666666666666
4775,2011-07-22,3,0,7,21,38,152,190,217.33333333333334
4776,2011-07-22,3,0,7,22,44,105,149,183.66666666666666
4777,2011-07-22,3,0,7,23,19,84,103,147.33333333333334
4778,2011-07-23,3,0,7,0,16,85,101,117.66666666666667
4779,2011-07-23,3,0,7,1,13,57,70,91.33333333333333
4780,2011-07-23,3,0,7,2,13,48,61,77.33333333333333
4781,2011-07-23,3,0,7,3,6,16,22,51.0
4782,2011-07-23,3,0,7,4,5,4,9,30.666666666666668
4783,2011-07-23,3,0,7,5,1,6,7,12.666666666666666
4784,2011-07-23,3,0,7,6,6,19,25,13.666666666666666
4785,2011-07-23,3,0,7,7,7,38,45,25.666666666666668
4786,2011-07-23,3,0,7,8,24,85,109,59.666666666666664
4787,2011-07-23,3,0,7,9,30,102,132,95.33333333333333
4788,2011-07-23,3,0,7,10,61,137,198,146.33333333333334
4789,2011-07-23,3,0,7,11,62,154,216,182.0
4790,2011-07-23,3,0,7,12,71,164,235,216.33333333333334
4791,2011-07-23,3,0,7,13,78,167,245,232.0
4792,2011-07-23,3,0,7,14,84,152,236,238.66666666666666
4793,2011-07-23,3,0,7,15,78,137,215,232.0
4794,2011-07-23,3,0,7,16,70,151,221,224.0
4795,2011-07-23,3,0,7,17,70,127,197,211.0
4796,2011-07-23,3,0,7,18,62,134,196,204.66666666666666
4797,2011-07-23,3,0,7,19,80,137,217,203.33333333333334
4798,2011-07-23,3,0,7,20,47,98,145,186.0
4799,2011-07-23,3,0,7,21,39,115,154,172.0
4800,2011-07-23,3,0,7,22,37,88,125,141.33333333333334
4801,2011-07-23,3,0,7,23,27,77,104,127.66666666666667
4802,2011-07-24,3,0,7,0,42,77,119,116.0
4803,2011-07-24,3,0,7,1,33,63,96,106.33333333333333
4804,2011-07-24,3,0,7,2,12,48,60,91.66666666666667
4805,2011-07-24,3,0,7,3,17,20,37,64.33333333333333
4806,2011-07-24,3,0,7,4,1,5,6,34.333333333333336
4807,2011-07-24,3,0,7,5,5,3,8,17.0
4808,2011-07-24,3,0,7,6,9,13,22,12.0
4809,2011-07-24,3,0,7,7,6,29,35,21.666666666666668
4810,2011-07-24,3,0,7,8,22,82,104,53.666666666666664
4811,2011-07-24,3,0,7,9,42,112,154,97.66666666666667
4812,2011-07-24,3,0,7,10,61,165,226,161.33333333333334
4813,2011-07-24,3,0,7,11,74,169,243,207.66666666666666
4814,2011-07-24,3,0,7,12,85,161,246,238.33333333333334
4815,2011-07-24,3,0,7,13,90,162,252,247.0
4816,2011-07-24,3,0,7,14,79,204,283,260.3333333333333
4817,2011-07-24,3,0,7,15,68,170,238,257.6666666666667
4818,2011-07-24,3,0,7,16,62,187,249,256.6666666666667
4819,2011-07-24,3,0,7,17,75,174,249,245.33333333333334
4820,2011-07-24,3,0,7,18,67,176,243,247.0
4821,2011-07-24,3,0,7,19,70,170,240,244.0
4822,2011-07-24,3,0,7,20,52,143,195,226.0
4823,2011-07-24,3,0,7,21,42,111,153,196.0
4824,2011-07-24,3,0,7,22,23,75,98,148.66666666666666
4825,2011-07-24,3,0,7,23,13,37,50,100.33333333333333
4826,2011-07-25,3,0,7,0,17,17,34,60.666666666666664
4827,2011-07-25,3,0,7,1,4,8,12,32.0
4828,2011-07-25,3,0,7,2,3,3,6,17.333333333333332
4829,2011-07-25,3,0,7,3,2,2,4,7.333333333333333
4830,2011-07-25,3,0,7,4,0,6,6,5.333333333333333
4831,2011-07-25,3,0,7,5,2,22,24,11.333333333333334
4832,2011-07-25,3,0,7,6,7,100,107,45.666666666666664
4833,2011-07-25,3,0,7,7,20,257,277,136.0
4834,2011-07-25,3,0,7,8,34,353,387,257.0
4835,2011-07-25,3,0,7,9,11,124,135,266.3333333333333
4836,2011-07-25,3,0,7,10,30,54,84,202.0
4837,2011-07-25,3,0,7,11,24,83,107,108.66666666666667
4838,2011-07-25,3,0,7,12,17,50,67,86.0
4839,2011-07-25,3,0,7,13,14,64,78,84.0
4840,2011-07-25,3,0,7,14,28,62,90,78.33333333333333
4841,2011-07-25,3,0,7,15,16,96,112,93.33333333333333
4842,2011-07-25,3,0,7,16,37,161,198,133.33333333333334
4843,2011-07-25,3,0,7,17,48,437,485,265.0
4844,2011-07-25,3,0,7,18,60,473,533,405.3333333333333
4845,2011-07-25,3,0,7,19,62,324,386,468.0
4846,2011-07-25,3,0,7,20,55,247,302,407.0
4847,2011-07-25,3,0,7,21,41,153,194,294.0
4848,2011-07-25,3,0,7,22,13,112,125,207.0
4849,2011-07-25,3,0,7,23,23,64,87,135.33333333333334
4850,2011-07-26,3,0,7,0,8,20,28,80.0
4851,2011-07-26,3,0,7,1,6,6,12,42.333333333333336
4852,2011-07-26,3,0,7,2,1,6,7,15.666666666666666
4853,2011-07-26,3,0,7,3,2,2,4,7.666666666666667
4854,2011-07-26,3,0,7,4,0,6,6,5.666666666666667
4855,2011-07-26,3,0,7,5,3,24,27,12.333333333333334
4856,2011-07-26,3,0,7,6,2,108,110,47.666666666666664
4857,2011-07-26,3,0,7,7,30,288,318,151.66666666666666
4858,2011-07-26,3,0,7,8,32,392,424,284.0
4859,2011-07-26,3,0,7,9,25,162,187,309.6666666666667
4860,2011-07-26,3,0,7,10,42,96,138,249.66666666666666
4861,2011-07-26,3,0,7,11,49,102,151,158.66666666666666
4862,2011-07-26,3,0,7,12,25,122,147,145.33333333333334
4863,2011-07-26,3,0,7,13,43,139,182,160.0
4864,2011-07-26,3,0,7,14,46,101,147,158.66666666666666
4865,2011-07-26,3,0,7,15,49,114,163,164.0
4866,2011-07-26,3,0,7,16,41,213,254,188.0
4867,2011-07-26,3,0,7,17,72,465,537,318.0
4868,2011-07-26,3,0,7,18,68,478,546,445.6666666666667
4869,2011-07-26,3,0,7,19,69,329,398,493.6666666666667
4870,2011-07-26,3,0,7,20,47,243,290,411.3333333333333
4871,2011-07-26,3,0,7,21,45,222,267,318.3333333333333
4872,2011-07-26,3,0,7,22,27,131,158,238.33333333333334
4873,2011-07-26,3,0,7,23,18,71,89,171.33333333333334
4874,2011-07-27,3,0,7,0,19,26,45,97.33333333333333
4875,2011-07-27,3,0,7,1,1,9,10,48.0
4876,2011-07-27,3,0,7,2,1,5,6,20.333333333333332
4877,2011-07-27,3,0,7,3,0,4,4,6.666666666666667
4878,2011-07-27,3,0,7,4,1,3,4,4.666666666666667
4879,2011-07-27,3,0,7,5,0,18,18,8.666666666666666
4880,2011-07-27,3,0,7,6,4,119,123,48.333333333333336
4881,2011-07-27,3,0,7,7,34,313,347,162.66666666666666
4882,2011-07-27,3,0,7,8,28,405,433,301.0
4883,2011-07-27,3,0,7,9,27,189,216,332.0
4884,2011-07-27,3,0,7,10,32,82,114,254.33333333333334
4885,2011-07-27,3,0,7,11,42,94,136,155.33333333333334
4886,2011-07-27,3,0,7,12,37,132,169,139.66666666666666
4887,2011-07-27,3,0,7,13,29,151,180,161.66666666666666
4888,2011-07-27,3,0,7,14,20,107,127,158.66666666666666
4889,2011-07-27,3,0,7,15,37,103,140,149.0
4890,2011-07-27,3,0,7,16,40,228,268,178.33333333333334
4891,2011-07-27,3,0,7,17,81,491,572,326.6666666666667
4892,2011-07-27,3,0,7,18,78,463,541,460.3333333333333
4893,2011-07-27,3,0,7,19,87,288,375,496.0
4894,2011-07-27,3,0,7,20,55,239,294,403.3333333333333
4895,2011-07-27,3,0,7,21,49,196,245,304.6666666666667
4896,2011-07-27,3,0,7,22,37,143,180,239.66666666666666
4897,2011-07-27,3,0,7,23,16,93,109,178.0
4898,2011-07-28,3,0,7,0,14,31,45,111.33333333333333
4899,2011-07-28,3,0,7,1,3,26,29,61.0
4900,2011-07-28,3,0,7,2,2,5,7,27.0
4901,2011-07-28,3,0,7,3,0,5,5,13.666666666666666
4902,2011-07-28,3,0,7,4,0,6,6,6.0
4903,2011-07-28,3,0,7,5,1,26,27,12.666666666666666
4904,2011-07-28,3,0,7,6,6,110,116,49.666666666666664
4905,2011-07-28,3,0,7,7,27,278,305,149.33333333333334
4906,2011-07-28,3,0,7,8,47,409,456,292.3333333333333
4907,2011-07-28,3,0,7,9,21,189,210,323.6666666666667
4908,2011-07-28,3,0,7,10,30,86,116,260.6666666666667
4909,2011-07-28,3,0,7,11,41,113,154,160.0
4910,2011-07-28,3,0,7,12,35,151,186,152.0
4911,2011-07-28,3,0,7,13,26,126,152,164.0
4912,2011-07-28,3,0,7,14,27,111,138,158.66666666666666
4913,2011-07-28,3,0,7,15,22,124,146,145.33333333333334
4914,2011-07-28,3,0,7,16,42,214,256,180.0
4915,2011-07-28,3,0,7,17,45,423,468,290.0
4916,2011-07-28,3,0,7,18,55,428,483,402.3333333333333
4917,2011-07-28,3,0,7,19,37,285,322,424.3333333333333
4918,2011-07-28,3,0,7,20,41,229,270,358.3333333333333
4919,2011-07-28,3,0,7,21,31,165,196,262.6666666666667
4920,2011-07-28,3,0,7,22,25,149,174,213.33333333333334
4921,2011-07-28,3,0,7,23,28,95,123,164.33333333333334
4922,2011-07-29,3,0,7,0,12,45,57,118.0
4923,2011-07-29,3,0,7,1,12,22,34,71.33333333333333
4924,2011-07-29,3,0,7,2,3,10,13,34.666666666666664
4925,2011-07-29,3,0,7,3,2,9,11,19.333333333333332
4926,2011-07-29,3,0,7,4,2,4,6,10.0
4927,2011-07-29,3,0,7,5,4,23,27,14.666666666666666
4928,2011-07-29,3,0,7,6,7,83,90,41.0
4929,2011-07-29,3,0,7,7,26,228,254,123.66666666666667
4930,2011-07-29,3,0,7,8,30,354,384,242.66666666666666
4931,2011-07-29,3,0,7,9,28,151,179,272.3333333333333
4932,2011-07-29,3,0,7,10,37,69,106,223.0
4933,2011-07-29,3,0,7,11,43,118,161,148.66666666666666
4934,2011-07-29,3,0,7,12,40,95,135,134.0
4935,2011-07-29,3,0,7,13,42,114,156,150.66666666666666
4936,2011-07-29,3,0,7,14,34,114,148,146.33333333333334
4937,2011-07-29,3,0,7,15,40,129,169,157.66666666666666
4938,2011-07-29,3,0,7,16,35,198,233,183.33333333333334
4939,2011-07-29,3,0,7,17,47,374,421,274.3333333333333
4940,2011-07-29,3,0,7,18,49,313,362,338.6666666666667
4941,2011-07-29,3,0,7,19,22,219,241,341.3333333333333
4942,2011-07-29,3,0,7,20,53,153,206,269.6666666666667
4943,2011-07-29,3,0,7,21,29,134,163,203.33333333333334
4944,2011-07-29,3,0,7,22,47,127,174,181.0
4945,2011-07-29,3,0,7,23,26,90,116,151.0
4946,2011-07-30,3,0,7,0,60,73,133,141.0
4947,2011-07-30,3,0,7,1,15,75,90,113.0
4948,2011-07-30,3,0,7,2,11,31,42,88.33333333333333
4949,2011-07-30,3,0,7,3,18,25,43,58.333333333333336
4950,2011-07-30,3,0,7,4,4,6,10,31.666666666666668
4951,2011-07-30,3,0,7,5,4,9,13,22.0
4952,2011-07-30,3,0,7,6,6,18,24,15.666666666666666
4953,2011-07-30,3,0,7,7,3,39,42,26.333333333333332
4954,2011-07-30,3,0,7,8,27,87,114,60.0
4955,2011-07-30,3,0,7,9,49,125,174,110.0
4956,2011-07-30,3,0,7,10,79,182,261,183.0
4957,2011-07-30,3,0,7,11,111,206,317,250.66666666666666
4958,2011-07-30,3,0,7,12,111,230,341,306.3333333333333
4959,2011-07-30,3,0,7,13,125,183,308,322.0
4960,2011-07-30,3,0,7,14,112,193,305,318.0
4961,2011-07-30,3,0,7,15,113,189,302,305.0
4962,2011-07-30,3,0,7,16,126,176,302,303.0
4963,2011-07-30,3,0,7,17,93,209,302,302.0
4964,2011-07-30,3,0,7,18,92,207,299,301.0
4965,2011-07-30,3,0,7,19,101,155,256,285.6666666666667
4966,2011-07-30,3,0,7,20,74,132,206,253.66666666666666
4967,2011-07-30,3,0,7,21,82,123,205,222.33333333333334
4968,2011-07-30,3,0,7,22,80,129,209,206.66666666666666
4969,2011-07-30,3,0,7,23,63,114,177,197.0
4970,2011-07-31,3,0,7,0,33,80,113,166.33333333333334
4971,2011-07-31,3,0,7,1,8,71,79,123.0
4972,2011-07-31,3,0,7,2,19,48,67,86.33333333333333
4973,2011-07-31,3,0,7,3,24,26,50,65.33333333333333
4974,2011-07-31,3,0,7,4,6,7,13,43.333333333333336
4975,2011-07-31,3,0,7,5,4,4,8,23.666666666666668
4976,2011-07-31,3,0,7,6,5,8,13,11.333333333333334
4977,2011-07-31,3,0,7,7,19,26,45,22.0
4978,2011-07-31,3,0,7,8,54,88,142,66.66666666666667
4979,2011-07-31,3,0,7,9,55,128,183,123.33333333333333
4980,2011-07-31,3,0,7,10,91,163,254,193.0
4981,2011-07-31,3,0,7,11,112,163,275,237.33333333333334
4982,2011-07-31,3,0,7,12,146,192,338,289.0
4983,2011-07-31,3,0,7,13,142,152,294,302.3333333333333
4984,2011-07-31,3,0,7,14,130,196,326,319.3333333333333
4985,2011-07-31,3,0,7,15,109,184,293,304.3333333333333
4986,2011-07-31,3,0,7,16,98,208,306,308.3333333333333
4987,2011-07-31,3,0,7,17,114,206,320,306.3333333333333
4988,2011-07-31,3,0,7,18,91,213,304,310.0
4989,2011-07-31,3,0,7,19,87,187,274,299.3333333333333
4990,2011-07-31,3,0,7,20,70,205,275,284.3333333333333
4991,2011-07-31,3,0,7,21,68,96,164,237.66666666666666
4992,2011-07-31,3,0,7,22,25,71,96,178.33333333333334
4993,2011-07-31,3,0,7,23,14,56,70,110.0
4994,2011-08-01,3,0,8,0,7,22,29,65.0
4995,2011-08-01,3,0,8,1,5,12,17,38.666666666666664
4996,2011-08-01,3,0,8,2,4,7,11,19.0
4997,2011-08-01,3,0,8,3,0,4,4,10.666666666666666
4998,2011-08-01,3,0,8,4,2,2,4,6.333333333333333
4999,2011-08-01,3,0,8,5,2,24,26,11.333333333333334
5000,2011-08-01,3,0,8,6,3,97,100,43.333333333333336
5001,2011-08-01,3,0,8,7,24,258,282,136.0
5002,2011-08-01,3,0,8,8,35,347,382,254.66666666666666
5003,2011-08-01,3,0,8,9,27,139,166,276.6666666666667
5004,2011-08-01,3,0,8,10,27,70,97,215.0
5005,2011-08-01,3,0,8,11,53,66,119,127.33333333333333
5006,2011-08-01,3,0,8,12,53,115,168,128.0
5007,2011-08-01,3,0,8,13,38,112,150,145.66666666666666
5008,2011-08-01,3,0,8,14,37,86,123,147.0
5009,2011-08-01,3,0,8,15,52,77,129,134.0
5010,2011-08-01,3,0,8,16,34,197,231,161.0
5011,2011-08-01,3,0,8,17,69,445,514,291.3333333333333
5012,2011-08-01,3,0,8,18,68,475,543,429.3333333333333
5013,2011-08-01,3,0,8,19,63,350,413,490.0
5014,2011-08-01,3,0,8,20,49,256,305,420.3333333333333
5015,2011-08-01,3,0,8,21,42,178,220,312.6666666666667
5016,2011-08-01,3,0,8,22,21,116,137,220.66666666666666
5017,2011-08-01,3,0,8,23,14,82,96,151.0
5018,2011-08-02,3,0,8,0,11,18,29,87.33333333333333
5019,2011-08-02,3,0,8,1,4,8,12,45.666666666666664
5020,2011-08-02,3,0,8,2,2,6,8,16.333333333333332
5021,2011-08-02,3,0,8,3,0,5,5,8.333333333333334
5022,2011-08-02,3,0,8,4,0,10,10,7.666666666666667
5023,2011-08-02,3,0,8,5,4,17,21,12.0
5024,2011-08-02,3,0,8,6,12,105,117,49.333333333333336
5025,2011-08-02,3,0,8,7,15,320,335,157.66666666666666
5026,2011-08-02,3,0,8,8,37,398,435,295.6666666666667
5027,2011-08-02,3,0,8,9,31,182,213,327.6666666666667
5028,2011-08-02,3,0,8,10,50,90,140,262.6666666666667
5029,2011-08-02,3,0,8,11,32,96,128,160.33333333333334
5030,2011-08-02,3,0,8,12,45,112,157,141.66666666666666
5031,2011-08-02,3,0,8,13,50,153,203,162.66666666666666
5032,2011-08-02,3,0,8,14,45,114,159,173.0
5033,2011-08-02,3,0,8,15,48,120,168,176.66666666666666
5034,2011-08-02,3,0,8,16,58,216,274,200.33333333333334
5035,2011-08-02,3,0,8,17,63,493,556,332.6666666666667
5036,2011-08-02,3,0,8,18,65,491,556,462.0
5037,2011-08-02,3,0,8,19,85,369,454,522.0
5038,2011-08-02,3,0,8,20,40,248,288,432.6666666666667
5039,2011-08-02,3,0,8,21,53,201,254,332.0
5040,2011-08-02,3,0,8,22,22,169,191,244.33333333333334
5041,2011-08-02,3,0,8,23,29,103,132,192.33333333333334
5042,2011-08-03,3,0,8,0,11,32,43,122.0
5043,2011-08-03,3,0,8,1,7,9,16,63.666666666666664
5044,2011-08-03,3,0,8,2,2,9,11,23.333333333333332
5045,2011-08-03,3,0,8,3,0,4,4,10.333333333333334
5046,2011-08-03,3,0,8,4,0,7,7,7.333333333333333
5047,2011-08-03,3,0,8,5,2,22,24,11.666666666666666
5048,2011-08-03,3,0,8,6,9,101,110,47.0
5049,2011-08-03,3,0,8,7,19,252,271,135.0
5050,2011-08-03,3,0,8,8,29,408,437,272.6666666666667
5051,2011-08-03,3,0,8,9,23,172,195,301.0
5052,2011-08-03,3,0,8,10,9,59,68,233.33333333333334
5053,2011-08-03,3,0,8,11,29,93,122,128.33333333333334
5054,2011-08-03,3,0,8,12,19,142,161,117.0
5055,2011-08-03,3,0,8,13,37,107,144,142.33333333333334
5056,2011-08-03,3,0,8,14,43,104,147,150.66666666666666
5057,2011-08-03,3,0,8,15,31,87,118,136.33333333333334
5058,2011-08-03,3,0,8,16,21,129,150,138.33333333333334
5059,2011-08-03,3,0,8,17,47,378,425,231.0
5060,2011-08-03,3,0,8,18,49,443,492,355.6666666666667
5061,2011-08-03,3,0,8,19,51,270,321,412.6666666666667
5062,2011-08-03,3,0,8,20,7,80,87,300.0
5063,2011-08-03,3,0,8,21,7,81,88,165.33333333333334
5064,2011-08-03,3,0,8,22,11,66,77,84.0
5065,2011-08-03,3,0,8,23,4,52,56,73.66666666666667
5066,2011-08-04,3,0,8,0,2,15,17,50.0
5067,2011-08-04,3,0,8,1,3,14,17,30.0
5068,2011-08-04,3,0,8,2,2,5,7,13.666666666666666
5069,2011-08-04,3,0,8,3,0,3,3,9.0
5070,2011-08-04,3,0,8,4,0,7,7,5.666666666666667
5071,2011-08-04,3,0,8,5,3,17,20,10.0
5072,2011-08-04,3,0,8,6,7,90,97,41.333333333333336
5073,2011-08-04,3,0,8,7,11,271,282,133.0
5074,2011-08-04,3,0,8,8,29,369,398,259.0
5075,2011-08-04,3,0,8,9,25,162,187,289.0
5076,2011-08-04,3,0,8,10,24,89,113,232.66666666666666
5077,2011-08-04,3,0,8,11,37,112,149,149.66666666666666
5078,2011-08-04,3,0,8,12,53,152,205,155.66666666666666
5079,2011-08-04,3,0,8,13,63,142,205,186.33333333333334
5080,2011-08-04,3,0,8,14,53,114,167,192.33333333333334
5081,2011-08-04,3,0,8,15,50,115,165,179.0
5082,2011-08-04,3,0,8,16,70,220,290,207.33333333333334
5083,2011-08-04,3,0,8,17,91,464,555,336.6666666666667
5084,2011-08-04,3,0,8,18,88,435,523,456.0
5085,2011-08-04,3,0,8,19,65,301,366,481.3333333333333
5086,2011-08-04,3,0,8,20,41,245,286,391.6666666666667
5087,2011-08-04,3,0,8,21,25,186,211,287.6666666666667
5088,2011-08-04,3,0,8,22,33,141,174,223.66666666666666
5089,2011-08-04,3,0,8,23,24,108,132,172.33333333333334
5090,2011-08-05,3,0,8,0,13,41,54,120.0
5091,2011-08-05,3,0,8,1,3,16,19,68.33333333333333
5092,2011-08-05,3,0,8,2,5,14,19,30.666666666666668
5093,2011-08-05,3,0,8,3,0,6,6,14.666666666666666
5094,2011-08-05,3,0,8,4,1,6,7,10.666666666666666
5095,2011-08-05,3,0,8,5,0,16,16,9.666666666666666
5096,2011-08-05,3,0,8,6,7,94,101,41.333333333333336
5097,2011-08-05,3,0,8,7,23,247,270,129.0
5098,2011-08-05,3,0,8,8,39,415,454,275.0
5099,2011-08-05,3,0,8,9,43,183,226,316.6666666666667
5100,2011-08-05,3,0,8,10,50,113,163,281.0
5101,2011-08-05,3,0,8,11,44,103,147,178.66666666666666
5102,2011-08-05,3,0,8,12,57,159,216,175.33333333333334
5103,2011-08-05,3,0,8,13,40,164,204,189.0
5104,2011-08-05,3,0,8,14,81,164,245,221.66666666666666
5105,2011-08-05,3,0,8,15,50,160,210,219.66666666666666
5106,2011-08-05,3,0,8,16,76,254,330,261.6666666666667
5107,2011-08-05,3,0,8,17,84,466,550,363.3333333333333
5108,2011-08-05,3,0,8,18,105,361,466,448.6666666666667
5109,2011-08-05,3,0,8,19,90,282,372,462.6666666666667
5110,2011-08-05,3,0,8,20,70,221,291,376.3333333333333
5111,2011-08-05,3,0,8,21,54,119,173,278.6666666666667
5112,2011-08-05,3,0,8,22,51,137,188,217.33333333333334
5113,2011-08-05,3,0,8,23,37,102,139,166.66666666666666
5114,2011-08-06,3,0,8,0,29,104,133,153.33333333333334
5115,2011-08-06,3,0,8,1,17,50,67,113.0
5116,2011-08-06,3,0,8,2,14,39,53,84.33333333333333
5117,2011-08-06,3,0,8,3,14,28,42,54.0
5118,2011-08-06,3,0,8,4,5,5,10,35.0
5119,2011-08-06,3,0,8,5,2,4,6,19.333333333333332
5120,2011-08-06,3,0,8,6,5,22,27,14.333333333333334
5121,2011-08-06,3,0,8,7,14,49,63,32.0
5122,2011-08-06,3,0,8,8,27,94,121,70.33333333333333
5123,2011-08-06,3,0,8,9,60,155,215,133.0
5124,2011-08-06,3,0,8,10,91,199,290,208.66666666666666
5125,2011-08-06,3,0,8,11,138,211,349,284.6666666666667
5126,2011-08-06,3,0,8,12,130,252,382,340.3333333333333
5127,2011-08-06,3,0,8,13,176,265,441,390.6666666666667
5128,2011-08-06,3,0,8,14,176,204,380,401.0
5129,2011-08-06,3,0,8,15,130,232,362,394.3333333333333
5130,2011-08-06,3,0,8,16,155,188,343,361.6666666666667
5131,2011-08-06,3,0,8,17,61,88,149,284.6666666666667
5132,2011-08-06,3,0,8,18,81,130,211,234.33333333333334
5133,2011-08-06,3,0,8,19,57,114,171,177.0
5134,2011-08-06,3,0,8,20,58,79,137,173.0
5135,2011-08-06,3,0,8,21,28,86,114,140.66666666666666
5136,2011-08-06,3,0,8,22,24,96,120,123.66666666666667
5137,2011-08-06,3,0,8,23,29,79,108,114.0
5138,2011-08-07,3,0,8,0,14,66,80,102.66666666666667
5139,2011-08-07,3,0,8,1,10,63,73,87.0
5140,2011-08-07,3,0,8,2,18,48,66,73.0
5141,2011-08-07,3,0,8,3,9,23,32,57.0
5142,2011-08-07,3,0,8,4,1,5,6,34.666666666666664
5143,2011-08-07,3,0,8,5,1,4,5,14.333333333333334
5144,2011-08-07,3,0,8,6,3,10,13,8.0
5145,2011-08-07,3,0,8,7,11,28,39,19.0
5146,2011-08-07,3,0,8,8,23,66,89,47.0
5147,2011-08-07,3,0,8,9,82,102,184,104.0
5148,2011-08-07,3,0,8,10,88,178,266,179.66666666666666
5149,2011-08-07,3,0,8,11,113,156,269,239.66666666666666
5150,2011-08-07,3,0,8,12,161,209,370,301.6666666666667
5151,2011-08-07,3,0,8,13,118,206,324,321.0
5152,2011-08-07,3,0,8,14,130,192,322,338.6666666666667
5153,2011-08-07,3,0,8,15,118,208,326,324.0
5154,2011-08-07,3,0,8,16,74,119,193,280.3333333333333
5155,2011-08-07,3,0,8,17,63,131,194,237.66666666666666
5156,2011-08-07,3,0,8,18,74,155,229,205.33333333333334
5157,2011-08-07,3,0,8,19,68,160,228,217.0
5158,2011-08-07,3,0,8,20,50,133,183,213.33333333333334
5159,2011-08-07,3,0,8,21,36,100,136,182.33333333333334
5160,2011-08-07,3,0,8,22,21,82,103,140.66666666666666
5161,2011-08-07,3,0,8,23,12,43,55,98.0
5162,2011-08-08,3,0,8,0,13,17,30,62.666666666666664
5163,2011-08-08,3,0,8,1,4,8,12,32.333333333333336
5164,2011-08-08,3,0,8,2,4,3,7,16.333333333333332
5165,2011-08-08,3,0,8,3,1,0,1,6.666666666666667
5166,2011-08-08,3,0,8,4,2,8,10,6.0
5167,2011-08-08,3,0,8,5,1,14,15,8.666666666666666
5168,2011-08-08,3,0,8,6,8,87,95,40.0
5169,2011-08-08,3,0,8,7,18,249,267,125.66666666666667
5170,2011-08-08,3,0,8,8,29,320,349,237.0
5171,2011-08-08,3,0,8,9,37,146,183,266.3333333333333
5172,2011-08-08,3,0,8,10,62,62,124,218.66666666666666
5173,2011-08-08,3,0,8,11,90,89,179,162.0
5174,2011-08-08,3,0,8,12,48,134,182,161.66666666666666
5175,2011-08-08,3,0,8,13,43,108,151,170.66666666666666
5176,2011-08-08,3,0,8,14,41,109,150,161.0
5177,2011-08-08,3,0,8,15,40,86,126,142.33333333333334
5178,2011-08-08,3,0,8,16,64,218,282,186.0
5179,2011-08-08,3,0,8,17,67,460,527,311.6666666666667
5180,2011-08-08,3,0,8,18,64,465,529,446.0
5181,2011-08-08,3,0,8,19,64,352,416,490.6666666666667
5182,2011-08-08,3,0,8,20,71,215,286,410.3333333333333
5183,2011-08-08,3,0,8,21,30,156,186,296.0
5184,2011-08-08,3,0,8,22,26,121,147,206.33333333333334
5185,2011-08-08,3,0,8,23,19,53,72,135.0
5186,2011-08-09,3,0,8,0,10,25,35,84.66666666666667
5187,2011-08-09,3,0,8,1,5,9,14,40.333333333333336
5188,2011-08-09,3,0,8,2,9,3,12,20.333333333333332
5189,2011-08-09,3,0,8,3,0,3,3,9.666666666666666
5190,2011-08-09,3,0,8,4,1,6,7,7.333333333333333
5191,2011-08-09,3,0,8,5,5,25,30,13.333333333333334
5192,2011-08-09,3,0,8,6,6,95,101,46.0
5193,2011-08-09,3,0,8,7,30,313,343,158.0
5194,2011-08-09,3,0,8,8,40,352,392,278.6666666666667
5195,2011-08-09,3,0,8,9,34,141,175,303.3333333333333
5196,2011-08-09,3,0,8,10,55,89,144,237.0
5197,2011-08-09,3,0,8,11,61,88,149,156.0
5198,2011-08-09,3,0,8,12,60,125,185,159.33333333333334
5199,2011-08-09,3,0,8,13,48,127,175,169.66666666666666
5200,2011-08-09,3,0,8,14,53,95,148,169.33333333333334
5201,2011-08-09,3,0,8,15,58,106,164,162.33333333333334
5202,2011-08-09,3,0,8,16,57,228,285,199.0
5203,2011-08-09,3,0,8,17,79,453,532,327.0
5204,2011-08-09,3,0,8,18,97,488,585,467.3333333333333
5205,2011-08-09,3,0,8,19,69,302,371,496.0
5206,2011-08-09,3,0,8,20,34,258,292,416.0
5207,2011-08-09,3,0,8,21,46,184,230,297.6666666666667
5208,2011-08-09,3,0,8,22,28,127,155,225.66666666666666
5209,2011-08-09,3,0,8,23,22,53,75,153.33333333333334
5210,2011-08-10,3,0,8,0,19,18,37,89.0
5211,2011-08-10,3,0,8,1,7,10,17,43.0
5212,2011-08-10,3,0,8,2,1,10,11,21.666666666666668
5213,2011-08-10,3,0,8,3,1,3,4,10.666666666666666
5214,2011-08-10,3,0,8,4,1,4,5,6.666666666666667
5215,2011-08-10,3,0,8,5,2,30,32,13.666666666666666
5216,2011-08-10,3,0,8,6,9,110,119,52.0
5217,2011-08-10,3,0,8,7,16,289,305,152.0
5218,2011-08-10,3,0,8,8,38,361,399,274.3333333333333
5219,2011-08-10,3,0,8,9,32,148,180,294.6666666666667
5220,2011-08-10,3,0,8,10,41,72,113,230.66666666666666
5221,2011-08-10,3,0,8,11,54,95,149,147.33333333333334
5222,2011-08-10,3,0,8,12,74,166,240,167.33333333333334
5223,2011-08-10,3,0,8,13,41,150,191,193.33333333333334
5224,2011-08-10,3,0,8,14,62,116,178,203.0
5225,2011-08-10,3,0,8,15,53,141,194,187.66666666666666
5226,2011-08-10,3,0,8,16,76,206,282,218.0
5227,2011-08-10,3,0,8,17,71,513,584,353.3333333333333
5228,2011-08-10,3,0,8,18,70,489,559,475.0
5229,2011-08-10,3,0,8,19,79,334,413,518.6666666666666
5230,2011-08-10,3,0,8,20,59,253,312,428.0
5231,2011-08-10,3,0,8,21,47,162,209,311.3333333333333
5232,2011-08-10,3,0,8,22,17,122,139,220.0
5233,2011-08-10,3,0,8,23,14,94,108,152.0
5234,2011-08-11,3,0,8,0,6,40,46,97.66666666666667
5235,2011-08-11,3,0,8,1,9,17,26,60.0
5236,2011-08-11,3,0,8,2,3,8,11,27.666666666666668
5237,2011-08-11,3,0,8,3,2,7,9,15.333333333333334
5238,2011-08-11,3,0,8,4,1,4,5,8.333333333333334
5239,2011-08-11,3,0,8,5,2,23,25,13.0
5240,2011-08-11,3,0,8,6,5,101,106,45.333333333333336
5241,2011-08-11,3,0,8,7,15,292,307,146.0
5242,2011-08-11,3,0,8,8,29,361,390,267.6666666666667
5243,2011-08-11,3,0,8,9,31,166,197,298.0
5244,2011-08-11,3,0,8,10,36,96,132,239.66666666666666
5245,2011-08-11,3,0,8,11,59,128,187,172.0
5246,2011-08-11,3,0,8,12,50,164,214,177.66666666666666
5247,2011-08-11,3,0,8,13,51,166,217,206.0
5248,2011-08-11,3,0,8,14,39,103,142,191.0
5249,2011-08-11,3,0,8,15,52,126,178,179.0
5250,2011-08-11,3,0,8,16,57,241,298,206.0
5251,2011-08-11,3,0,8,17,96,486,582,352.6666666666667
5252,2011-08-11,3,0,8,18,74,497,571,483.6666666666667
5253,2011-08-11,3,0,8,19,48,323,371,508.0
5254,2011-08-11,3,0,8,20,56,232,288,410.0
5255,2011-08-11,3,0,8,21,35,171,206,288.3333333333333
5256,2011-08-11,3,0,8,22,34,123,157,217.0
5257,2011-08-11,3,0,8,23,22,105,127,163.33333333333334
5258,2011-08-12,3,0,8,0,12,53,65,116.33333333333333
5259,2011-08-12,3,0,8,1,4,19,23,71.66666666666667
5260,2011-08-12,3,0,8,2,0,15,15,34.333333333333336
5261,2011-08-12,3,0,8,3,0,9,9,15.666666666666666
5262,2011-08-12,3,0,8,4,0,5,5,9.666666666666666
5263,2011-08-12,3,0,8,5,2,24,26,13.333333333333334
5264,2011-08-12,3,0,8,6,3,73,76,35.666666666666664
5265,2011-08-12,3,0,8,7,17,247,264,122.0
5266,2011-08-12,3,0,8,8,29,397,426,255.33333333333334
5267,2011-08-12,3,0,8,9,27,178,205,298.3333333333333
5268,2011-08-12,3,0,8,10,44,86,130,253.66666666666666
5269,2011-08-12,3,0,8,11,48,108,156,163.66666666666666
5270,2011-08-12,3,0,8,12,55,167,222,169.33333333333334
5271,2011-08-12,3,0,8,13,74,179,253,210.33333333333334
5272,2011-08-12,3,0,8,14,51,135,186,220.33333333333334
5273,2011-08-12,3,0,8,15,59,190,249,229.33333333333334
5274,2011-08-12,3,0,8,16,68,266,334,256.3333333333333
5275,2011-08-12,3,0,8,17,93,423,516,366.3333333333333
5276,2011-08-12,3,0,8,18,89,376,465,438.3333333333333
5277,2011-08-12,3,0,8,19,101,284,385,455.3333333333333
5278,2011-08-12,3,0,8,20,77,210,287,379.0
5279,2011-08-12,3,0,8,21,73,153,226,299.3333333333333
5280,2011-08-12,3,0,8,22,74,157,231,248.0
5281,2011-08-12,3,0,8,23,51,100,151,202.66666666666666
5282,2011-08-13,3,0,8,0,15,69,84,155.33333333333334
5283,2011-08-13,3,0,8,1,13,64,77,104.0
5284,2011-08-13,3,0,8,2,16,58,74,78.33333333333333
5285,2011-08-13,3,0,8,3,9,18,27,59.333333333333336
5286,2011-08-13,3,0,8,4,5,5,10,37.0
5287,2011-08-13,3,0,8,5,3,15,18,18.333333333333332
5288,2011-08-13,3,0,8,6,3,19,22,16.666666666666668
5289,2011-08-13,3,0,8,7,10,34,44,28.0
5290,2011-08-13,3,0,8,8,28,90,118,61.333333333333336
5291,2011-08-13,3,0,8,9,70,138,208,123.33333333333333
5292,2011-08-13,3,0,8,10,97,163,260,195.33333333333334
5293,2011-08-13,3,0,8,11,122,192,314,260.6666666666667
5294,2011-08-13,3,0,8,12,175,246,421,331.6666666666667
5295,2011-08-13,3,0,8,13,61,92,153,296.0
5296,2011-08-13,3,0,8,14,113,146,259,277.6666666666667
5297,2011-08-13,3,0,8,15,150,208,358,256.6666666666667
5298,2011-08-13,3,0,8,16,148,133,281,299.3333333333333
5299,2011-08-13,3,0,8,17,97,172,269,302.6666666666667
5300,2011-08-13,3,0,8,18,123,169,292,280.6666666666667
5301,2011-08-13,3,0,8,19,67,170,237,266.0
5302,2011-08-13,3,0,8,20,78,105,183,237.33333333333334
5303,2011-08-13,3,0,8,21,40,127,167,195.66666666666666
5304,2011-08-13,3,0,8,22,36,118,154,168.0
5305,2011-08-13,3,0,8,23,25,95,120,147.0
5306,2011-08-14,3,0,8,0,19,71,90,121.33333333333333
5307,2011-08-14,3,0,8,1,16,57,73,94.33333333333333
5308,2011-08-14,3,0,8,2,13,49,62,75.0
5309,2011-08-14,3,0,8,3,5,22,27,54.0
5310,2011-08-14,3,0,8,4,1,2,3,30.666666666666668
5311,2011-08-14,3,0,8,5,1,9,10,13.333333333333334
5312,2011-08-14,3,0,8,6,2,4,6,6.333333333333333
5313,2011-08-14,3,0,8,7,4,20,24,13.333333333333334
5314,2011-08-14,3,0,8,8,20,21,41,23.666666666666668
5315,2011-08-14,3,0,8,9,27,76,103,56.0
5316,2011-08-14,3,0,8,10,67,116,183,109.0
5317,2011-08-14,3,0,8,11,81,117,198,161.33333333333334
5318,2011-08-14,3,0,8,12,98,183,281,220.66666666666666
5319,2011-08-14,3,0,8,13,144,233,377,285.3333333333333
5320,2011-08-14,3,0,8,14,126,244,370,342.6666666666667
5321,2011-08-14,3,0,8,15,128,203,331,359.3333333333333
5322,2011-08-14,3,0,8,16,116,176,292,331.0
5323,2011-08-14,3,0,8,17,133,196,329,317.3333333333333
5324,2011-08-14,3,0,8,18,125,222,347,322.6666666666667
5325,2011-08-14,3,0,8,19,75,184,259,311.6666666666667
5326,2011-08-14,3,0,8,20,67,126,193,266.3333333333333
5327,2011-08-14,3,0,8,21,51,104,155,202.33333333333334
5328,2011-08-14,3,0,8,22,14,25,39,129.0
5329,2011-08-14,3,0,8,23,5,22,27,73.66666666666667
5330,2011-08-15,3,0,8,0,7,18,25,30.333333333333332
5331,2011-08-15,3,0,8,1,1,9,10,20.666666666666668
5332,2011-08-15,3,0,8,2,0,3,3,12.666666666666666
5333,2011-08-15,3,0,8,3,1,6,7,6.666666666666667
5334,2011-08-15,3,0,8,4,1,4,5,5.0
5335,2011-08-15,3,0,8,5,3,14,17,9.666666666666666
5336,2011-08-15,3,0,8,6,3,87,90,37.333333333333336
5337,2011-08-15,3,0,8,7,10,248,258,121.66666666666667
5338,2011-08-15,3,0,8,8,29,326,355,234.33333333333334
5339,2011-08-15,3,0,8,9,52,170,222,278.3333333333333
5340,2011-08-15,3,0,8,10,54,87,141,239.33333333333334
5341,2011-08-15,3,0,8,11,41,112,153,172.0
5342,2011-08-15,3,0,8,12,62,116,178,157.33333333333334
5343,2011-08-15,3,0,8,13,53,140,193,174.66666666666666
5344,2011-08-15,3,0,8,14,56,95,151,174.0
5345,2011-08-15,3,0,8,15,49,133,182,175.33333333333334
5346,2011-08-15,3,0,8,16,58,225,283,205.33333333333334
5347,2011-08-15,3,0,8,17,59,471,530,331.6666666666667
5348,2011-08-15,3,0,8,18,70,413,483,432.0
5349,2011-08-15,3,0,8,19,54,343,397,470.0
5350,2011-08-15,3,0,8,20,45,240,285,388.3333333333333
5351,2011-08-15,3,0,8,21,34,150,184,288.6666666666667
5352,2011-08-15,3,0,8,22,22,76,98,189.0
5353,2011-08-15,3,0,8,23,11,77,88,123.33333333333333
5354,2011-08-16,3,0,8,0,8,23,31,72.33333333333333
5355,2011-08-16,3,0,8,1,4,12,16,45.0
5356,2011-08-16,3,0,8,2,1,3,4,17.0
5357,2011-08-16,3,0,8,3,1,5,6,8.666666666666666
5358,2011-08-16,3,0,8,4,0,5,5,5.0
5359,2011-08-16,3,0,8,5,1,29,30,13.666666666666666
5360,2011-08-16,3,0,8,6,4,115,119,51.333333333333336
5361,2011-08-16,3,0,8,7,18,328,346,165.0
5362,2011-08-16,3,0,8,8,24,417,441,302.0
5363,2011-08-16,3,0,8,9,27,171,198,328.3333333333333
5364,2011-08-16,3,0,8,10,28,83,111,250.0
5365,2011-08-16,3,0,8,11,40,110,150,153.0
5366,2011-08-16,3,0,8,12,42,120,162,141.0
5367,2011-08-16,3,0,8,13,45,147,192,168.0
5368,2011-08-16,3,0,8,14,65,117,182,178.66666666666666
5369,2011-08-16,3,0,8,15,36,123,159,177.66666666666666
5370,2011-08-16,3,0,8,16,55,248,303,214.66666666666666
5371,2011-08-16,3,0,8,17,75,525,600,354.0
5372,2011-08-16,3,0,8,18,54,516,570,491.0
5373,2011-08-16,3,0,8,19,56,320,376,515.3333333333334
5374,2011-08-16,3,0,8,20,48,232,280,408.6666666666667
5375,2011-08-16,3,0,8,21,38,177,215,290.3333333333333
5376,2011-08-16,3,0,8,22,31,121,152,215.66666666666666
5377,2011-08-16,3,0,8,23,20,57,77,148.0
5378,2011-08-17,3,0,8,0,8,16,24,84.33333333333333
5379,2011-08-17,3,0,8,1,2,12,14,38.333333333333336
5380,2011-08-17,3,0,8,2,0,6,6,14.666666666666666
5381,2011-08-17,3,0,8,3,1,4,5,8.333333333333334
5382,2011-08-17,3,0,8,4,0,5,5,5.333333333333333
5383,2011-08-17,3,0,8,5,0,28,28,12.666666666666666
5384,2011-08-17,3,0,8,6,4,101,105,46.0
5385,2011-08-17,3,0,8,7,12,296,308,147.0
5386,2011-08-17,3,0,8,8,35,452,487,300.0
5387,2011-08-17,3,0,8,9,31,178,209,334.6666666666667
5388,2011-08-17,3,0,8,10,27,91,118,271.3333333333333
5389,2011-08-17,3,0,8,11,20,108,128,151.66666666666666
5390,2011-08-17,3,0,8,12,26,163,189,145.0
5391,2011-08-17,3,0,8,13,38,138,176,164.33333333333334
5392,2011-08-17,3,0,8,14,54,138,192,185.66666666666666
5393,2011-08-17,3,0,8,15,42,117,159,175.66666666666666
5394,2011-08-17,3,0,8,16,62,238,300,217.0
5395,2011-08-17,3,0,8,17,46,506,552,337.0
5396,2011-08-17,3,0,8,18,86,470,556,469.3333333333333
5397,2011-08-17,3,0,8,19,50,297,347,485.0
5398,2011-08-17,3,0,8,20,37,243,280,394.3333333333333
5399,2011-08-17,3,0,8,21,38,192,230,285.6666666666667
5400,2011-08-17,3,0,8,22,29,142,171,227.0
5401,2011-08-17,3,0,8,23,20,85,105,168.66666666666666
5402,2011-08-18,3,0,8,0,18,38,56,110.66666666666667
5403,2011-08-18,3,0,8,1,13,11,24,61.666666666666664
5404,2011-08-18,3,0,8,2,2,4,6,28.666666666666668
5405,2011-08-18,3,0,8,3,0,6,6,12.0
5406,2011-08-18,3,0,8,4,0,9,9,7.0
5407,2011-08-18,3,0,8,5,0,27,27,14.0
5408,2011-08-18,3,0,8,6,6,97,103,46.333333333333336
5409,2011-08-18,3,0,8,7,19,289,308,146.0
5410,2011-08-18,3,0,8,8,27,393,420,277.0
5411,2011-08-18,3,0,8,9,42,186,228,318.6666666666667
5412,2011-08-18,3,0,8,10,37,92,129,259.0
5413,2011-08-18,3,0,8,11,44,97,141,166.0
5414,2011-08-18,3,0,8,12,34,139,173,147.66666666666666
5415,2011-08-18,3,0,8,13,33,154,187,167.0
5416,2011-08-18,3,0,8,14,67,115,182,180.66666666666666
5417,2011-08-18,3,0,8,15,56,118,174,181.0
5418,2011-08-18,3,0,8,16,49,196,245,200.33333333333334
5419,2011-08-18,3,0,8,17,44,365,409,276.0
5420,2011-08-18,3,0,8,18,48,226,274,309.3333333333333
5421,2011-08-18,3,0,8,19,26,115,141,274.6666666666667
5422,2011-08-18,3,0,8,20,24,141,165,193.33333333333334
5423,2011-08-18,3,0,8,21,12,137,149,151.66666666666666
5424,2011-08-18,3,0,8,22,18,117,135,149.66666666666666
5425,2011-08-18,3,0,8,23,20,94,114,132.66666666666666
5426,2011-08-19,3,0,8,0,9,53,62,103.66666666666667
5427,2011-08-19,3,0,8,1,1,19,20,65.33333333333333
5428,2011-08-19,3,0,8,2,0,8,8,30.0
5429,2011-08-19,3,0,8,3,2,1,3,10.333333333333334
5430,2011-08-19,3,0,8,4,1,7,8,6.333333333333333
5431,2011-08-19,3,0,8,5,1,16,17,9.333333333333334
5432,2011-08-19,3,0,8,6,2,91,93,39.333333333333336
5433,2011-08-19,3,0,8,7,12,251,263,124.33333333333333
5434,2011-08-19,3,0,8,8,30,368,398,251.33333333333334
5435,2011-08-19,3,0,8,9,31,187,218,293.0
5436,2011-08-19,3,0,8,10,57,108,165,260.3333333333333
5437,2011-08-19,3,0,8,11,45,120,165,182.66666666666666
5438,2011-08-19,3,0,8,12,54,168,222,184.0
5439,2011-08-19,3,0,8,13,63,169,232,206.33333333333334
5440,2011-08-19,3,0,8,14,78,142,220,224.66666666666666
5441,2011-08-19,3,0,8,15,66,156,222,224.66666666666666
5442,2011-08-19,3,0,8,16,66,261,327,256.3333333333333
5443,2011-08-19,3,0,8,17,85,442,527,358.6666666666667
5444,2011-08-19,3,0,8,18,88,337,425,426.3333333333333
5445,2011-08-19,3,0,8,19,33,132,165,372.3333333333333
5446,2011-08-19,3,0,8,20,12,46,58,216.0
5447,2011-08-19,3,0,8,21,18,89,107,110.0
5448,2011-08-19,3,0,8,22,25,97,122,95.66666666666667
5449,2011-08-19,3,0,8,23,18,88,106,111.66666666666667
5450,2011-08-20,3,0,8,0,21,107,128,118.66666666666667
5451,2011-08-20,3,0,8,1,12,35,47,93.66666666666667
5452,2011-08-20,3,0,8,2,10,59,69,81.33333333333333
5453,2011-08-20,3,0,8,3,9,42,51,55.666666666666664
5454,2011-08-20,3,0,8,4,1,6,7,42.333333333333336
5455,2011-08-20,3,0,8,5,0,8,8,22.0
5456,2011-08-20,3,0,8,6,6,18,24,13.0
5457,2011-08-20,3,0,8,7,8,36,44,25.333333333333332
5458,2011-08-20,3,0,8,8,27,106,133,67.0
5459,2011-08-20,3,0,8,9,51,139,190,122.33333333333333
5460,2011-08-20,3,0,8,10,114,192,306,209.66666666666666
5461,2011-08-20,3,0,8,11,115,223,338,278.0
5462,2011-08-20,3,0,8,12,156,253,409,351.0
5463,2011-08-20,3,0,8,13,158,220,378,375.0
5464,2011-08-20,3,0,8,14,147,228,375,387.3333333333333
5465,2011-08-20,3,0,8,15,175,215,390,381.0
5466,2011-08-20,3,0,8,16,151,222,373,379.3333333333333
5467,2011-08-20,3,0,8,17,180,203,383,382.0
5468,2011-08-20,3,0,8,18,169,225,394,383.3333333333333
5469,2011-08-20,3,0,8,19,109,182,291,356.0
5470,2011-08-20,3,0,8,20,78,170,248,311.0
5471,2011-08-20,3,0,8,21,81,144,225,254.66666666666666
5472,2011-08-20,3,0,8,22,77,146,223,232.0
5473,2011-08-20,3,0,8,23,59,98,157,201.66666666666666
5474,2011-08-21,3,0,8,0,6,68,74,151.33333333333334
5475,2011-08-21,3,0,8,1,17,69,86,105.66666666666667
5476,2011-08-21,3,0,8,2,13,51,64,74.66666666666667
5477,2011-08-21,3,0,8,3,25,26,51,67.0
5478,2011-08-21,3,0,8,4,1,5,6,40.333333333333336
5479,2011-08-21,3,0,8,5,0,8,8,21.666666666666668
5480,2011-08-21,3,0,8,6,4,10,14,9.333333333333334
5481,2011-08-21,3,0,8,7,12,19,31,17.666666666666668
5482,2011-08-21,3,0,8,8,30,62,92,45.666666666666664
5483,2011-08-21,3,0,8,9,80,151,231,118.0
5484,2011-08-21,3,0,8,10,97,177,274,199.0
5485,2011-08-21,3,0,8,11,132,181,313,272.6666666666667
5486,2011-08-21,3,0,8,12,135,239,374,320.3333333333333
5487,2011-08-21,3,0,8,13,94,216,310,332.3333333333333
5488,2011-08-21,3,0,8,14,78,157,235,306.3333333333333
5489,2011-08-21,3,0,8,15,17,51,68,204.33333333333334
5490,2011-08-21,3,0,8,16,97,161,258,187.0
5491,2011-08-21,3,0,8,17,91,179,270,198.66666666666666
5492,2011-08-21,3,0,8,18,96,215,311,279.6666666666667
5493,2011-08-21,3,0,8,19,81,201,282,287.6666666666667
5494,2011-08-21,3,0,8,20,41,140,181,258.0
5495,2011-08-21,3,0,8,21,45,93,138,200.33333333333334
5496,2011-08-21,3,0,8,22,37,97,134,151.0
5497,2011-08-21,3,0,8,23,20,48,68,113.33333333333333
5498,2011-08-22,3,0,8,0,18,22,40,80.66666666666667
5499,2011-08-22,3,0,8,1,8,13,21,43.0
5500,2011-08-22,3,0,8,2,2,6,8,23.0
5501,2011-08-22,3,0,8,3,0,5,5,11.333333333333334
5502,2011-08-22,3,0,8,4,2,10,12,8.333333333333334
5503,2011-08-22,3,0,8,5,1,23,24,13.666666666666666
5504,2011-08-22,3,0,8,6,6,106,112,49.333333333333336
5505,2011-08-22,3,0,8,7,11,270,281,139.0
5506,2011-08-22,3,0,8,8,20,331,351,248.0
5507,2011-08-22,3,0,8,9,36,151,187,273.0
5508,2011-08-22,3,0,8,10,36,85,121,219.66666666666666
5509,2011-08-22,3,0,8,11,46,85,131,146.33333333333334
5510,2011-08-22,3,0,8,12,54,153,207,153.0
5511,2011-08-22,3,0,8,13,47,158,205,181.0
5512,2011-08-22,3,0,8,14,88,137,225,212.33333333333334
5513,2011-08-22,3,0,8,15,72,127,199,209.66666666666666
5514,2011-08-22,3,0,8,16,66,254,320,248.0
5515,2011-08-22,3,0,8,17,82,509,591,370.0
5516,2011-08-22,3,0,8,18,72,537,609,506.6666666666667
5517,2011-08-22,3,0,8,19,66,350,416,538.6666666666666
5518,2011-08-22,3,0,8,20,21,247,268,431.0
5519,2011-08-22,3,0,8,21,28,180,208,297.3333333333333
5520,2011-08-22,3,0,8,22,32,121,153,209.66666666666666
5521,2011-08-22,3,0,8,23,19,45,64,141.66666666666666
5522,2011-08-23,3,0,8,0,13,22,35,84.0
5523,2011-08-23,3,0,8,1,6,13,19,39.333333333333336
5524,2011-08-23,3,0,8,2,2,4,6,20.0
5525,2011-08-23,3,0,8,3,2,4,6,10.333333333333334
5526,2011-08-23,3,0,8,4,0,5,5,5.666666666666667
5527,2011-08-23,3,0,8,5,1,35,36,15.666666666666666
5528,2011-08-23,3,0,8,6,3,111,114,51.666666666666664
5529,2011-08-23,3,0,8,7,11,333,344,164.66666666666666
5530,2011-08-23,3,0,8,8,43,461,504,320.6666666666667
5531,2011-08-23,3,0,8,9,34,191,225,357.6666666666667
5532,2011-08-23,3,0,8,10,56,92,148,292.3333333333333
5533,2011-08-23,3,0,8,11,62,124,186,186.33333333333334
5534,2011-08-23,3,0,8,12,60,177,237,190.33333333333334
5535,2011-08-23,3,0,8,13,70,164,234,219.0
5536,2011-08-23,3,0,8,14,149,502,651,374.0
5537,2011-08-23,3,0,8,15,178,423,601,495.3333333333333
5538,2011-08-23,3,0,8,16,133,311,444,565.3333333333334
5539,2011-08-23,3,0,8,17,133,339,472,505.6666666666667
5540,2011-08-23,3,0,8,18,98,421,519,478.3333333333333
5541,2011-08-23,3,0,8,19,70,297,367,452.6666666666667
5542,2011-08-23,3,0,8,20,54,206,260,382.0
5543,2011-08-23,3,0,8,21,38,173,211,279.3333333333333
5544,2011-08-23,3,0,8,22,46,145,191,220.66666666666666
5545,2011-08-23,3,0,8,23,19,61,80,160.66666666666666
5546,2011-08-24,3,0,8,0,9,29,38,103.0
5547,2011-08-24,3,0,8,1,7,17,24,47.333333333333336
5548,2011-08-24,3,0,8,2,2,4,6,22.666666666666668
5549,2011-08-24,3,0,8,3,0,1,1,10.333333333333334
5550,2011-08-24,3,0,8,4,0,7,7,4.666666666666667
5551,2011-08-24,3,0,8,5,1,26,27,11.666666666666666
5552,2011-08-24,3,0,8,6,3,105,108,47.333333333333336
5553,2011-08-24,3,0,8,7,11,297,308,147.66666666666666
5554,2011-08-24,3,0,8,8,32,436,468,294.6666666666667
5555,2011-08-24,3,0,8,9,44,169,213,329.6666666666667
5556,2011-08-24,3,0,8,10,51,95,146,275.6666666666667
5557,2011-08-24,3,0,8,11,57,128,185,181.33333333333334
5558,2011-08-24,3,0,8,12,60,175,235,188.66666666666666
5559,2011-08-24,3,0,8,13,56,180,236,218.66666666666666
5560,2011-08-24,3,0,8,14,77,127,204,225.0
5561,2011-08-24,3,0,8,15,63,141,204,214.66666666666666
5562,2011-08-24,3,0,8,16,49,222,271,226.33333333333334
5563,2011-08-24,3,0,8,17,83,484,567,347.3333333333333
5564,2011-08-24,3,0,8,18,102,519,621,486.3333333333333
5565,2011-08-24,3,0,8,19,93,347,440,542.6666666666666
5566,2011-08-24,3,0,8,20,45,289,334,465.0
5567,2011-08-24,3,0,8,21,47,189,236,336.6666666666667
5568,2011-08-24,3,0,8,22,41,140,181,250.33333333333334
5569,2011-08-24,3,0,8,23,16,54,70,162.33333333333334
5570,2011-08-25,3,0,8,0,11,41,52,101.0
5571,2011-08-25,3,0,8,1,4,11,15,45.666666666666664
5572,2011-08-25,3,0,8,2,3,2,5,24.0
5573,2011-08-25,3,0,8,3,2,2,4,8.0
5574,2011-08-25,3,0,8,4,1,6,7,5.333333333333333
5575,2011-08-25,3,0,8,5,1,25,26,12.333333333333334
5576,2011-08-25,3,0,8,6,1,101,102,45.0
5577,2011-08-25,3,0,8,7,17,296,313,147.0
5578,2011-08-25,3,0,8,8,23,461,484,299.6666666666667
5579,2011-08-25,3,0,8,9,21,141,162,319.6666666666667
5580,2011-08-25,3,0,8,10,37,105,142,262.6666666666667
5581,2011-08-25,3,0,8,11,39,112,151,151.66666666666666
5582,2011-08-25,3,0,8,12,9,32,41,111.33333333333333
5583,2011-08-25,3,0,8,13,7,30,37,76.33333333333333
5584,2011-08-25,3,0,8,14,27,86,113,63.666666666666664
5585,2011-08-25,3,0,8,15,28,104,132,94.0
5586,2011-08-25,3,0,8,16,16,105,121,122.0
5587,2011-08-25,3,0,8,17,28,284,312,188.33333333333334
5588,2011-08-25,3,0,8,18,31,377,408,280.3333333333333
5589,2011-08-25,3,0,8,19,31,241,272,330.6666666666667
5590,2011-08-25,3,0,8,20,33,192,225,301.6666666666667
5591,2011-08-25,3,0,8,21,29,158,187,228.0
5592,2011-08-25,3,0,8,22,21,126,147,186.33333333333334
5593,2011-08-25,3,0,8,23,15,69,84,139.33333333333334
5594,2011-08-26,3,0,8,0,9,42,51,94.0
5595,2011-08-26,3,0,8,1,10,13,23,52.666666666666664
5596,2011-08-26,3,0,8,2,4,16,20,31.333333333333332
5597,2011-08-26,3,0,8,3,3,8,11,18.0
5598,2011-08-26,3,0,8,4,2,6,8,13.0
5599,2011-08-26,3,0,8,5,3,23,26,15.0
5600,2011-08-26,3,0,8,6,5,100,105,46.333333333333336
5601,2011-08-26,3,0,8,7,3,263,266,132.33333333333334
5602,2011-08-26,3,0,8,8,17,387,404,258.3333333333333
5603,2011-08-26,3,0,8,9,39,191,230,300.0
5604,2011-08-26,3,0,8,10,34,89,123,252.33333333333334
5605,2011-08-26,3,0,8,11,63,151,214,189.0
5606,2011-08-26,3,0,8,12,70,173,243,193.33333333333334
5607,2011-08-26,3,0,8,13,72,165,237,231.33333333333334
5608,2011-08-26,3,0,8,14,55,164,219,233.0
5609,2011-08-26,3,0,8,15,53,196,249,235.0
5610,2011-08-26,3,0,8,16,50,293,343,270.3333333333333
5611,2011-08-26,3,0,8,17,56,433,489,360.3333333333333
5612,2011-08-26,3,0,8,18,40,370,410,414.0
5613,2011-08-26,3,0,8,19,55,235,290,396.3333333333333
5614,2011-08-26,3,0,8,20,39,183,222,307.3333333333333
5615,2011-08-26,3,0,8,21,38,152,190,234.0
5616,2011-08-26,3,0,8,22,26,126,152,188.0
5617,2011-08-26,3,0,8,23,22,114,136,159.33333333333334
5618,2011-08-27,3,0,8,0,33,112,145,144.33333333333334
5619,2011-08-27,3,0,8,1,13,51,64,115.0
5620,2011-08-27,3,0,8,2,18,59,77,95.33333333333333
5621,2011-08-27,3,0,8,3,8,22,30,57.0
5622,2011-08-27,3,0,8,4,1,3,4,37.0
5623,2011-08-27,3,0,8,5,1,11,12,15.333333333333334
5624,2011-08-27,3,0,8,6,3,15,18,11.333333333333334
5625,2011-08-27,3,0,8,7,2,26,28,19.333333333333332
5626,2011-08-27,3,0,8,8,14,62,76,40.666666666666664
5627,2011-08-27,3,0,8,9,28,128,156,86.66666666666667
5628,2011-08-27,3,0,8,10,51,154,205,145.66666666666666
5629,2011-08-27,3,0,8,11,15,73,88,149.66666666666666
5630,2011-08-27,3,0,8,12,11,65,76,123.0
5631,2011-08-27,3,0,8,13,10,33,43,69.0
5632,2011-08-27,3,0,8,14,4,19,23,47.333333333333336
5633,2011-08-27,3,0,8,15,2,28,30,32.0
5634,2011-08-27,3,0,8,16,10,14,24,25.666666666666668
5635,2011-08-27,3,0,8,17,2,14,16,23.333333333333332
5636,2011-08-28,3,0,8,7,0,1,1,13.666666666666666
5637,2011-08-28,3,0,8,8,2,6,8,8.333333333333334
5638,2011-08-28,3,0,8,9,7,46,53,20.666666666666668
5639,2011-08-28,3,0,8,10,27,115,142,67.66666666666667
5640,2011-08-28,3,0,8,11,59,178,237,144.0
5641,2011-08-28,3,0,8,12,88,218,306,228.33333333333334
5642,2011-08-28,3,0,8,13,129,302,431,324.6666666666667
5643,2011-08-28,3,0,8,14,157,290,447,394.6666666666667
5644,2011-08-28,3,0,8,15,155,314,469,449.0
5645,2011-08-28,3,0,8,16,196,295,491,469.0
5646,2011-08-28,3,0,8,17,145,253,398,452.6666666666667
5647,2011-08-28,3,0,8,18,145,257,402,430.3333333333333
5648,2011-08-28,3,0,8,19,140,247,387,395.6666666666667
5649,2011-08-28,3,0,8,20,64,150,214,334.3333333333333
5650,2011-08-28,3,0,8,21,60,126,186,262.3333333333333
5651,2011-08-28,3,0,8,22,25,73,98,166.0
5652,2011-08-28,3,0,8,23,16,48,64,116.0
5653,2011-08-29,3,0,8,0,13,21,34,65.33333333333333
5654,2011-08-29,3,0,8,1,5,15,20,39.333333333333336
5655,2011-08-29,3,0,8,2,8,5,13,22.333333333333332
5656,2011-08-29,3,0,8,3,1,5,6,13.0
5657,2011-08-29,3,0,8,4,0,3,3,7.333333333333333
5658,2011-08-29,3,0,8,5,0,17,17,8.666666666666666
5659,2011-08-29,3,0,8,6,3,99,102,40.666666666666664
5660,2011-08-29,3,0,8,7,11,273,284,134.33333333333334
5661,2011-08-29,3,0,8,8,20,384,404,263.3333333333333
5662,2011-08-29,3,0,8,9,22,166,188,292.0
5663,2011-08-29,3,0,8,10,42,73,115,235.66666666666666
5664,2011-08-29,3,0,8,11,38,100,138,147.0
5665,2011-08-29,3,0,8,12,48,159,207,153.33333333333334
5666,2011-08-29,3,0,8,13,48,170,218,187.66666666666666
5667,2011-08-29,3,0,8,14,55,127,182,202.33333333333334
5668,2011-08-29,3,0,8,15,56,164,220,206.66666666666666
5669,2011-08-29,3,0,8,16,56,226,282,228.0
5670,2011-08-29,3,0,8,17,67,524,591,364.3333333333333
5671,2011-08-29,3,0,8,18,60,487,547,473.3333333333333
5672,2011-08-29,3,0,8,19,50,317,367,501.6666666666667
5673,2011-08-29,3,0,8,20,50,227,277,397.0
5674,2011-08-29,3,0,8,21,34,168,202,282.0
5675,2011-08-29,3,0,8,22,23,119,142,207.0
5676,2011-08-29,3,0,8,23,19,56,75,139.66666666666666
5677,2011-08-30,3,0,8,0,10,17,27,81.33333333333333
5678,2011-08-30,3,0,8,1,6,7,13,38.333333333333336
5679,2011-08-30,3,0,8,2,2,8,10,16.666666666666668
5680,2011-08-30,3,0,8,3,2,2,4,9.0
5681,2011-08-30,3,0,8,4,0,6,6,6.666666666666667
5682,2011-08-30,3,0,8,5,1,27,28,12.666666666666666
5683,2011-08-30,3,0,8,6,4,115,119,51.0
5684,2011-08-30,3,0,8,7,19,338,357,168.0
5685,2011-08-30,3,0,8,8,34,459,493,323.0
5686,2011-08-30,3,0,8,9,38,180,218,356.0
5687,2011-08-30,3,0,8,10,28,109,137,282.6666666666667
5688,2011-08-30,3,0,8,11,60,115,175,176.66666666666666
5689,2011-08-30,3,0,8,12,65,172,237,183.0
5690,2011-08-30,3,0,8,13,59,170,229,213.66666666666666
5691,2011-08-30,3,0,8,14,58,151,209,225.0
5692,2011-08-30,3,0,8,15,34,162,196,211.33333333333334
5693,2011-08-30,3,0,8,16,42,295,337,247.33333333333334
5694,2011-08-30,3,0,8,17,62,549,611,381.3333333333333
5695,2011-08-30,3,0,8,18,60,516,576,508.0
5696,2011-08-30,3,0,8,19,68,397,465,550.6666666666666
5697,2011-08-30,3,0,8,20,39,259,298,446.3333333333333
5698,2011-08-30,3,0,8,21,43,180,223,328.6666666666667
5699,2011-08-30,3,0,8,22,22,121,143,221.33333333333334
5700,2011-08-30,3,0,8,23,19,74,93,153.0
5701,2011-08-31,3,0,8,0,8,24,32,89.33333333333333
5702,2011-08-31,3,0,8,1,2,13,15,46.666666666666664
5703,2011-08-31,3,0,8,2,1,5,6,17.666666666666668
5704,2011-08-31,3,0,8,3,2,4,6,9.0
5705,2011-08-31,3,0,8,4,0,5,5,5.666666666666667
5706,2011-08-31,3,0,8,5,2,25,27,12.666666666666666
5707,2011-08-31,3,0,8,6,4,107,111,47.666666666666664
5708,2011-08-31,3,0,8,7,12,316,328,155.33333333333334
5709,2011-08-31,3,0,8,8,27,440,467,302.0
5710,2011-08-31,3,0,8,9,27,217,244,346.3333333333333
5711,2011-08-31,3,0,8,10,33,105,138,283.0
5712,2011-08-31,3,0,8,11,28,143,171,184.33333333333334
5713,2011-08-31,3,0,8,12,68,192,260,189.66666666666666
5714,2011-08-31,3,0,8,13,39,182,221,217.33333333333334
5715,2011-08-31,3,0,8,14,48,148,196,225.66666666666666
5716,2011-08-31,3,0,8,15,34,138,172,196.33333333333334
5717,2011-08-31,3,0,8,16,46,263,309,225.66666666666666
5718,2011-08-31,3,0,8,17,83,525,608,363.0
5719,2011-08-31,3,0,8,18,70,495,565,494.0
5720,2011-08-31,3,0,8,19,53,393,446,539.6666666666666
5721,2011-08-31,3,0,8,20,30,259,289,433.3333333333333
5722,2011-08-31,3,0,8,21,27,174,201,312.0
5723,2011-08-31,3,0,8,22,20,137,157,215.66666666666666
5724,2011-08-31,3,0,8,23,24,60,84,147.33333333333334
5725,2011-09-01,3,0,9,0,18,33,51,97.33333333333333
5726,2011-09-01,3,0,9,1,7,14,21,52.0
5727,2011-09-01,3,0,9,2,14,11,25,32.333333333333336
5728,2011-09-01,3,0,9,3,7,7,14,20.0
5729,2011-09-01,3,0,9,4,0,7,7,15.333333333333334
5730,2011-09-01,3,0,9,5,1,22,23,14.666666666666666
5731,2011-09-01,3,0,9,6,2,103,105,45.0
5732,2011-09-01,3,0,9,7,7,335,342,156.66666666666666
5733,2011-09-01,3,0,9,8,31,467,498,315.0
5734,2011-09-01,3,0,9,9,29,178,207,349.0
5735,2011-09-01,3,0,9,10,46,92,138,281.0
5736,2011-09-01,3,0,9,11,51,141,192,179.0
5737,2011-09-01,3,0,9,12,64,165,229,186.33333333333334
5738,2011-09-01,3,0,9,13,50,169,219,213.33333333333334
5739,2011-09-01,3,0,9,14,54,144,198,215.33333333333334
5740,2011-09-01,3,0,9,15,39,135,174,197.0
5741,2011-09-01,3,0,9,16,55,253,308,226.66666666666666
5742,2011-09-01,3,0,9,17,61,567,628,370.0
5743,2011-09-01,3,0,9,18,69,462,531,489.0
5744,2011-09-01,3,0,9,19,79,364,443,534.0
5745,2011-09-01,3,0,9,20,33,247,280,418.0
5746,2011-09-01,3,0,9,21,17,160,177,300.0
5747,2011-09-01,3,0,9,22,34,145,179,212.0
5748,2011-09-01,3,0,9,23,15,111,126,160.66666666666666
5749,2011-09-02,3,0,9,0,6,58,64,123.0
5750,2011-09-02,3,0,9,1,4,28,32,74.0
5751,2011-09-02,3,0,9,2,9,11,20,38.666666666666664
5752,2011-09-02,3,0,9,3,4,4,8,20.0
5753,2011-09-02,3,0,9,4,2,2,4,10.666666666666666
5754,2011-09-02,3,0,9,5,0,20,20,10.666666666666666
5755,2011-09-02,3,0,9,6,3,73,76,33.333333333333336
5756,2011-09-02,3,0,9,7,6,253,259,118.33333333333333
5757,2011-09-02,3,0,9,8,22,434,456,263.6666666666667
5758,2011-09-02,3,0,9,9,30,190,220,311.6666666666667
5759,2011-09-02,3,0,9,10,34,106,140,272.0
5760,2011-09-02,3,0,9,11,51,141,192,184.0
5761,2011-09-02,3,0,9,12,82,178,260,197.33333333333334
5762,2011-09-02,3,0,9,13,72,207,279,243.66666666666666
5763,2011-09-02,3,0,9,14,75,208,283,274.0
5764,2011-09-02,3,0,9,15,69,277,346,302.6666666666667
5765,2011-09-02,3,0,9,16,82,299,381,336.6666666666667
5766,2011-09-02,3,0,9,17,78,377,455,394.0
5767,2011-09-02,3,0,9,18,50,305,355,397.0
5768,2011-09-02,3,0,9,19,67,220,287,365.6666666666667
5769,2011-09-02,3,0,9,20,38,158,196,279.3333333333333
5770,2011-09-02,3,0,9,21,28,121,149,210.66666666666666
5771,2011-09-02,3,0,9,22,33,114,147,164.0
5772,2011-09-02,3,0,9,23,30,68,98,131.33333333333334
5773,2011-09-03,3,0,9,0,22,65,87,110.66666666666667
5774,2011-09-03,3,0,9,1,17,57,74,86.33333333333333
5775,2011-09-03,3,0,9,2,15,26,41,67.33333333333333
5776,2011-09-03,3,0,9,3,17,18,35,50.0
5777,2011-09-03,3,0,9,4,3,4,7,27.666666666666668
5778,2011-09-03,3,0,9,5,3,9,12,18.0
5779,2011-09-03,3,0,9,6,4,19,23,14.0
5780,2011-09-03,3,0,9,7,5,33,38,24.333333333333332
5781,2011-09-03,3,0,9,8,24,65,89,50.0
5782,2011-09-03,3,0,9,9,83,118,201,109.33333333333333
5783,2011-09-03,3,0,9,10,90,168,258,182.66666666666666
5784,2011-09-03,3,0,9,11,66,128,194,217.66666666666666
5785,2011-09-03,3,0,9,12,97,160,257,236.33333333333334
5786,2011-09-03,3,0,9,13,153,200,353,268.0
5787,2011-09-03,3,0,9,14,204,176,380,330.0
5788,2011-09-03,3,0,9,15,187,201,388,373.6666666666667
5789,2011-09-03,3,0,9,16,186,188,374,380.6666666666667
5790,2011-09-03,3,0,9,17,170,201,371,377.6666666666667
5791,2011-09-03,3,0,9,18,160,179,339,361.3333333333333
5792,2011-09-03,3,0,9,19,147,148,295,335.0
5793,2011-09-03,3,0,9,20,99,120,219,284.3333333333333
5794,2011-09-03,3,0,9,21,71,93,164,226.0
5795,2011-09-03,3,0,9,22,66,96,162,181.66666666666666
5796,2011-09-03,3,0,9,23,46,77,123,149.66666666666666
5797,2011-09-04,3,0,9,0,33,76,109,131.33333333333334
5798,2011-09-04,3,0,9,1,37,38,75,102.33333333333333
5799,2011-09-04,3,0,9,2,17,43,60,81.33333333333333
5800,2011-09-04,3,0,9,3,20,23,43,59.333333333333336
5801,2011-09-04,3,0,9,4,0,4,4,35.666666666666664
5802,2011-09-04,3,0,9,5,1,5,6,17.666666666666668
5803,2011-09-04,3,0,9,6,0,3,3,4.333333333333333
5804,2011-09-04,3,0,9,7,10,20,30,13.0
5805,2011-09-04,3,0,9,8,21,49,70,34.333333333333336
5806,2011-09-04,3,0,9,9,87,102,189,96.33333333333333
5807,2011-09-04,3,0,9,10,150,147,297,185.33333333333334
5808,2011-09-04,3,0,9,11,174,163,337,274.3333333333333
5809,2011-09-04,3,0,9,12,214,221,435,356.3333333333333
5810,2011-09-04,3,0,9,13,245,174,419,397.0
5811,2011-09-04,3,0,9,14,205,156,361,405.0
5812,2011-09-04,3,0,9,15,218,192,410,396.6666666666667
5813,2011-09-04,3,0,9,16,196,141,337,369.3333333333333
5814,2011-09-04,3,0,9,17,204,172,376,374.3333333333333
5815,2011-09-04,3,0,9,18,187,169,356,356.3333333333333
5816,2011-09-04,3,0,9,19,178,150,328,353.3333333333333
5817,2011-09-04,3,0,9,20,104,125,229,304.3333333333333
5818,2011-09-04,3,0,9,21,104,103,207,254.66666666666666
5819,2011-09-04,3,0,9,22,70,85,155,197.0
5820,2011-09-04,3,0,9,23,46,58,104,155.33333333333334
5821,2011-09-05,3,0,9,0,31,66,97,118.66666666666667
5822,2011-09-05,3,0,9,1,19,35,54,85.0
5823,2011-09-05,3,0,9,2,17,22,39,63.333333333333336
5824,2011-09-05,3,0,9,3,4,12,16,36.333333333333336
5825,2011-09-05,3,0,9,4,3,5,8,21.0
5826,2011-09-05,3,0,9,5,2,4,6,10.0
5827,2011-09-05,3,0,9,6,6,5,11,8.333333333333334
5828,2011-09-05,3,0,9,7,11,30,41,19.333333333333332
5829,2011-09-05,3,0,9,8,45,56,101,51.0
5830,2011-09-05,3,0,9,9,63,89,152,98.0
5831,2011-09-05,3,0,9,10,107,137,244,165.66666666666666
5832,2011-09-05,3,0,9,11,101,207,308,234.66666666666666
5833,2011-09-05,3,0,9,12,141,212,353,301.6666666666667
5834,2011-09-05,3,0,9,13,154,235,389,350.0
5835,2011-09-05,3,0,9,14,145,212,357,366.3333333333333
5836,2011-09-05,3,0,9,15,111,142,253,333.0
5837,2011-09-05,3,0,9,16,92,192,284,298.0
5838,2011-09-05,3,0,9,17,37,77,114,217.0
5839,2011-09-05,3,0,9,18,31,92,123,173.66666666666666
5840,2011-09-05,3,0,9,19,52,123,175,137.33333333333334
5841,2011-09-05,3,0,9,20,26,56,82,126.66666666666667
5842,2011-09-05,3,0,9,21,20,40,60,105.66666666666667
5843,2011-09-05,3,0,9,22,15,49,64,68.66666666666667
5844,2011-09-05,3,0,9,23,3,17,20,48.0
5845,2011-09-06,3,0,9,0,1,7,8,30.666666666666668
5846,2011-09-06,3,0,9,2,0,2,2,10.0
5847,2011-09-06,3,0,9,3,1,0,1,3.6666666666666665
5848,2011-09-06,3,0,9,4,1,3,4,2.3333333333333335
5849,2011-09-06,3,0,9,5,1,20,21,8.666666666666666
5850,2011-09-06,3,0,9,6,0,72,72,32.333333333333336
5851,2011-09-06,3,0,9,7,6,166,172,88.33333333333333
5852,2011-09-06,3,0,9,8,15,349,364,202.66666666666666
5853,2011-09-06,3,0,9,9,18,167,185,240.33333333333334
5854,2011-09-06,3,0,9,10,16,90,106,218.33333333333334
5855,2011-09-06,3,0,9,11,11,78,89,126.66666666666667
5856,2011-09-06,3,0,9,12,16,51,67,87.33333333333333
5857,2011-09-06,3,0,9,13,5,24,29,61.666666666666664
5858,2011-09-06,3,0,9,14,3,21,24,40.0
5859,2011-09-06,3,0,9,15,18,71,89,47.333333333333336
5860,2011-09-06,3,0,9,16,11,95,106,73.0
5861,2011-09-06,3,0,9,17,15,276,291,162.0
5862,2011-09-06,3,0,9,18,22,351,373,256.6666666666667
5863,2011-09-06,3,0,9,19,12,269,281,315.0
5864,2011-09-06,3,0,9,20,13,150,163,272.3333333333333
5865,2011-09-06,3,0,9,21,12,109,121,188.33333333333334
5866,2011-09-06,3,0,9,22,5,79,84,122.66666666666667
5867,2011-09-06,3,0,9,23,2,56,58,87.66666666666667
5868,2011-09-07,3,0,9,0,1,12,13,51.666666666666664
5869,2011-09-07,3,0,9,1,2,3,5,25.333333333333332
5870,2011-09-07,3,0,9,2,2,4,6,8.0
5871,2011-09-07,3,0,9,3,1,1,2,4.333333333333333
5872,2011-09-07,3,0,9,4,0,4,4,4.0
5873,2011-09-07,3,0,9,5,1,15,16,7.333333333333333
5874,2011-09-07,3,0,9,6,1,74,75,31.666666666666668
5875,2011-09-07,3,0,9,7,3,83,86,59.0
5876,2011-09-07,3,0,9,8,9,319,328,163.0
5877,2011-09-07,3,0,9,9,14,176,190,201.33333333333334
5878,2011-09-07,3,0,9,10,3,63,66,194.66666666666666
5879,2011-09-07,3,0,9,11,1,9,10,88.66666666666667
5880,2011-09-07,3,0,9,12,1,21,22,32.666666666666664
5881,2011-09-07,3,0,9,13,2,9,11,14.333333333333334
5882,2011-09-07,3,0,9,14,1,24,25,19.333333333333332
5883,2011-09-07,3,0,9,15,3,55,58,31.333333333333332
5884,2011-09-07,3,0,9,16,7,137,144,75.66666666666667
5885,2011-09-07,3,0,9,17,21,264,285,162.33333333333334
5886,2011-09-07,3,0,9,18,18,219,237,222.0
5887,2011-09-07,3,0,9,19,14,212,226,249.33333333333334
5888,2011-09-07,3,0,9,20,3,93,96,186.33333333333334
5889,2011-09-07,3,0,9,21,4,34,38,120.0
5890,2011-09-07,3,0,9,22,3,26,29,54.333333333333336
5891,2011-09-07,3,0,9,23,3,21,24,30.333333333333332
5892,2011-09-08,3,0,9,0,3,11,14,22.333333333333332
5893,2011-09-08,3,0,9,1,0,4,4,14.0
5894,2011-09-08,3,0,9,3,0,2,2,6.666666666666667
5895,2011-09-08,3,0,9,4,0,3,3,3.0
5896,2011-09-08,3,0,9,5,1,13,14,6.333333333333333
5897,2011-09-08,3,0,9,6,1,55,56,24.333333333333332
5898,2011-09-08,3,0,9,7,7,172,179,83.0
5899,2011-09-08,3,0,9,8,7,188,195,143.33333333333334
5900,2011-09-08,3,0,9,9,4,65,69,147.66666666666666
5901,2011-09-08,3,0,9,10,8,57,65,109.66666666666667
5902,2011-09-08,3,0,9,11,16,82,98,77.33333333333333
5903,2011-09-08,3,0,9,12,17,85,102,88.33333333333333
5904,2011-09-08,3,0,9,13,14,112,126,108.66666666666667
5905,2011-09-08,3,0,9,14,15,105,120,116.0
5906,2011-09-08,3,0,9,15,24,115,139,128.33333333333334
5907,2011-09-08,3,0,9,16,5,151,156,138.33333333333334
5908,2011-09-08,3,0,9,17,11,102,113,136.0
5909,2011-09-08,3,0,9,18,2,66,68,112.33333333333333
5910,2011-09-08,3,0,9,19,1,51,52,77.66666666666667
5911,2011-09-08,3,0,9,20,6,83,89,69.66666666666667
5912,2011-09-08,3,0,9,21,6,76,82,74.33333333333333
5913,2011-09-08,3,0,9,22,5,65,70,80.33333333333333
5914,2011-09-08,3,0,9,23,0,26,26,59.333333333333336
5915,2011-09-09,3,0,9,0,1,15,16,37.333333333333336
5916,2011-09-09,3,0,9,1,0,8,8,16.666666666666668
5917,2011-09-09,3,0,9,2,1,7,8,10.666666666666666
5918,2011-09-09,3,0,9,3,1,1,2,6.0
5919,2011-09-09,3,0,9,4,0,3,3,4.333333333333333
5920,2011-09-09,3,0,9,5,0,14,14,6.333333333333333
5921,2011-09-09,3,0,9,6,3,54,57,24.666666666666668
5922,2011-09-09,3,0,9,7,4,104,108,59.666666666666664
5923,2011-09-09,3,0,9,8,12,276,288,151.0
5924,2011-09-09,3,0,9,9,5,131,136,177.33333333333334
5925,2011-09-09,3,0,9,10,2,27,29,151.0
5926,2011-09-09,3,0,9,11,6,66,72,79.0
5927,2011-09-09,3,0,9,12,4,71,75,58.666666666666664
5928,2011-09-09,3,0,9,13,14,108,122,89.66666666666667
5929,2011-09-09,3,0,9,14,29,119,148,115.0
5930,2011-09-09,3,0,9,15,27,161,188,152.66666666666666
5931,2011-09-09,3,0,9,16,41,244,285,207.0
5932,2011-09-09,3,0,9,17,54,451,505,326.0
5933,2011-09-09,3,0,9,18,33,377,410,400.0
5934,2011-09-09,3,0,9,19,33,316,349,421.3333333333333
5935,2011-09-09,3,0,9,20,30,180,210,323.0
5936,2011-09-09,3,0,9,21,49,154,203,254.0
5937,2011-09-09,3,0,9,22,33,127,160,191.0
5938,2011-09-09,3,0,9,23,35,113,148,170.33333333333334
5939,2011-09-10,3,0,9,0,32,84,116,141.33333333333334
5940,2011-09-10,3,0,9,1,16,67,83,115.66666666666667
5941,2011-09-10,3,0,9,2,18,46,64,87.66666666666667
5942,2011-09-10,3,0,9,3,8,29,37,61.333333333333336
5943,2011-09-10,3,0,9,4,3,4,7,36.0
5944,2011-09-10,3,0,9,5,2,6,8,17.333333333333332
5945,2011-09-10,3,0,9,6,0,6,6,7.0
5946,2011-09-10,3,0,9,7,9,43,52,22.0
5947,2011-09-10,3,0,9,8,16,103,119,59.0
5948,2011-09-10,3,0,9,9,39,168,207,126.0
5949,2011-09-10,3,0,9,10,85,233,318,214.66666666666666
5950,2011-09-10,3,0,9,11,108,252,360,295.0
5951,2011-09-10,3,0,9,12,144,260,404,360.6666666666667
5952,2011-09-10,3,0,9,13,131,239,370,378.0
5953,2011-09-10,3,0,9,14,129,230,359,377.6666666666667
5954,2011-09-10,3,0,9,15,217,263,480,403.0
5955,2011-09-10,3,0,9,16,170,261,431,423.3333333333333
5956,2011-09-10,3,0,9,17,185,275,460,457.0
5957,2011-09-10,3,0,9,18,119,241,360,417.0
5958,2011-09-10,3,0,9,19,101,214,315,378.3333333333333
5959,2011-09-10,3,0,9,20,78,167,245,306.6666666666667
5960,2011-09-10,3,0,9,21,59,171,230,263.3333333333333
5961,2011-09-10,3,0,9,22,49,126,175,216.66666666666666
5962,2011-09-10,3,0,9,23,32,107,139,181.33333333333334
5963,2011-09-11,3,0,9,0,29,79,108,140.66666666666666
5964,2011-09-11,3,0,9,1,22,66,88,111.66666666666667
5965,2011-09-11,3,0,9,2,16,60,76,90.66666666666667
5966,2011-09-11,3,0,9,3,15,30,45,69.66666666666667
5967,2011-09-11,3,0,9,4,3,6,9,43.333333333333336
5968,2011-09-11,3,0,9,5,15,24,39,31.0
5969,2011-09-11,3,0,9,6,4,16,20,22.666666666666668
5970,2011-09-11,3,0,9,7,9,28,37,32.0
5971,2011-09-11,3,0,9,8,25,69,94,50.333333333333336
5972,2011-09-11,3,0,9,9,59,168,227,119.33333333333333
5973,2011-09-11,3,0,9,10,120,214,334,218.33333333333334
5974,2011-09-11,3,0,9,11,144,258,402,321.0
5975,2011-09-11,3,0,9,12,113,298,411,382.3333333333333
5976,2011-09-11,3,0,9,13,119,231,350,387.6666666666667
5977,2011-09-11,3,0,9,14,120,222,342,367.6666666666667
5978,2011-09-11,3,0,9,15,134,270,404,365.3333333333333
5979,2011-09-11,3,0,9,16,180,303,483,409.6666666666667
5980,2011-09-11,3,0,9,17,152,228,380,422.3333333333333
5981,2011-09-11,3,0,9,18,110,229,339,400.6666666666667
5982,2011-09-11,3,0,9,19,101,232,333,350.6666666666667
5983,2011-09-11,3,0,9,20,65,161,226,299.3333333333333
5984,2011-09-11,3,0,9,21,45,114,159,239.33333333333334
5985,2011-09-11,3,0,9,22,21,74,95,160.0
5986,2011-09-11,3,0,9,23,12,33,45,99.66666666666667
5987,2011-09-12,3,0,9,0,5,11,16,52.0
5988,2011-09-12,3,0,9,1,1,11,12,24.333333333333332
5989,2011-09-12,3,0,9,2,2,0,2,10.0
5990,2011-09-12,3,0,9,4,0,4,4,6.0
5991,2011-09-12,3,0,9,5,1,23,24,10.0
5992,2011-09-12,3,0,9,6,1,108,109,45.666666666666664
5993,2011-09-12,3,0,9,7,12,300,312,148.33333333333334
5994,2011-09-12,3,0,9,8,26,382,408,276.3333333333333
5995,2011-09-12,3,0,9,9,21,155,176,298.6666666666667
5996,2011-09-12,3,0,9,10,40,89,129,237.66666666666666
5997,2011-09-12,3,0,9,11,34,131,165,156.66666666666666
5998,2011-09-12,3,0,9,12,37,147,184,159.33333333333334
5999,2011-09-12,3,0,9,13,43,120,163,170.66666666666666
6000,2011-09-12,3,0,9,14,60,129,189,178.66666666666666
6001,2011-09-12,3,0,9,15,60,152,212,188.0
6002,2011-09-12,3,0,9,16,60,238,298,233.0
6003,2011-09-12,3,0,9,17,75,515,590,366.6666666666667
6004,2011-09-12,3,0,9,18,56,515,571,486.3333333333333
6005,2011-09-12,3,0,9,19,63,373,436,532.3333333333334
6006,2011-09-12,3,0,9,20,41,258,299,435.3333333333333
6007,2011-09-12,3,0,9,21,29,166,195,310.0
6008,2011-09-12,3,0,9,22,16,134,150,214.66666666666666
6009,2011-09-12,3,0,9,23,7,62,69,138.0
6010,2011-09-13,3,0,9,0,7,19,26,81.66666666666667
6011,2011-09-13,3,0,9,1,4,6,10,35.0
6012,2011-09-13,3,0,9,2,2,0,2,12.666666666666666
6013,2011-09-13,3,0,9,3,2,2,4,5.333333333333333
6014,2011-09-13,3,0,9,4,2,6,8,4.666666666666667
6015,2011-09-13,3,0,9,5,1,19,20,10.666666666666666
6016,2011-09-13,3,0,9,6,6,116,122,50.0
6017,2011-09-13,3,0,9,7,14,348,362,168.0
6018,2011-09-13,3,0,9,8,26,399,425,303.0
6019,2011-09-13,3,0,9,9,35,179,214,333.6666666666667
6020,2011-09-13,3,0,9,10,42,93,135,258.0
6021,2011-09-13,3,0,9,11,33,120,153,167.33333333333334
6022,2011-09-13,3,0,9,12,43,144,187,158.33333333333334
6023,2011-09-13,3,0,9,13,48,136,184,174.66666666666666
6024,2011-09-13,3,0,9,14,51,139,190,187.0
6025,2011-09-13,3,0,9,15,35,145,180,184.66666666666666
6026,2011-09-13,3,0,9,16,41,251,292,220.66666666666666
6027,2011-09-13,3,0,9,17,72,507,579,350.3333333333333
6028,2011-09-13,3,0,9,18,67,472,539,470.0
6029,2011-09-13,3,0,9,19,55,341,396,504.6666666666667
6030,2011-09-13,3,0,9,20,31,241,272,402.3333333333333
6031,2011-09-13,3,0,9,21,45,200,245,304.3333333333333
6032,2011-09-13,3,0,9,22,24,120,144,220.33333333333334
6033,2011-09-13,3,0,9,23,15,59,74,154.33333333333334
6034,2011-09-14,3,0,9,0,5,28,33,83.66666666666667
6035,2011-09-14,3,0,9,1,1,7,8,38.333333333333336
6036,2011-09-14,3,0,9,2,1,4,5,15.333333333333334
6037,2011-09-14,3,0,9,3,1,7,8,7.0
6038,2011-09-14,3,0,9,4,1,8,9,7.333333333333333
6039,2011-09-14,3,0,9,5,1,30,31,16.0
6040,2011-09-14,3,0,9,6,7,138,145,61.666666666666664
6041,2011-09-14,3,0,9,7,20,350,370,182.0
6042,2011-09-14,3,0,9,8,33,396,429,314.6666666666667
6043,2011-09-14,3,0,9,9,19,183,202,333.6666666666667
6044,2011-09-14,3,0,9,10,27,115,142,257.6666666666667
6045,2011-09-14,3,0,9,11,43,121,164,169.33333333333334
6046,2011-09-14,3,0,9,12,56,156,212,172.66666666666666
6047,2011-09-14,3,0,9,13,39,139,178,184.66666666666666
6048,2011-09-14,3,0,9,14,19,105,124,171.33333333333334
6049,2011-09-14,3,0,9,15,30,146,176,159.33333333333334
6050,2011-09-14,3,0,9,16,36,241,277,192.33333333333334
6051,2011-09-14,3,0,9,17,87,512,599,350.6666666666667
6052,2011-09-14,3,0,9,18,83,503,586,487.3333333333333
6053,2011-09-14,3,0,9,19,44,337,381,522.0
6054,2011-09-14,3,0,9,20,40,221,261,409.3333333333333
6055,2011-09-14,3,0,9,21,24,189,213,285.0
6056,2011-09-14,3,0,9,22,20,140,160,211.33333333333334
6057,2011-09-14,3,0,9,23,10,62,72,148.33333333333334
6058,2011-09-15,3,0,9,0,3,34,37,89.66666666666667
6059,2011-09-15,3,0,9,1,0,20,20,43.0
6060,2011-09-15,3,0,9,2,0,5,5,20.666666666666668
6061,2011-09-15,3,0,9,3,3,5,8,11.0
6062,2011-09-15,3,0,9,4,2,5,7,6.666666666666667
6063,2011-09-15,3,0,9,5,1,30,31,15.333333333333334
6064,2011-09-15,3,0,9,6,5,119,124,54.0
6065,2011-09-15,3,0,9,7,17,321,338,164.33333333333334
6066,2011-09-15,3,0,9,8,27,364,391,284.3333333333333
6067,2011-09-15,3,0,9,9,23,186,209,312.6666666666667
6068,2011-09-15,3,0,9,10,25,96,121,240.33333333333334
6069,2011-09-15,3,0,9,11,39,120,159,163.0
6070,2011-09-15,3,0,9,12,31,148,179,153.0
6071,2011-09-15,3,0,9,13,38,151,189,175.66666666666666
6072,2011-09-15,3,0,9,14,36,134,170,179.33333333333334
6073,2011-09-15,3,0,9,15,25,110,135,164.66666666666666
6074,2011-09-15,3,0,9,16,29,193,222,175.66666666666666
6075,2011-09-15,3,0,9,17,31,230,261,206.0
6076,2011-09-15,3,0,9,18,22,222,244,242.33333333333334
6077,2011-09-15,3,0,9,19,20,212,232,245.66666666666666
6078,2011-09-15,3,0,9,20,25,223,248,241.33333333333334
6079,2011-09-15,3,0,9,21,11,134,145,208.33333333333334
6080,2011-09-15,3,0,9,22,7,108,115,169.33333333333334
6081,2011-09-15,3,0,9,23,8,61,69,109.66666666666667
6082,2011-09-16,3,0,9,0,5,43,48,77.33333333333333
6083,2011-09-16,3,0,9,1,7,19,26,47.666666666666664
6084,2011-09-16,3,0,9,2,3,7,10,28.0
6085,2011-09-16,3,0,9,3,2,4,6,14.0
6086,2011-09-16,3,0,9,4,1,3,4,6.666666666666667
6087,2011-09-16,3,0,9,5,2,30,32,14.0
6088,2011-09-16,3,0,9,6,6,87,93,43.0
6089,2011-09-16,3,0,9,7,16,283,299,141.33333333333334
6090,2011-09-16,3,0,9,8,23,386,409,267.0
6091,2011-09-16,3,0,9,9,21,189,210,306.0
6092,2011-09-16,3,0,9,10,36,104,140,253.0
6093,2011-09-16,3,0,9,11,40,139,179,176.33333333333334
6094,2011-09-16,3,0,9,12,39,212,251,190.0
6095,2011-09-16,3,0,9,13,55,168,223,217.66666666666666
6096,2011-09-16,3,0,9,14,49,176,225,233.0
6097,2011-09-16,3,0,9,15,38,165,203,217.0
6098,2011-09-16,3,0,9,16,67,291,358,262.0
6099,2011-09-16,3,0,9,17,86,480,566,375.6666666666667
6100,2011-09-16,3,0,9,18,55,427,482,468.6666666666667
6101,2011-09-16,3,0,9,19,59,256,315,454.3333333333333
6102,2011-09-16,3,0,9,20,41,184,225,340.6666666666667
6103,2011-09-16,3,0,9,21,39,124,163,234.33333333333334
6104,2011-09-16,3,0,9,22,32,135,167,185.0
6105,2011-09-16,3,0,9,23,20,106,126,152.0
6106,2011-09-17,3,0,9,0,28,80,108,133.66666666666666
6107,2011-09-17,3,0,9,1,28,52,80,104.66666666666667
6108,2011-09-17,3,0,9,2,18,61,79,89.0
6109,2011-09-17,3,0,9,3,7,21,28,62.333333333333336
6110,2011-09-17,3,0,9,4,1,4,5,37.333333333333336
6111,2011-09-17,3,0,9,5,2,3,5,12.666666666666666
6112,2011-09-17,3,0,9,6,5,17,22,10.666666666666666
6113,2011-09-17,3,0,9,7,4,33,37,21.333333333333332
6114,2011-09-17,3,0,9,8,27,81,108,55.666666666666664
6115,2011-09-17,3,0,9,9,32,145,177,107.33333333333333
6116,2011-09-17,3,0,9,10,72,177,249,178.0
6117,2011-09-17,3,0,9,11,119,248,367,264.3333333333333
6118,2011-09-17,3,0,9,12,115,257,372,329.3333333333333
6119,2011-09-17,3,0,9,13,124,225,349,362.6666666666667
6120,2011-09-17,3,0,9,14,123,174,297,339.3333333333333
6121,2011-09-17,3,0,9,15,148,206,354,333.3333333333333
6122,2011-09-17,3,0,9,16,116,189,305,318.6666666666667
6123,2011-09-17,3,0,9,17,141,218,359,339.3333333333333
6124,2011-09-17,3,0,9,18,95,234,329,331.0
6125,2011-09-17,3,0,9,19,70,186,256,314.6666666666667
6126,2011-09-17,3,0,9,20,43,133,176,253.66666666666666
6127,2011-09-17,3,0,9,21,49,121,170,200.66666666666666
6128,2011-09-17,3,0,9,22,31,112,143,163.0
6129,2011-09-17,3,0,9,23,36,100,136,149.66666666666666
6130,2011-09-18,3,0,9,0,24,88,112,130.33333333333334
6131,2011-09-18,3,0,9,1,13,66,79,109.0
6132,2011-09-18,3,0,9,2,21,68,89,93.33333333333333
6133,2011-09-18,3,0,9,3,11,25,36,68.0
6134,2011-09-18,3,0,9,4,1,0,1,42.0
6135,2011-09-18,3,0,9,5,1,5,6,14.333333333333334
6136,2011-09-18,3,0,9,6,2,10,12,6.333333333333333
6137,2011-09-18,3,0,9,7,15,29,44,20.666666666666668
6138,2011-09-18,3,0,9,8,16,53,69,41.666666666666664
6139,2011-09-18,3,0,9,9,46,94,140,84.33333333333333
6140,2011-09-18,3,0,9,10,82,178,260,156.33333333333334
6141,2011-09-18,3,0,9,11,116,201,317,239.0
6142,2011-09-18,3,0,9,12,135,229,364,313.6666666666667
6143,2011-09-18,3,0,9,13,162,214,376,352.3333333333333
6144,2011-09-18,3,0,9,14,127,184,311,350.3333333333333
6145,2011-09-18,3,0,9,15,132,233,365,350.6666666666667
6146,2011-09-18,3,0,9,16,134,235,369,348.3333333333333
6147,2011-09-18,3,0,9,17,95,230,325,353.0
6148,2011-09-18,3,0,9,18,66,223,289,327.6666666666667
6149,2011-09-18,3,0,9,19,54,191,245,286.3333333333333
6150,2011-09-18,3,0,9,20,44,136,180,238.0
6151,2011-09-18,3,0,9,21,37,110,147,190.66666666666666
6152,2011-09-18,3,0,9,22,9,75,84,137.0
6153,2011-09-18,3,0,9,23,10,44,54,95.0
6154,2011-09-19,3,0,9,0,14,23,37,58.333333333333336
6155,2011-09-19,3,0,9,1,3,7,10,33.666666666666664
6156,2011-09-19,3,0,9,2,6,7,13,20.0
6157,2011-09-19,3,0,9,3,1,4,5,9.333333333333334
6158,2011-09-19,3,0,9,4,2,6,8,8.666666666666666
6159,2011-09-19,3,0,9,5,2,26,28,13.666666666666666
6160,2011-09-19,3,0,9,6,6,107,113,49.666666666666664
6161,2011-09-19,3,0,9,7,20,312,332,157.66666666666666
6162,2011-09-19,3,0,9,8,29,391,420,288.3333333333333
6163,2011-09-19,3,0,9,9,32,183,215,322.3333333333333
6164,2011-09-19,3,0,9,10,21,84,105,246.66666666666666
6165,2011-09-19,3,0,9,11,41,98,139,153.0
6166,2011-09-19,3,0,9,12,51,138,189,144.33333333333334
6167,2011-09-19,3,0,9,13,53,124,177,168.33333333333334
6168,2011-09-19,3,0,9,14,45,143,188,184.66666666666666
6169,2011-09-19,3,0,9,15,44,143,187,184.0
6170,2011-09-19,3,0,9,16,55,208,263,212.66666666666666
6171,2011-09-19,3,0,9,17,85,483,568,339.3333333333333
6172,2011-09-19,3,0,9,18,56,484,540,457.0
6173,2011-09-19,3,0,9,19,41,333,374,494.0
6174,2011-09-19,3,0,9,20,27,204,231,381.6666666666667
6175,2011-09-19,3,0,9,21,19,181,200,268.3333333333333
6176,2011-09-19,3,0,9,22,25,104,129,186.66666666666666
6177,2011-09-19,3,0,9,23,13,55,68,132.33333333333334
6178,2011-09-20,3,0,9,0,4,21,25,74.0
6179,2011-09-20,3,0,9,1,3,11,14,35.666666666666664
6180,2011-09-20,3,0,9,2,1,4,5,14.666666666666666
6181,2011-09-20,3,0,9,3,0,3,3,7.333333333333333
6182,2011-09-20,3,0,9,4,2,4,6,4.666666666666667
6183,2011-09-20,3,0,9,5,1,21,22,10.333333333333334
6184,2011-09-20,3,0,9,6,3,111,114,47.333333333333336
6185,2011-09-20,3,0,9,7,23,306,329,155.0
6186,2011-09-20,3,0,9,8,13,196,209,217.33333333333334
6187,2011-09-20,3,0,9,9,5,64,69,202.33333333333334
6188,2011-09-20,3,0,9,10,4,26,30,102.66666666666667
6189,2011-09-20,3,0,9,11,8,48,56,51.666666666666664
6190,2011-09-20,3,0,9,12,13,47,60,48.666666666666664
6191,2011-09-20,3,0,9,13,22,81,103,73.0
6192,2011-09-20,3,0,9,14,27,85,112,91.66666666666667
6193,2011-09-20,3,0,9,15,34,158,192,135.66666666666666
6194,2011-09-20,3,0,9,16,23,241,264,189.33333333333334
6195,2011-09-20,3,0,9,17,66,445,511,322.3333333333333
6196,2011-09-20,3,0,9,18,39,453,492,422.3333333333333
6197,2011-09-20,3,0,9,19,43,294,337,446.6666666666667
6198,2011-09-20,3,0,9,20,41,212,253,360.6666666666667
6199,2011-09-20,3,0,9,21,29,177,206,265.3333333333333
6200,2011-09-20,3,0,9,22,23,125,148,202.33333333333334
6201,2011-09-20,3,0,9,23,11,70,81,145.0
6202,2011-09-21,3,0,9,0,7,20,27,85.33333333333333
6203,2011-09-21,3,0,9,1,0,17,17,41.666666666666664
6204,2011-09-21,3,0,9,2,1,5,6,16.666666666666668
6205,2011-09-21,3,0,9,3,0,6,6,9.666666666666666
6206,2011-09-21,3,0,9,4,2,5,7,6.333333333333333
6207,2011-09-21,3,0,9,5,1,30,31,14.666666666666666
6208,2011-09-21,3,0,9,6,5,112,117,51.666666666666664
6209,2011-09-21,3,0,9,7,18,312,330,159.33333333333334
6210,2011-09-21,3,0,9,8,18,444,462,303.0
6211,2011-09-21,3,0,9,9,21,187,208,333.3333333333333
6212,2011-09-21,3,0,9,10,30,103,133,267.6666666666667
6213,2011-09-21,3,0,9,11,42,138,180,173.66666666666666
6214,2011-09-21,3,0,9,12,42,151,193,168.66666666666666
6215,2011-09-21,3,0,9,13,37,144,181,184.66666666666666
6216,2011-09-21,3,0,9,14,40,139,179,184.33333333333334
6217,2011-09-21,3,0,9,15,43,142,185,181.66666666666666
6218,2011-09-21,3,0,9,16,51,230,281,215.0
6219,2011-09-21,3,0,9,17,61,475,536,334.0
6220,2011-09-21,3,0,9,18,24,384,408,408.3333333333333
6221,2011-09-21,3,0,9,19,30,253,283,409.0
6222,2011-09-21,3,0,9,20,11,149,160,283.6666666666667
6223,2011-09-21,3,0,9,21,25,175,200,214.33333333333334
6224,2011-09-21,3,0,9,22,15,112,127,162.33333333333334
6225,2011-09-21,3,0,9,23,15,80,95,140.66666666666666
6226,2011-09-22,3,0,9,0,11,30,41,87.66666666666667
6227,2011-09-22,3,0,9,1,5,6,11,49.0
6228,2011-09-22,3,0,9,2,2,8,10,20.666666666666668
6229,2011-09-22,3,0,9,3,5,7,12,11.0
6230,2011-09-22,3,0,9,4,0,2,2,8.0
6231,2011-09-22,3,0,9,5,2,28,30,14.666666666666666
6232,2011-09-22,3,0,9,6,7,94,101,44.333333333333336
6233,2011-09-22,3,0,9,7,16,295,311,147.33333333333334
6234,2011-09-22,3,0,9,8,26,389,415,275.6666666666667
6235,2011-09-22,3,0,9,9,35,168,203,309.6666666666667
6236,2011-09-22,3,0,9,10,19,101,120,246.0
6237,2011-09-22,3,0,9,11,23,142,165,162.66666666666666
6238,2011-09-22,3,0,9,12,25,151,176,153.66666666666666
6239,2011-09-22,3,0,9,13,38,155,193,178.0
6240,2011-09-22,3,0,9,14,41,142,183,184.0
6241,2011-09-22,3,0,9,15,32,149,181,185.66666666666666
6242,2011-09-22,3,0,9,16,39,262,301,221.66666666666666
6243,2011-09-22,3,0,9,17,50,513,563,348.3333333333333
6244,2011-09-22,3,0,9,18,50,501,551,471.6666666666667
6245,2011-09-22,3,0,9,19,32,388,420,511.3333333333333
6246,2011-09-22,3,0,9,20,35,250,285,418.6666666666667
6247,2011-09-22,3,0,9,21,27,194,221,308.6666666666667
6248,2011-09-22,3,0,9,22,21,166,187,231.0
6249,2011-09-22,3,0,9,23,14,99,113,173.66666666666666
6250,2011-09-23,4,0,9,0,11,41,52,117.33333333333333
6251,2011-09-23,4,0,9,1,2,29,31,65.33333333333333
6252,2011-09-23,4,0,9,2,6,14,20,34.333333333333336
6253,2011-09-23,4,0,9,3,3,5,8,19.666666666666668
6254,2011-09-23,4,0,9,4,6,7,13,13.666666666666666
6255,2011-09-23,4,0,9,5,2,20,22,14.333333333333334
6256,2011-09-23,4,0,9,6,5,99,104,46.333333333333336
6257,2011-09-23,4,0,9,7,14,240,254,126.66666666666667
6258,2011-09-23,4,0,9,8,20,297,317,225.0
6259,2011-09-23,4,0,9,9,3,108,111,227.33333333333334
6260,2011-09-23,4,0,9,10,7,28,35,154.33333333333334
6261,2011-09-23,4,0,9,11,1,20,21,55.666666666666664
6262,2011-09-23,4,0,9,12,1,28,29,28.333333333333332
6263,2011-09-23,4,0,9,13,7,27,34,28.0
6264,2011-09-23,4,0,9,14,3,21,24,29.0
6265,2011-09-23,4,0,9,15,9,52,61,39.666666666666664
6266,2011-09-23,4,0,9,16,5,51,56,47.0
6267,2011-09-23,4,0,9,17,13,86,99,72.0
6268,2011-09-23,4,0,9,18,14,220,234,129.66666666666666
6269,2011-09-23,4,0,9,19,16,232,248,193.66666666666666
6270,2011-09-23,4,0,9,20,21,158,179,220.33333333333334
6271,2011-09-23,4,0,9,21,17,121,138,188.33333333333334
6272,2011-09-23,4,0,9,22,31,126,157,158.0
6273,2011-09-23,4,0,9,23,41,107,148,147.66666666666666
6274,2011-09-24,4,0,9,0,7,86,93,132.66666666666666
6275,2011-09-24,4,0,9,1,18,61,79,106.66666666666667
6276,2011-09-24,4,0,9,2,14,54,68,80.0
6277,2011-09-24,4,0,9,3,4,27,31,59.333333333333336
6278,2011-09-24,4,0,9,4,1,7,8,35.666666666666664
6279,2011-09-24,4,0,9,5,2,3,5,14.666666666666666
6280,2011-09-24,4,0,9,6,6,12,18,10.333333333333334
6281,2011-09-24,4,0,9,7,12,34,46,23.0
6282,2011-09-24,4,0,9,8,19,102,121,61.666666666666664
6283,2011-09-24,4,0,9,9,41,134,175,114.0
6284,2011-09-24,4,0,9,10,90,203,293,196.33333333333334
6285,2011-09-24,4,0,9,11,118,268,386,284.6666666666667
6286,2011-09-24,4,0,9,12,141,266,407,362.0
6287,2011-09-24,4,0,9,13,170,290,460,417.6666666666667
6288,2011-09-24,4,0,9,14,164,226,390,419.0
6289,2011-09-24,4,0,9,15,168,284,452,434.0
6290,2011-09-24,4,0,9,16,167,282,449,430.3333333333333
6291,2011-09-24,4,0,9,17,180,246,426,442.3333333333333
6292,2011-09-24,4,0,9,18,157,243,400,425.0
6293,2011-09-24,4,0,9,19,77,231,308,378.0
6294,2011-09-24,4,0,9,20,77,166,243,317.0
6295,2011-09-24,4,0,9,21,66,156,222,257.6666666666667
6296,2011-09-24,4,0,9,22,50,143,193,219.33333333333334
6297,2011-09-24,4,0,9,23,27,123,150,188.33333333333334
6298,2011-09-25,4,0,9,0,37,136,173,172.0
6299,2011-09-25,4,0,9,1,31,93,124,149.0
6300,2011-09-25,4,0,9,2,27,79,106,134.33333333333334
6301,2011-09-25,4,0,9,3,20,39,59,96.33333333333333
6302,2011-09-25,4,0,9,4,3,5,8,57.666666666666664
6303,2011-09-25,4,0,9,5,1,2,3,23.333333333333332
6304,2011-09-25,4,0,9,6,4,13,17,9.333333333333334
6305,2011-09-25,4,0,9,7,15,23,38,19.333333333333332
6306,2011-09-25,4,0,9,8,27,59,86,47.0
6307,2011-09-25,4,0,9,9,55,100,155,93.0
6308,2011-09-25,4,0,9,10,85,190,275,172.0
6309,2011-09-25,4,0,9,11,131,230,361,263.6666666666667
6310,2011-09-25,4,0,9,12,143,270,413,349.6666666666667
6311,2011-09-25,4,0,9,13,122,247,369,381.0
6312,2011-09-25,4,0,9,14,116,231,347,376.3333333333333
6313,2011-09-25,4,0,9,15,119,234,353,356.3333333333333
6314,2011-09-25,4,0,9,16,144,320,464,388.0
6315,2011-09-25,4,0,9,17,145,275,420,412.3333333333333
6316,2011-09-25,4,0,9,18,125,279,404,429.3333333333333
6317,2011-09-25,4,0,9,19,87,242,329,384.3333333333333
6318,2011-09-25,4,0,9,20,51,135,186,306.3333333333333
6319,2011-09-25,4,0,9,21,24,113,137,217.33333333333334
6320,2011-09-25,4,0,9,22,20,84,104,142.33333333333334
6321,2011-09-25,4,0,9,23,12,67,79,106.66666666666667
6322,2011-09-26,4,0,9,0,6,23,29,70.66666666666667
6323,2011-09-26,4,0,9,1,3,14,17,41.666666666666664
6324,2011-09-26,4,0,9,2,4,4,8,18.0
6325,2011-09-26,4,0,9,3,0,5,5,10.0
6326,2011-09-26,4,0,9,4,2,4,6,6.333333333333333
6327,2011-09-26,4,0,9,5,0,25,25,12.0
6328,2011-09-26,4,0,9,6,6,107,113,48.0
6329,2011-09-26,4,0,9,7,17,315,332,156.66666666666666
6330,2011-09-26,4,0,9,8,29,326,355,266.6666666666667
6331,2011-09-26,4,0,9,9,44,161,205,297.3333333333333
6332,2011-09-26,4,0,9,10,37,117,154,238.0
6333,2011-09-26,4,0,9,11,43,116,159,172.66666666666666
6334,2011-09-26,4,0,9,12,48,161,209,174.0
6335,2011-09-26,4,0,9,13,48,139,187,185.0
6336,2011-09-26,4,0,9,14,44,110,154,183.33333333333334
6337,2011-09-26,4,0,9,15,52,157,209,183.33333333333334
6338,2011-09-26,4,0,9,16,74,239,313,225.33333333333334
6339,2011-09-26,4,0,9,17,61,509,570,364.0
6340,2011-09-26,4,0,9,18,63,490,553,478.6666666666667
6341,2011-09-26,4,0,9,19,36,347,383,502.0
6342,2011-09-26,4,0,9,20,24,227,251,395.6666666666667
6343,2011-09-26,4,0,9,21,18,164,182,272.0
6344,2011-09-26,4,0,9,22,14,122,136,189.66666666666666
6345,2011-09-26,4,0,9,23,11,64,75,131.0
6346,2011-09-27,4,0,9,0,9,28,37,82.66666666666667
6347,2011-09-27,4,0,9,1,4,6,10,40.666666666666664
6348,2011-09-27,4,0,9,2,7,4,11,19.333333333333332
6349,2011-09-27,4,0,9,3,5,5,10,10.333333333333334
6350,2011-09-27,4,0,9,4,5,3,8,9.666666666666666
6351,2011-09-27,4,0,9,5,0,24,24,14.0
6352,2011-09-27,4,0,9,6,8,116,124,52.0
6353,2011-09-27,4,0,9,7,15,234,249,132.33333333333334
6354,2011-09-27,4,0,9,8,27,400,427,266.6666666666667
6355,2011-09-27,4,0,9,9,20,173,193,289.6666666666667
6356,2011-09-27,4,0,9,10,21,101,122,247.33333333333334
6357,2011-09-27,4,0,9,11,26,97,123,146.0
6358,2011-09-27,4,0,9,12,33,129,162,135.66666666666666
6359,2011-09-27,4,0,9,13,29,122,151,145.33333333333334
6360,2011-09-27,4,0,9,14,29,123,152,155.0
6361,2011-09-27,4,0,9,15,35,170,205,169.33333333333334
6362,2011-09-27,4,0,9,16,33,225,258,205.0
6363,2011-09-27,4,0,9,17,50,480,530,331.0
6364,2011-09-27,4,0,9,18,31,325,356,381.3333333333333
6365,2011-09-27,4,0,9,19,26,294,320,402.0
6366,2011-09-27,4,0,9,20,17,221,238,304.6666666666667
6367,2011-09-27,4,0,9,21,17,179,196,251.33333333333334
6368,2011-09-27,4,0,9,22,19,102,121,185.0
6369,2011-09-27,4,0,9,23,11,82,93,136.66666666666666
6370,2011-09-28,4,0,9,0,7,29,36,83.33333333333333
6371,2011-09-28,4,0,9,1,1,13,14,47.666666666666664
6372,2011-09-28,4,0,9,2,0,9,9,19.666666666666668
6373,2011-09-28,4,0,9,3,0,3,3,8.666666666666666
6374,2011-09-28,4,0,9,4,1,3,4,5.333333333333333
6375,2011-09-28,4,0,9,5,2,20,22,9.666666666666666
6376,2011-09-28,4,0,9,6,3,111,114,46.666666666666664
6377,2011-09-28,4,0,9,7,8,177,185,107.0
6378,2011-09-28,4,0,9,8,17,270,287,195.33333333333334
6379,2011-09-28,4,0,9,9,14,141,155,209.0
6380,2011-09-28,4,0,9,10,20,109,129,190.33333333333334
6381,2011-09-28,4,0,9,11,24,127,151,145.0
6382,2011-09-28,4,0,9,12,25,159,184,154.66666666666666
6383,2011-09-28,4,0,9,13,24,138,162,165.66666666666666
6384,2011-09-28,4,0,9,14,25,145,170,172.0
6385,2011-09-28,4,0,9,15,35,146,181,171.0
6386,2011-09-28,4,0,9,16,39,241,280,210.33333333333334
6387,2011-09-28,4,0,9,17,64,527,591,350.6666666666667
6388,2011-09-28,4,0,9,18,65,459,524,465.0
6389,2011-09-28,4,0,9,19,57,315,372,495.6666666666667
6390,2011-09-28,4,0,9,20,11,91,102,332.6666666666667
6391,2011-09-28,4,0,9,21,7,67,74,182.66666666666666
6392,2011-09-28,4,0,9,22,19,68,87,87.66666666666667
6393,2011-09-28,4,0,9,23,12,59,71,77.33333333333333
6394,2011-09-29,4,0,9,0,7,33,40,66.0
6395,2011-09-29,4,0,9,1,3,20,23,44.666666666666664
6396,2011-09-29,4,0,9,2,0,2,2,21.666666666666668
6397,2011-09-29,4,0,9,3,0,8,8,11.0
6398,2011-09-29,4,0,9,4,2,5,7,5.666666666666667
6399,2011-09-29,4,0,9,5,0,22,22,12.333333333333334
6400,2011-09-29,4,0,9,6,5,106,111,46.666666666666664
6401,2011-09-29,4,0,9,7,14,269,283,138.66666666666666
6402,2011-09-29,4,0,9,8,29,402,431,275.0
6403,2011-09-29,4,0,9,9,27,198,225,313.0
6404,2011-09-29,4,0,9,10,24,103,127,261.0
6405,2011-09-29,4,0,9,11,36,122,158,170.0
6406,2011-09-29,4,0,9,12,38,157,195,160.0
6407,2011-09-29,4,0,9,13,36,175,211,188.0
6408,2011-09-29,4,0,9,14,33,134,167,191.0
6409,2011-09-29,4,0,9,15,42,185,227,201.66666666666666
6410,2011-09-29,4,0,9,16,64,227,291,228.33333333333334
6411,2011-09-29,4,0,9,17,62,527,589,369.0
6412,2011-09-29,4,0,9,18,84,500,584,488.0
6413,2011-09-29,4,0,9,19,36,348,384,519.0
6414,2011-09-29,4,0,9,20,39,234,273,413.6666666666667
6415,2011-09-29,4,0,9,21,30,195,225,294.0
6416,2011-09-29,4,0,9,22,25,150,175,224.33333333333334
6417,2011-09-29,4,0,9,23,17,64,81,160.33333333333334
6418,2011-09-30,4,0,9,0,7,53,60,105.33333333333333
6419,2011-09-30,4,0,9,1,5,18,23,54.666666666666664
6420,2011-09-30,4,0,9,2,6,9,15,32.666666666666664
6421,2011-09-30,4,0,9,3,0,3,3,13.666666666666666
6422,2011-09-30,4,0,9,4,2,6,8,8.666666666666666
6423,2011-09-30,4,0,9,5,3,23,26,12.333333333333334
6424,2011-09-30,4,0,9,6,0,98,98,44.0
6425,2011-09-30,4,0,9,7,14,283,297,140.33333333333334
6426,2011-09-30,4,0,9,8,31,425,456,283.6666666666667
6427,2011-09-30,4,0,9,9,23,214,237,330.0
6428,2011-09-30,4,0,9,10,46,122,168,287.0
6429,2011-09-30,4,0,9,11,49,168,217,207.33333333333334
6430,2011-09-30,4,0,9,12,59,195,254,213.0
6431,2011-09-30,4,0,9,13,72,194,266,245.66666666666666
6432,2011-09-30,4,0,9,14,93,173,266,262.0
6433,2011-09-30,4,0,9,15,52,193,245,259.0
6434,2011-09-30,4,0,9,16,62,298,360,290.3333333333333
6435,2011-09-30,4,0,9,17,94,497,591,398.6666666666667
6436,2011-09-30,4,0,9,18,62,449,511,487.3333333333333
6437,2011-09-30,4,0,9,19,42,332,374,492.0
6438,2011-09-30,4,0,9,20,28,202,230,371.6666666666667
6439,2011-09-30,4,0,9,21,27,179,206,270.0
6440,2011-09-30,4,0,9,22,30,129,159,198.33333333333334
6441,2011-09-30,4,0,9,23,23,109,132,165.66666666666666
6442,2011-10-01,4,0,10,0,24,106,130,140.33333333333334
6443,2011-10-01,4,0,10,1,11,47,58,106.66666666666667
6444,2011-10-01,4,0,10,2,21,46,67,85.0
6445,2011-10-01,4,0,10,3,8,17,25,50.0
6446,2011-10-01,4,0,10,4,2,6,8,33.333333333333336
6447,2011-10-01,4,0,10,5,1,4,5,12.666666666666666
6448,2011-10-01,4,0,10,6,4,15,19,10.666666666666666
6449,2011-10-01,4,0,10,7,6,30,36,20.0
6450,2011-10-01,4,0,10,8,9,58,67,40.666666666666664
6451,2011-10-01,4,0,10,9,17,112,129,77.33333333333333
6452,2011-10-01,4,0,10,10,21,100,121,105.66666666666667
6453,2011-10-01,4,0,10,11,30,102,132,127.33333333333333
6454,2011-10-01,4,0,10,12,28,130,158,137.0
6455,2011-10-01,4,0,10,13,27,98,125,138.33333333333334
6456,2011-10-01,4,0,10,14,33,147,180,154.33333333333334
6457,2011-10-01,4,0,10,15,41,154,195,166.66666666666666
6458,2011-10-01,4,0,10,16,58,165,223,199.33333333333334
6459,2011-10-01,4,0,10,17,58,170,228,215.33333333333334
6460,2011-10-01,4,0,10,18,23,117,140,197.0
6461,2011-10-01,4,0,10,19,27,99,126,164.66666666666666
6462,2011-10-01,4,0,10,20,8,58,66,110.66666666666667
6463,2011-10-01,4,0,10,21,3,53,56,82.66666666666667
6464,2011-10-01,4,0,10,22,12,58,70,64.0
6465,2011-10-01,4,0,10,23,8,57,65,63.666666666666664
6466,2011-10-02,4,0,10,0,4,43,47,60.666666666666664
6467,2011-10-02,4,0,10,1,1,23,24,45.333333333333336
6468,2011-10-02,4,0,10,2,3,27,30,33.666666666666664
6469,2011-10-02,4,0,10,3,4,5,9,21.0
6470,2011-10-02,4,0,10,4,4,3,7,15.333333333333334
6471,2011-10-02,4,0,10,5,0,7,7,7.666666666666667
6472,2011-10-02,4,0,10,6,2,13,15,9.666666666666666
6473,2011-10-02,4,0,10,7,5,24,29,17.0
6474,2011-10-02,4,0,10,8,14,50,64,36.0
6475,2011-10-02,4,0,10,9,19,96,115,69.33333333333333
6476,2011-10-02,4,0,10,10,60,188,248,142.33333333333334
6477,2011-10-02,4,0,10,11,74,218,292,218.33333333333334
6478,2011-10-02,4,0,10,12,78,243,321,287.0
6479,2011-10-02,4,0,10,13,84,224,308,307.0
6480,2011-10-02,4,0,10,14,61,195,256,295.0
6481,2011-10-02,4,0,10,15,29,144,173,245.66666666666666
6482,2011-10-02,4,0,10,16,44,162,206,211.66666666666666
6483,2011-10-02,4,0,10,17,32,135,167,182.0
6484,2011-10-02,4,0,10,18,16,158,174,182.33333333333334
6485,2011-10-02,4,0,10,19,34,128,162,167.66666666666666
6486,2011-10-02,4,0,10,20,16,71,87,141.0
6487,2011-10-02,4,0,10,21,17,71,88,112.33333333333333
6488,2011-10-02,4,0,10,22,9,55,64,79.66666666666667
6489,2011-10-02,4,0,10,23,6,19,25,59.0
6490,2011-10-03,4,0,10,0,3,13,16,35.0
6491,2011-10-03,4,0,10,1,1,5,6,15.666666666666666
6492,2011-10-03,4,0,10,2,0,4,4,8.666666666666666
6493,2011-10-03,4,0,10,3,1,6,7,5.666666666666667
6494,2011-10-03,4,0,10,4,2,6,8,6.333333333333333
6495,2011-10-03,4,0,10,5,4,17,21,12.0
6496,2011-10-03,4,0,10,6,3,91,94,41.0
6497,2011-10-03,4,0,10,7,8,241,249,121.33333333333333
6498,2011-10-03,4,0,10,8,13,359,372,238.33333333333334
6499,2011-10-03,4,0,10,9,12,141,153,258.0
6500,2011-10-03,4,0,10,10,19,82,101,208.66666666666666
6501,2011-10-03,4,0,10,11,26,100,126,126.66666666666667
6502,2011-10-03,4,0,10,12,29,118,147,124.66666666666667
6503,2011-10-03,4,0,10,13,16,102,118,130.33333333333334
6504,2011-10-03,4,0,10,14,26,94,120,128.33333333333334
6505,2011-10-03,4,0,10,15,22,79,101,113.0
6506,2011-10-03,4,0,10,16,16,202,218,146.33333333333334
6507,2011-10-03,4,0,10,17,40,455,495,271.3333333333333
6508,2011-10-03,4,0,10,18,28,384,412,375.0
6509,2011-10-03,4,0,10,19,15,300,315,407.3333333333333
6510,2011-10-03,4,0,10,20,13,191,204,310.3333333333333
6511,2011-10-03,4,0,10,21,10,128,138,219.0
6512,2011-10-03,4,0,10,22,12,79,91,144.33333333333334
6513,2011-10-03,4,0,10,23,11,43,54,94.33333333333333
6514,2011-10-04,4,0,10,0,5,22,27,57.333333333333336
6515,2011-10-04,4,0,10,1,1,8,9,30.0
6516,2011-10-04,4,0,10,2,1,2,3,13.0
6517,2011-10-04,4,0,10,3,3,3,6,6.0
6518,2011-10-04,4,0,10,4,3,4,7,5.333333333333333
6519,2011-10-04,4,0,10,5,2,25,27,13.333333333333334
6520,2011-10-04,4,0,10,6,3,109,112,48.666666666666664
6521,2011-10-04,4,0,10,7,11,298,309,149.33333333333334
6522,2011-10-04,4,0,10,8,28,372,400,273.6666666666667
6523,2011-10-04,4,0,10,9,19,168,187,298.6666666666667
6524,2011-10-04,4,0,10,10,19,107,126,237.66666666666666
6525,2011-10-04,4,0,10,11,22,102,124,145.66666666666666
6526,2011-10-04,4,0,10,12,39,160,199,149.66666666666666
6527,2011-10-04,4,0,10,13,20,153,173,165.33333333333334
6528,2011-10-04,4,0,10,14,27,156,183,185.0
6529,2011-10-04,4,0,10,15,28,166,194,183.33333333333334
6530,2011-10-04,4,0,10,16,36,273,309,228.66666666666666
6531,2011-10-04,4,0,10,17,55,530,585,362.6666666666667
6532,2011-10-04,4,0,10,18,68,456,524,472.6666666666667
6533,2011-10-04,4,0,10,19,35,310,345,484.6666666666667
6534,2011-10-04,4,0,10,20,25,236,261,376.6666666666667
6535,2011-10-04,4,0,10,21,22,144,166,257.3333333333333
6536,2011-10-04,4,0,10,22,8,106,114,180.33333333333334
6537,2011-10-04,4,0,10,23,6,60,66,115.33333333333333
6538,2011-10-05,4,0,10,0,7,36,43,74.33333333333333
6539,2011-10-05,4,0,10,1,4,7,11,40.0
6540,2011-10-05,4,0,10,2,1,2,3,19.0
6541,2011-10-05,4,0,10,3,1,5,6,6.666666666666667
6542,2011-10-05,4,0,10,4,1,4,5,4.666666666666667
6543,2011-10-05,4,0,10,5,3,29,32,14.333333333333334
6544,2011-10-05,4,0,10,6,5,112,117,51.333333333333336
6545,2011-10-05,4,0,10,7,9,292,301,150.0
6546,2011-10-05,4,0,10,8,26,441,467,295.0
6547,2011-10-05,4,0,10,9,32,187,219,329.0
6548,2011-10-05,4,0,10,10,30,103,133,273.0
6549,2011-10-05,4,0,10,11,32,138,170,174.0
6550,2011-10-05,4,0,10,12,34,180,214,172.33333333333334
6551,2011-10-05,4,0,10,13,30,189,219,201.0
6552,2011-10-05,4,0,10,14,34,156,190,207.66666666666666
6553,2011-10-05,4,0,10,15,35,147,182,197.0
6554,2011-10-05,4,0,10,16,37,245,282,218.0
6555,2011-10-05,4,0,10,17,66,525,591,351.6666666666667
6556,2011-10-05,4,0,10,18,57,536,593,488.6666666666667
6557,2011-10-05,4,0,10,19,40,334,374,519.3333333333334
6558,2011-10-05,4,0,10,20,18,228,246,404.3333333333333
6559,2011-10-05,4,0,10,21,28,173,201,273.6666666666667
6560,2011-10-05,4,0,10,22,20,134,154,200.33333333333334
6561,2011-10-05,4,0,10,23,9,64,73,142.66666666666666
6562,2011-10-06,4,0,10,0,6,34,40,89.0
6563,2011-10-06,4,0,10,1,5,17,22,45.0
6564,2011-10-06,4,0,10,2,2,8,10,24.0
6565,2011-10-06,4,0,10,3,1,4,5,12.333333333333334
6566,2011-10-06,4,0,10,4,0,5,5,6.666666666666667
6567,2011-10-06,4,0,10,5,0,24,24,11.333333333333334
6568,2011-10-06,4,0,10,6,4,110,114,47.666666666666664
6569,2011-10-06,4,0,10,7,15,287,302,146.66666666666666
6570,2011-10-06,4,0,10,8,20,437,457,291.0
6571,2011-10-06,4,0,10,9,20,188,208,322.3333333333333
6572,2011-10-06,4,0,10,10,24,105,129,264.6666666666667
6573,2011-10-06,4,0,10,11,29,115,144,160.33333333333334
6574,2011-10-06,4,0,10,12,46,180,226,166.33333333333334
6575,2011-10-06,4,0,10,13,33,158,191,187.0
6576,2011-10-06,4,0,10,14,56,139,195,204.0
6577,2011-10-06,4,0,10,15,62,157,219,201.66666666666666
6578,2011-10-06,4,0,10,16,51,272,323,245.66666666666666
6579,2011-10-06,4,0,10,17,63,505,568,370.0
6580,2011-10-06,4,0,10,18,59,479,538,476.3333333333333
6581,2011-10-06,4,0,10,19,38,305,343,483.0
6582,2011-10-06,4,0,10,20,29,231,260,380.3333333333333
6583,2011-10-06,4,0,10,21,34,161,195,266.0
6584,2011-10-06,4,0,10,22,24,124,148,201.0
6585,2011-10-06,4,0,10,23,18,81,99,147.33333333333334
6586,2011-10-07,4,0,10,0,19,48,67,104.66666666666667
6587,2011-10-07,4,0,10,1,3,25,28,64.66666666666667
6588,2011-10-07,4,0,10,2,0,5,5,33.333333333333336
6589,2011-10-07,4,0,10,3,1,9,10,14.333333333333334
6590,2011-10-07,4,0,10,4,0,5,5,6.666666666666667
6591,2011-10-07,4,0,10,5,3,24,27,14.0
6592,2011-10-07,4,0,10,6,3,84,87,39.666666666666664
6593,2011-10-07,4,0,10,7,5,237,242,118.66666666666667
6594,2011-10-07,4,0,10,8,31,386,417,248.66666666666666
6595,2011-10-07,4,0,10,9,34,207,241,300.0
6596,2011-10-07,4,0,10,10,48,126,174,277.3333333333333
6597,2011-10-07,4,0,10,11,80,150,230,215.0
6598,2011-10-07,4,0,10,12,61,174,235,213.0
6599,2011-10-07,4,0,10,13,95,210,305,256.6666666666667
6600,2011-10-07,4,0,10,14,77,179,256,265.3333333333333
6601,2011-10-07,4,0,10,15,68,202,270,277.0
6602,2011-10-07,4,0,10,16,73,346,419,315.0
6603,2011-10-07,4,0,10,17,101,462,563,417.3333333333333
6604,2011-10-07,4,0,10,18,94,371,465,482.3333333333333
6605,2011-10-07,4,0,10,19,51,243,294,440.6666666666667
6606,2011-10-07,4,0,10,20,30,167,197,318.6666666666667
6607,2011-10-07,4,0,10,21,22,144,166,219.0
6608,2011-10-07,4,0,10,22,27,119,146,169.66666666666666
6609,2011-10-07,4,0,10,23,23,113,136,149.33333333333334
6610,2011-10-08,4,0,10,0,17,72,89,123.66666666666667
6611,2011-10-08,4,0,10,1,14,51,65,96.66666666666667
6612,2011-10-08,4,0,10,2,4,41,45,66.33333333333333
6613,2011-10-08,4,0,10,3,4,16,20,43.333333333333336
6614,2011-10-08,4,0,10,4,3,7,10,25.0
6615,2011-10-08,4,0,10,5,1,7,8,12.666666666666666
6616,2011-10-08,4,0,10,6,6,16,22,13.333333333333334
6617,2011-10-08,4,0,10,7,27,46,73,34.333333333333336
6618,2011-10-08,4,0,10,8,14,89,103,66.0
6619,2011-10-08,4,0,10,9,54,163,217,131.0
6620,2011-10-08,4,0,10,10,120,217,337,219.0
6621,2011-10-08,4,0,10,11,176,221,397,317.0
6622,2011-10-08,4,0,10,12,191,255,446,393.3333333333333
6623,2011-10-08,4,0,10,13,256,229,485,442.6666666666667
6624,2011-10-08,4,0,10,14,251,214,465,465.3333333333333
6625,2011-10-08,4,0,10,15,262,234,496,482.0
6626,2011-10-08,4,0,10,16,221,230,451,470.6666666666667
6627,2011-10-08,4,0,10,17,174,219,393,446.6666666666667
6628,2011-10-08,4,0,10,18,135,224,359,401.0
6629,2011-10-08,4,0,10,19,76,172,248,333.3333333333333
6630,2011-10-08,4,0,10,20,78,124,202,269.6666666666667
6631,2011-10-08,4,0,10,21,54,133,187,212.33333333333334
6632,2011-10-08,4,0,10,22,45,104,149,179.33333333333334
6633,2011-10-08,4,0,10,23,52,90,142,159.33333333333334
6634,2011-10-09,4,0,10,0,46,83,129,140.0
6635,2011-10-09,4,0,10,1,15,63,78,116.33333333333333
6636,2011-10-09,4,0,10,2,20,35,55,87.33333333333333
6637,2011-10-09,4,0,10,3,10,20,30,54.333333333333336
6638,2011-10-09,4,0,10,4,7,7,14,33.0
6639,2011-10-09,4,0,10,5,1,14,15,19.666666666666668
6640,2011-10-09,4,0,10,6,7,14,21,16.666666666666668
6641,2011-10-09,4,0,10,7,18,26,44,26.666666666666668
6642,2011-10-09,4,0,10,8,25,82,107,57.333333333333336
6643,2011-10-09,4,0,10,9,66,119,185,112.0
6644,2011-10-09,4,0,10,10,155,210,365,219.0
6645,2011-10-09,4,0,10,11,189,234,423,324.3333333333333
6646,2011-10-09,4,0,10,12,212,243,455,414.3333333333333
6647,2011-10-09,4,0,10,13,225,193,418,432.0
6648,2011-10-09,4,0,10,14,272,228,500,457.6666666666667
6649,2011-10-09,4,0,10,15,198,209,407,441.6666666666667
6650,2011-10-09,4,0,10,16,223,247,470,459.0
6651,2011-10-09,4,0,10,17,208,230,438,438.3333333333333
6652,2011-10-09,4,0,10,18,186,228,414,440.6666666666667
6653,2011-10-09,4,0,10,19,116,186,302,384.6666666666667
6654,2011-10-09,4,0,10,20,59,134,193,303.0
6655,2011-10-09,4,0,10,21,53,120,173,222.66666666666666
6656,2011-10-09,4,0,10,22,48,104,152,172.66666666666666
6657,2011-10-09,4,0,10,23,38,85,123,149.33333333333334
6658,2011-10-10,4,0,10,0,11,42,53,109.33333333333333
6659,2011-10-10,4,0,10,1,4,30,34,70.0
6660,2011-10-10,4,0,10,2,4,15,19,35.333333333333336
6661,2011-10-10,4,0,10,3,2,9,11,21.333333333333332
6662,2011-10-10,4,0,10,4,2,4,6,12.0
6663,2011-10-10,4,0,10,5,2,19,21,12.666666666666666
6664,2011-10-10,4,0,10,6,5,39,44,23.666666666666668
6665,2011-10-10,4,0,10,7,12,102,114,59.666666666666664
6666,2011-10-10,4,0,10,8,27,227,254,137.33333333333334
6667,2011-10-10,4,0,10,9,58,161,219,195.66666666666666
6668,2011-10-10,4,0,10,10,107,158,265,246.0
6669,2011-10-10,4,0,10,11,139,183,322,268.6666666666667
6670,2011-10-10,4,0,10,12,164,201,365,317.3333333333333
6671,2011-10-10,4,0,10,13,146,219,365,350.6666666666667
6672,2011-10-10,4,0,10,14,147,223,370,366.6666666666667
6673,2011-10-10,4,0,10,15,130,254,384,373.0
6674,2011-10-10,4,0,10,16,154,248,402,385.3333333333333
6675,2011-10-10,4,0,10,17,125,334,459,415.0
6676,2011-10-10,4,0,10,18,108,365,473,444.6666666666667
6677,2011-10-10,4,0,10,19,69,267,336,422.6666666666667
6678,2011-10-10,4,0,10,20,37,188,225,344.6666666666667
6679,2011-10-10,4,0,10,21,27,148,175,245.33333333333334
6680,2011-10-10,4,0,10,22,22,104,126,175.33333333333334
6681,2011-10-10,4,0,10,23,12,63,75,125.33333333333333
6682,2011-10-11,4,0,10,0,14,16,30,77.0
6683,2011-10-11,4,0,10,1,2,9,11,38.666666666666664
6684,2011-10-11,4,0,10,2,1,4,5,15.333333333333334
6685,2011-10-11,4,0,10,3,2,1,3,6.333333333333333
6686,2011-10-11,4,0,10,4,0,5,5,4.333333333333333
6687,2011-10-11,4,0,10,5,0,20,20,9.333333333333334
6688,2011-10-11,4,0,10,6,9,114,123,49.333333333333336
6689,2011-10-11,4,0,10,7,19,333,352,165.0
6690,2011-10-11,4,0,10,8,31,375,406,293.6666666666667
6691,2011-10-11,4,0,10,9,40,195,235,331.0
6692,2011-10-11,4,0,10,10,38,111,149,263.3333333333333
6693,2011-10-11,4,0,10,11,31,92,123,169.0
6694,2011-10-11,4,0,10,12,51,130,181,151.0
6695,2011-10-11,4,0,10,13,42,138,180,161.33333333333334
6696,2011-10-11,4,0,10,14,54,117,171,177.33333333333334
6697,2011-10-11,4,0,10,15,36,139,175,175.33333333333334
6698,2011-10-11,4,0,10,16,63,257,320,222.0
6699,2011-10-11,4,0,10,17,70,534,604,366.3333333333333
6700,2011-10-11,4,0,10,18,46,493,539,487.6666666666667
6701,2011-10-11,4,0,10,19,33,285,318,487.0
6702,2011-10-11,4,0,10,20,31,203,234,363.6666666666667
6703,2011-10-11,4,0,10,21,17,158,175,242.33333333333334
6704,2011-10-11,4,0,10,22,27,120,147,185.33333333333334
6705,2011-10-11,4,0,10,23,10,47,57,126.33333333333333
6706,2011-10-12,4,0,10,0,2,23,25,76.33333333333333
6707,2011-10-12,4,0,10,1,2,8,10,30.666666666666668
6708,2011-10-12,4,0,10,2,0,2,2,12.333333333333334
6709,2011-10-12,4,0,10,3,0,2,2,4.666666666666667
6710,2011-10-12,4,0,10,4,1,6,7,3.6666666666666665
6711,2011-10-12,4,0,10,5,0,22,22,10.333333333333334
6712,2011-10-12,4,0,10,6,5,107,112,47.0
6713,2011-10-12,4,0,10,7,15,244,259,131.0
6714,2011-10-12,4,0,10,8,27,377,404,258.3333333333333
6715,2011-10-12,4,0,10,9,14,183,197,286.6666666666667
6716,2011-10-12,4,0,10,10,15,98,113,238.0
6717,2011-10-12,4,0,10,11,18,102,120,143.33333333333334
6718,2011-10-12,4,0,10,12,9,53,62,98.33333333333333
6719,2011-10-12,4,0,10,13,25,76,101,94.33333333333333
6720,2011-10-12,4,0,10,14,8,70,78,80.33333333333333
6721,2011-10-12,4,0,10,15,3,42,45,74.66666666666667
6722,2011-10-12,4,0,10,16,5,50,55,59.333333333333336
6723,2011-10-12,4,0,10,17,16,235,251,117.0
6724,2011-10-12,4,0,10,18,11,161,172,159.33333333333334
6725,2011-10-12,4,0,10,19,7,102,109,177.33333333333334
6726,2011-10-12,4,0,10,20,9,81,90,123.66666666666667
6727,2011-10-12,4,0,10,21,9,74,83,94.0
6728,2011-10-12,4,0,10,22,3,40,43,72.0
6729,2011-10-12,4,0,10,23,13,41,54,60.0
6730,2011-10-13,4,0,10,0,1,14,15,37.333333333333336
6731,2011-10-13,4,0,10,1,3,9,12,27.0
6732,2011-10-13,4,0,10,2,0,4,4,10.333333333333334
6733,2011-10-13,4,0,10,3,2,4,6,7.333333333333333
6734,2011-10-13,4,0,10,4,2,5,7,5.666666666666667
6735,2011-10-13,4,0,10,5,1,16,17,10.0
6736,2011-10-13,4,0,10,6,1,51,52,25.333333333333332
6737,2011-10-13,4,0,10,7,5,76,81,50.0
6738,2011-10-13,4,0,10,8,10,199,209,114.0
6739,2011-10-13,4,0,10,9,3,106,109,133.0
6740,2011-10-13,4,0,10,10,16,53,69,129.0
6741,2011-10-13,4,0,10,11,8,76,84,87.33333333333333
6742,2011-10-13,4,0,10,12,10,95,105,86.0
6743,2011-10-13,4,0,10,13,20,142,162,117.0
6744,2011-10-13,4,0,10,14,22,111,133,133.33333333333334
6745,2011-10-13,4,0,10,15,27,128,155,150.0
6746,2011-10-13,4,0,10,16,36,240,276,188.0
6747,2011-10-13,4,0,10,17,47,432,479,303.3333333333333
6748,2011-10-13,4,0,10,18,20,248,268,341.0
6749,2011-10-13,4,0,10,19,18,187,205,317.3333333333333
6750,2011-10-13,4,0,10,20,15,166,181,218.0
6751,2011-10-13,4,0,10,21,8,115,123,169.66666666666666
6752,2011-10-13,4,0,10,22,13,101,114,139.33333333333334
6753,2011-10-13,4,0,10,23,2,45,47,94.66666666666667
6754,2011-10-14,4,0,10,0,10,29,39,66.66666666666667
6755,2011-10-14,4,0,10,1,8,16,24,36.666666666666664
6756,2011-10-14,4,0,10,2,0,6,6,23.0
6757,2011-10-14,4,0,10,3,1,6,7,12.333333333333334
6758,2011-10-14,4,0,10,4,0,8,8,7.0
6759,2011-10-14,4,0,10,5,0,17,17,10.666666666666666
6760,2011-10-14,4,0,10,6,4,90,94,39.666666666666664
6761,2011-10-14,4,0,10,7,10,137,147,86.0
6762,2011-10-14,4,0,10,8,23,186,209,150.0
6763,2011-10-14,4,0,10,9,16,164,180,178.66666666666666
6764,2011-10-14,4,0,10,10,17,108,125,171.33333333333334
6765,2011-10-14,4,0,10,11,11,76,87,130.66666666666666
6766,2011-10-14,4,0,10,12,13,62,75,95.66666666666667
6767,2011-10-14,4,0,10,13,18,114,132,98.0
6768,2011-10-14,4,0,10,14,37,119,156,121.0
6769,2011-10-14,4,0,10,15,61,169,230,172.66666666666666
6770,2011-10-14,4,0,10,16,80,264,344,243.33333333333334
6771,2011-10-14,4,0,10,17,55,426,481,351.6666666666667
6772,2011-10-14,4,0,10,18,62,361,423,416.0
6773,2011-10-14,4,0,10,19,27,221,248,384.0
6774,2011-10-14,4,0,10,20,19,177,196,289.0
6775,2011-10-14,4,0,10,21,22,156,178,207.33333333333334
6776,2011-10-14,4,0,10,22,20,123,143,172.33333333333334
6777,2011-10-14,4,0,10,23,15,80,95,138.66666666666666
6778,2011-10-15,4,0,10,0,18,88,106,114.66666666666667
6779,2011-10-15,4,0,10,1,9,64,73,91.33333333333333
6780,2011-10-15,4,0,10,2,17,39,56,78.33333333333333
6781,2011-10-15,4,0,10,3,5,18,23,50.666666666666664
6782,2011-10-15,4,0,10,4,0,6,6,28.333333333333332
6783,2011-10-15,4,0,10,5,1,6,7,12.0
6784,2011-10-15,4,0,10,6,5,15,20,11.0
6785,2011-10-15,4,0,10,7,17,40,57,28.0
6786,2011-10-15,4,0,10,8,24,101,125,67.33333333333333
6787,2011-10-15,4,0,10,9,50,157,207,129.66666666666666
6788,2011-10-15,4,0,10,10,115,207,322,218.0
6789,2011-10-15,4,0,10,11,153,221,374,301.0
6790,2011-10-15,4,0,10,12,195,261,456,384.0
6791,2011-10-15,4,0,10,13,171,223,394,408.0
6792,2011-10-15,4,0,10,14,242,230,472,440.6666666666667
6793,2011-10-15,4,0,10,15,166,211,377,414.3333333333333
6794,2011-10-15,4,0,10,16,179,264,443,430.6666666666667
6795,2011-10-15,4,0,10,17,177,264,441,420.3333333333333
6796,2011-10-15,4,0,10,18,121,251,372,418.6666666666667
6797,2011-10-15,4,0,10,19,61,177,238,350.3333333333333
6798,2011-10-15,4,0,10,20,42,137,179,263.0
6799,2011-10-15,4,0,10,21,53,115,168,195.0
6800,2011-10-15,4,0,10,22,45,121,166,171.0
6801,2011-10-15,4,0,10,23,33,102,135,156.33333333333334
6802,2011-10-16,4,0,10,0,22,85,107,136.0
6803,2011-10-16,4,0,10,1,13,64,77,106.33333333333333
6804,2011-10-16,4,0,10,2,13,52,65,83.0
6805,2011-10-16,4,0,10,3,11,31,42,61.333333333333336
6806,2011-10-16,4,0,10,4,5,7,12,39.666666666666664
6807,2011-10-16,4,0,10,5,1,6,7,20.333333333333332
6808,2011-10-16,4,0,10,6,3,7,10,9.666666666666666
6809,2011-10-16,4,0,10,7,9,39,48,21.666666666666668
6810,2011-10-16,4,0,10,8,28,71,99,52.333333333333336
6811,2011-10-16,4,0,10,9,39,151,190,112.33333333333333
6812,2011-10-16,4,0,10,10,121,226,347,212.0
6813,2011-10-16,4,0,10,11,159,218,377,304.6666666666667
6814,2011-10-16,4,0,10,12,167,277,444,389.3333333333333
6815,2011-10-16,4,0,10,13,169,269,438,419.6666666666667
6816,2011-10-16,4,0,10,14,204,258,462,448.0
6817,2011-10-16,4,0,10,15,182,230,412,437.3333333333333
6818,2011-10-16,4,0,10,16,177,289,466,446.6666666666667
6819,2011-10-16,4,0,10,17,152,253,405,427.6666666666667
6820,2011-10-16,4,0,10,18,102,226,328,399.6666666666667
6821,2011-10-16,4,0,10,19,52,181,233,322.0
6822,2011-10-16,4,0,10,20,49,129,178,246.33333333333334
6823,2011-10-16,4,0,10,21,14,88,102,171.0
6824,2011-10-16,4,0,10,22,42,88,130,136.66666666666666
6825,2011-10-16,4,0,10,23,14,48,62,98.0
6826,2011-10-17,4,0,10,0,12,25,37,76.33333333333333
6827,2011-10-17,4,0,10,1,2,15,17,38.666666666666664
6828,2011-10-17,4,0,10,2,4,3,7,20.333333333333332
6829,2011-10-17,4,0,10,3,0,2,2,8.666666666666666
6830,2011-10-17,4,0,10,4,2,3,5,4.666666666666667
6831,2011-10-17,4,0,10,5,1,28,29,12.0
6832,2011-10-17,4,0,10,6,7,107,114,49.333333333333336
6833,2011-10-17,4,0,10,7,10,299,309,150.66666666666666
6834,2011-10-17,4,0,10,8,33,381,414,279.0
6835,2011-10-17,4,0,10,9,26,180,206,309.6666666666667
6836,2011-10-17,4,0,10,10,43,92,135,251.66666666666666
6837,2011-10-17,4,0,10,11,35,131,166,169.0
6838,2011-10-17,4,0,10,12,39,166,205,168.66666666666666
6839,2011-10-17,4,0,10,13,49,156,205,192.0
6840,2011-10-17,4,0,10,14,44,122,166,192.0
6841,2011-10-17,4,0,10,15,66,142,208,193.0
6842,2011-10-17,4,0,10,16,64,238,302,225.33333333333334
6843,2011-10-17,4,0,10,17,80,540,620,376.6666666666667
6844,2011-10-17,4,0,10,18,49,469,518,480.0
6845,2011-10-17,4,0,10,19,45,288,333,490.3333333333333
6846,2011-10-17,4,0,10,20,40,189,229,360.0
6847,2011-10-17,4,0,10,21,36,141,177,246.33333333333334
6848,2011-10-17,4,0,10,22,16,88,104,170.0
6849,2011-10-17,4,0,10,23,10,52,62,114.33333333333333
6850,2011-10-18,4,0,10,0,8,23,31,65.66666666666667
6851,2011-10-18,4,0,10,1,4,7,11,34.666666666666664
6852,2011-10-18,4,0,10,2,1,4,5,15.666666666666666
6853,2011-10-18,4,0,10,3,0,1,1,5.666666666666667
6854,2011-10-18,4,0,10,4,0,4,4,3.3333333333333335
6855,2011-10-18,4,0,10,5,2,19,21,8.666666666666666
6856,2011-10-18,4,0,10,6,4,105,109,44.666666666666664
6857,2011-10-18,4,0,10,7,15,326,341,157.0
6858,2011-10-18,4,0,10,8,25,474,499,316.3333333333333
6859,2011-10-18,4,0,10,9,29,198,227,355.6666666666667
6860,2011-10-18,4,0,10,10,27,75,102,276.0
6861,2011-10-18,4,0,10,11,35,112,147,158.66666666666666
6862,2011-10-18,4,0,10,12,42,159,201,150.0
6863,2011-10-18,4,0,10,13,48,171,219,189.0
6864,2011-10-18,4,0,10,14,32,137,169,196.33333333333334
6865,2011-10-18,4,0,10,15,66,139,205,197.66666666666666
6866,2011-10-18,4,0,10,16,58,246,304,226.0
6867,2011-10-18,4,0,10,17,72,553,625,378.0
6868,2011-10-18,4,0,10,18,58,512,570,499.6666666666667
6869,2011-10-18,4,0,10,19,31,286,317,504.0
6870,2011-10-18,4,0,10,20,23,204,227,371.3333333333333
6871,2011-10-18,4,0,10,21,28,178,206,250.0
6872,2011-10-18,4,0,10,22,22,115,137,190.0
6873,2011-10-18,4,0,10,23,7,63,70,137.66666666666666
6874,2011-10-19,4,0,10,0,11,23,34,80.33333333333333
6875,2011-10-19,4,0,10,1,7,9,16,40.0
6876,2011-10-19,4,0,10,2,1,6,7,19.0
6877,2011-10-19,4,0,10,4,0,3,3,8.666666666666666
6878,2011-10-19,4,0,10,5,0,3,3,4.333333333333333
6879,2011-10-19,4,0,10,6,3,28,31,12.333333333333334
6880,2011-10-19,4,0,10,7,1,67,68,34.0
6881,2011-10-19,4,0,10,8,10,200,210,103.0
6882,2011-10-19,4,0,10,9,17,185,202,160.0
6883,2011-10-19,4,0,10,10,14,109,123,178.33333333333334
6884,2011-10-19,4,0,10,11,33,116,149,158.0
6885,2011-10-19,4,0,10,12,13,117,130,134.0
6886,2011-10-19,4,0,10,13,20,86,106,128.33333333333334
6887,2011-10-19,4,0,10,14,17,80,97,111.0
6888,2011-10-19,4,0,10,15,21,99,120,107.66666666666667
6889,2011-10-19,4,0,10,16,21,180,201,139.33333333333334
6890,2011-10-19,4,0,10,17,11,170,181,167.33333333333334
6891,2011-10-19,4,0,10,18,8,132,140,174.0
6892,2011-10-19,4,0,10,19,8,189,197,172.66666666666666
6893,2011-10-19,4,0,10,20,5,140,145,160.66666666666666
6894,2011-10-19,4,0,10,21,6,79,85,142.33333333333334
6895,2011-10-19,4,0,10,22,13,94,107,112.33333333333333
6896,2011-10-19,4,0,10,23,14,55,69,87.0
6897,2011-10-20,4,0,10,0,4,22,26,67.33333333333333
6898,2011-10-20,4,0,10,1,4,11,15,36.666666666666664
6899,2011-10-20,4,0,10,2,0,4,4,15.0
6900,2011-10-20,4,0,10,3,0,1,1,6.666666666666667
6901,2011-10-20,4,0,10,4,2,6,8,4.333333333333333
6902,2011-10-20,4,0,10,5,2,24,26,11.666666666666666
6903,2011-10-20,4,0,10,6,5,87,92,42.0
6904,2011-10-20,4,0,10,7,15,303,318,145.33333333333334
6905,2011-10-20,4,0,10,8,17,409,426,278.6666666666667
6906,2011-10-20,4,0,10,9,26,197,223,322.3333333333333
6907,2011-10-20,4,0,10,10,25,105,130,259.6666666666667
6908,2011-10-20,4,0,10,11,30,99,129,160.66666666666666
6909,2011-10-20,4,0,10,12,28,171,199,152.66666666666666
6910,2011-10-20,4,0,10,13,28,136,164,164.0
6911,2011-10-20,4,0,10,14,38,117,155,172.66666666666666
6912,2011-10-20,4,0,10,15,22,138,160,159.66666666666666
6913,2011-10-20,4,0,10,16,31,203,234,183.0
6914,2011-10-20,4,0,10,17,56,438,494,296.0
6915,2011-10-20,4,0,10,18,39,430,469,399.0
6916,2011-10-20,4,0,10,19,20,278,298,420.3333333333333
6917,2011-10-20,4,0,10,20,34,207,241,336.0
6918,2011-10-20,4,0,10,21,16,149,165,234.66666666666666
6919,2011-10-20,4,0,10,22,22,106,128,178.0
6920,2011-10-20,4,0,10,23,7,83,90,127.66666666666667
6921,2011-10-21,4,0,10,0,8,42,50,89.33333333333333
6922,2011-10-21,4,0,10,1,7,19,26,55.333333333333336
6923,2011-10-21,4,0,10,2,6,12,18,31.333333333333332
6924,2011-10-21,4,0,10,3,0,7,7,17.0
6925,2011-10-21,4,0,10,4,0,6,6,10.333333333333334
6926,2011-10-21,4,0,10,5,0,31,31,14.666666666666666
6927,2011-10-21,4,0,10,6,7,78,85,40.666666666666664
6928,2011-10-21,4,0,10,7,5,228,233,116.33333333333333
6929,2011-10-21,4,0,10,8,16,386,402,240.0
6930,2011-10-21,4,0,10,9,33,189,222,285.6666666666667
6931,2011-10-21,4,0,10,10,32,106,138,254.0
6932,2011-10-21,4,0,10,11,39,135,174,178.0
6933,2011-10-21,4,0,10,12,47,193,240,184.0
6934,2011-10-21,4,0,10,13,43,163,206,206.66666666666666
6935,2011-10-21,4,0,10,14,67,131,198,214.66666666666666
6936,2011-10-21,4,0,10,15,57,178,235,213.0
6937,2011-10-21,4,0,10,16,60,242,302,245.0
6938,2011-10-21,4,0,10,17,79,445,524,353.6666666666667
6939,2011-10-21,4,0,10,18,43,354,397,407.6666666666667
6940,2011-10-21,4,0,10,19,25,228,253,391.3333333333333
6941,2011-10-21,4,0,10,20,29,155,184,278.0
6942,2011-10-21,4,0,10,21,31,112,143,193.33333333333334
6943,2011-10-21,4,0,10,22,24,89,113,146.66666666666666
6944,2011-10-21,4,0,10,23,18,99,117,124.33333333333333
6945,2011-10-22,4,0,10,0,16,80,96,108.66666666666667
6946,2011-10-22,4,0,10,1,20,50,70,94.33333333333333
6947,2011-10-22,4,0,10,2,6,25,31,65.66666666666667
6948,2011-10-22,4,0,10,3,1,19,20,40.333333333333336
6949,2011-10-22,4,0,10,4,4,4,8,19.666666666666668
6950,2011-10-22,4,0,10,5,1,7,8,12.0
6951,2011-10-22,4,0,10,6,1,17,18,11.333333333333334
6952,2011-10-22,4,0,10,7,8,49,57,27.666666666666668
6953,2011-10-22,4,0,10,8,26,88,114,63.0
6954,2011-10-22,4,0,10,9,47,122,169,113.33333333333333
6955,2011-10-22,4,0,10,10,87,149,236,173.0
6956,2011-10-22,4,0,10,11,110,172,282,229.0
6957,2011-10-22,4,0,10,12,132,211,343,287.0
6958,2011-10-22,4,0,10,13,136,186,322,315.6666666666667
6959,2011-10-22,4,0,10,14,133,177,310,325.0
6960,2011-10-22,4,0,10,15,159,223,382,338.0
6961,2011-10-22,4,0,10,16,169,190,359,350.3333333333333
6962,2011-10-22,4,0,10,17,143,217,360,367.0
6963,2011-10-22,4,0,10,18,111,224,335,351.3333333333333
6964,2011-10-22,4,0,10,19,47,173,220,305.0
6965,2011-10-22,4,0,10,20,48,111,159,238.0
6966,2011-10-22,4,0,10,21,37,120,157,178.66666666666666
6967,2011-10-22,4,0,10,22,30,114,144,153.33333333333334
6968,2011-10-22,4,0,10,23,27,81,108,136.33333333333334
6969,2011-10-23,4,0,10,0,24,64,88,113.33333333333333
6970,2011-10-23,4,0,10,1,11,60,71,89.0
6971,2011-10-23,4,0,10,2,10,40,50,69.66666666666667
6972,2011-10-23,4,0,10,3,15,31,46,55.666666666666664
6973,2011-10-23,4,0,10,4,5,1,6,34.0
6974,2011-10-23,4,0,10,5,1,2,3,18.333333333333332
6975,2011-10-23,4,0,10,6,0,12,12,7.0
6976,2011-10-23,4,0,10,7,3,18,21,12.0
6977,2011-10-23,4,0,10,8,32,56,88,40.333333333333336
6978,2011-10-23,4,0,10,9,48,95,143,84.0
6979,2011-10-23,4,0,10,10,104,185,289,173.33333333333334
6980,2011-10-23,4,0,10,11,131,202,333,255.0
6981,2011-10-23,4,0,10,12,164,249,413,345.0
6982,2011-10-23,4,0,10,13,160,255,415,387.0
6983,2011-10-23,4,0,10,14,192,216,408,412.0
6984,2011-10-23,4,0,10,15,171,216,387,403.3333333333333
6985,2011-10-23,4,0,10,16,188,217,405,400.0
6986,2011-10-23,4,0,10,17,120,220,340,377.3333333333333
6987,2011-10-23,4,0,10,18,88,196,284,343.0
6988,2011-10-23,4,0,10,19,53,140,193,272.3333333333333
6989,2011-10-23,4,0,10,20,32,112,144,207.0
6990,2011-10-23,4,0,10,21,24,75,99,145.33333333333334
6991,2011-10-23,4,0,10,22,25,69,94,112.33333333333333
6992,2011-10-23,4,0,10,23,18,31,49,80.66666666666667
6993,2011-10-24,4,0,10,0,6,26,32,58.333333333333336
6994,2011-10-24,4,0,10,1,7,8,15,32.0
6995,2011-10-24,4,0,10,2,1,6,7,18.0
6996,2011-10-24,4,0,10,3,1,3,4,8.666666666666666
6997,2011-10-24,4,0,10,4,1,5,6,5.666666666666667
6998,2011-10-24,4,0,10,5,2,19,21,10.333333333333334
6999,2011-10-24,4,0,10,6,3,83,86,37.666666666666664
7000,2011-10-24,4,0,10,7,11,274,285,130.66666666666666
7001,2011-10-24,4,0,10,8,20,378,398,256.3333333333333
7002,2011-10-24,4,0,10,9,29,166,195,292.6666666666667
7003,2011-10-24,4,0,10,10,47,82,129,240.66666666666666
7004,2011-10-24,4,0,10,11,59,109,168,164.0
7005,2011-10-24,4,0,10,12,64,156,220,172.33333333333334
7006,2011-10-24,4,0,10,13,60,138,198,195.33333333333334
7007,2011-10-24,4,0,10,14,63,143,206,208.0
7008,2011-10-24,4,0,10,15,52,125,177,193.66666666666666
7009,2011-10-24,4,0,10,16,68,242,310,231.0
7010,2011-10-24,4,0,10,17,87,527,614,367.0
7011,2011-10-24,4,0,10,18,58,428,486,470.0
7012,2011-10-24,4,0,10,19,25,212,237,445.6666666666667
7013,2011-10-24,4,0,10,20,11,118,129,284.0
7014,2011-10-24,4,0,10,21,12,114,126,164.0
7015,2011-10-24,4,0,10,22,3,76,79,111.33333333333333
7016,2011-10-24,4,0,10,23,9,50,59,88.0
7017,2011-10-25,4,0,10,0,4,26,30,56.0
7018,2011-10-25,4,0,10,1,5,6,11,33.333333333333336
7019,2011-10-25,4,0,10,2,2,3,5,15.333333333333334
7020,2011-10-25,4,0,10,3,1,3,4,6.666666666666667
7021,2011-10-25,4,0,10,4,0,5,5,4.666666666666667
7022,2011-10-25,4,0,10,5,0,24,24,11.0
7023,2011-10-25,4,0,10,6,3,95,98,42.333333333333336
7024,2011-10-25,4,0,10,7,15,299,314,145.33333333333334
7025,2011-10-25,4,0,10,8,25,383,408,273.3333333333333
7026,2011-10-25,4,0,10,9,29,194,223,315.0
7027,2011-10-25,4,0,10,10,26,102,128,253.0
7028,2011-10-25,4,0,10,11,46,120,166,172.33333333333334
7029,2011-10-25,4,0,10,12,35,165,200,164.66666666666666
7030,2011-10-25,4,0,10,13,37,161,198,188.0
7031,2011-10-25,4,0,10,14,66,134,200,199.33333333333334
7032,2011-10-25,4,0,10,15,63,171,234,210.66666666666666
7033,2011-10-25,4,0,10,16,52,233,285,239.66666666666666
7034,2011-10-25,4,0,10,17,68,517,585,368.0
7035,2011-10-25,4,0,10,18,65,453,518,462.6666666666667
7036,2011-10-25,4,0,10,19,44,294,338,480.3333333333333
7037,2011-10-25,4,0,10,20,40,208,248,368.0
7038,2011-10-25,4,0,10,21,32,169,201,262.3333333333333
7039,2011-10-25,4,0,10,22,22,148,170,206.33333333333334
7040,2011-10-25,4,0,10,23,15,79,94,155.0
7041,2011-10-26,4,0,10,0,4,28,32,98.66666666666667
7042,2011-10-26,4,0,10,1,3,9,12,46.0
7043,2011-10-26,4,0,10,2,2,1,3,15.666666666666666
7044,2011-10-26,4,0,10,3,0,3,3,6.0
7045,2011-10-26,4,0,10,4,0,5,5,3.6666666666666665
7046,2011-10-26,4,0,10,5,0,21,21,9.666666666666666
7047,2011-10-26,4,0,10,6,0,92,92,39.333333333333336
7048,2011-10-26,4,0,10,7,15,284,299,137.33333333333334
7049,2011-10-26,4,0,10,8,26,438,464,285.0
7050,2011-10-26,4,0,10,9,14,226,240,334.3333333333333
7051,2011-10-26,4,0,10,10,26,105,131,278.3333333333333
7052,2011-10-26,4,0,10,11,23,132,155,175.33333333333334
7053,2011-10-26,4,0,10,12,39,155,194,160.0
7054,2011-10-26,4,0,10,13,20,62,82,143.66666666666666
7055,2011-10-26,4,0,10,14,14,52,66,114.0
7056,2011-10-26,4,0,10,15,11,59,70,72.66666666666667
7057,2011-10-26,4,0,10,16,17,196,213,116.33333333333333
7058,2011-10-26,4,0,10,17,40,414,454,245.66666666666666
7059,2011-10-26,4,0,10,18,55,398,453,373.3333333333333
7060,2011-10-26,4,0,10,19,25,306,331,412.6666666666667
7061,2011-10-26,4,0,10,20,27,180,207,330.3333333333333
7062,2011-10-26,4,0,10,21,17,140,157,231.66666666666666
7063,2011-10-26,4,0,10,22,23,112,135,166.33333333333334
7064,2011-10-26,4,0,10,23,3,72,75,122.33333333333333
7065,2011-10-27,4,0,10,0,3,23,26,78.66666666666667
7066,2011-10-27,4,0,10,1,2,9,11,37.333333333333336
7067,2011-10-27,4,0,10,2,3,5,8,15.0
7068,2011-10-27,4,0,10,3,1,3,4,7.666666666666667
7069,2011-10-27,4,0,10,4,1,3,4,5.333333333333333
7070,2011-10-27,4,0,10,5,1,14,15,7.666666666666667
7071,2011-10-27,4,0,10,6,4,42,46,21.666666666666668
7072,2011-10-27,4,0,10,7,9,128,137,66.0
7073,2011-10-27,4,0,10,8,12,304,316,166.33333333333334
7074,2011-10-27,4,0,10,9,16,155,171,208.0
7075,2011-10-27,4,0,10,10,10,52,62,183.0
7076,2011-10-27,4,0,10,11,8,44,52,95.0
7077,2011-10-27,4,0,10,12,8,45,53,55.666666666666664
7078,2011-10-27,4,0,10,13,10,64,74,59.666666666666664
7079,2011-10-27,4,0,10,14,16,76,92,73.0
7080,2011-10-27,4,0,10,15,12,95,107,91.0
7081,2011-10-27,4,0,10,16,14,193,207,135.33333333333334
7082,2011-10-27,4,0,10,17,31,291,322,212.0
7083,2011-10-27,4,0,10,18,14,226,240,256.3333333333333
7084,2011-10-27,4,0,10,19,19,200,219,260.3333333333333
7085,2011-10-27,4,0,10,20,11,171,182,213.66666666666666
7086,2011-10-27,4,0,10,21,13,119,132,177.66666666666666
7087,2011-10-27,4,0,10,22,14,97,111,141.66666666666666
7088,2011-10-27,4,0,10,23,8,60,68,103.66666666666667
7089,2011-10-28,4,0,10,0,4,40,44,74.33333333333333
7090,2011-10-28,4,0,10,1,7,9,16,42.666666666666664
7091,2011-10-28,4,0,10,2,1,3,4,21.333333333333332
7092,2011-10-28,4,0,10,3,4,4,8,9.333333333333334
7093,2011-10-28,4,0,10,4,5,5,10,7.333333333333333
7094,2011-10-28,4,0,10,5,0,25,25,14.333333333333334
7095,2011-10-28,4,0,10,6,1,74,75,36.666666666666664
7096,2011-10-28,4,0,10,7,6,199,205,101.66666666666667
7097,2011-10-28,4,0,10,8,13,361,374,218.0
7098,2011-10-28,4,0,10,9,19,210,229,269.3333333333333
7099,2011-10-28,4,0,10,10,28,102,130,244.33333333333334
7100,2011-10-28,4,0,10,11,40,128,168,175.66666666666666
7101,2011-10-28,4,0,10,12,46,167,213,170.33333333333334
7102,2011-10-28,4,0,10,13,43,185,228,203.0
7103,2011-10-28,4,0,10,14,33,152,185,208.66666666666666
7104,2011-10-28,4,0,10,15,44,171,215,209.33333333333334
7105,2011-10-28,4,0,10,16,46,262,308,236.0
7106,2011-10-28,4,0,10,17,35,411,446,323.0
7107,2011-10-28,4,0,10,18,36,332,368,374.0
7108,2011-10-28,4,0,10,19,16,188,204,339.3333333333333
7109,2011-10-28,4,0,10,20,12,131,143,238.33333333333334
7110,2011-10-28,4,0,10,21,5,69,74,140.33333333333334
7111,2011-10-28,4,0,10,22,4,32,36,84.33333333333333
7112,2011-10-28,4,0,10,23,8,31,39,49.666666666666664
7113,2011-10-29,4,0,10,0,0,19,19,31.333333333333332
7114,2011-10-29,4,0,10,1,0,18,18,25.333333333333332
7115,2011-10-29,4,0,10,2,1,16,17,18.0
7116,2011-10-29,4,0,10,3,0,8,8,14.333333333333334
7117,2011-10-29,4,0,10,4,0,1,1,8.666666666666666
7118,2011-10-29,4,0,10,5,0,1,1,3.3333333333333335
7119,2011-10-29,4,0,10,6,4,1,5,2.3333333333333335
7120,2011-10-29,4,0,10,7,1,6,7,4.333333333333333
7121,2011-10-29,4,0,10,8,4,16,20,10.666666666666666
7122,2011-10-29,4,0,10,9,1,19,20,15.666666666666666
7123,2011-10-29,4,0,10,10,0,12,12,17.333333333333332
7124,2011-10-29,4,0,10,11,1,26,27,19.666666666666668
7125,2011-10-29,4,0,10,12,6,44,50,29.666666666666668
7126,2011-10-29,4,0,10,13,0,30,30,35.666666666666664
7127,2011-10-29,4,0,10,14,0,29,29,36.333333333333336
7128,2011-10-29,4,0,10,15,3,38,41,33.333333333333336
7129,2011-10-29,4,0,10,16,3,19,22,30.666666666666668
7130,2011-10-29,4,0,10,17,3,28,31,31.333333333333332
7131,2011-10-29,4,0,10,18,6,37,43,32.0
7132,2011-10-29,4,0,10,19,3,36,39,37.666666666666664
7133,2011-10-29,4,0,10,20,7,40,47,43.0
7134,2011-10-29,4,0,10,21,1,49,50,45.333333333333336
7135,2011-10-29,4,0,10,22,10,44,54,50.333333333333336
7136,2011-10-29,4,0,10,23,3,33,36,46.666666666666664
7137,2011-10-30,4,0,10,0,7,47,54,48.0
7138,2011-10-30,4,0,10,1,9,34,43,44.333333333333336
7139,2011-10-30,4,0,10,2,7,43,50,49.0
7140,2011-10-30,4,0,10,3,7,26,33,42.0
7141,2011-10-30,4,0,10,4,1,10,11,31.333333333333332
7142,2011-10-30,4,0,10,5,0,4,4,16.0
7143,2011-10-30,4,0,10,6,2,8,10,8.333333333333334
7144,2011-10-30,4,0,10,7,7,15,22,12.0
7145,2011-10-30,4,0,10,8,20,60,80,37.333333333333336
7146,2011-10-30,4,0,10,9,55,92,147,83.0
7147,2011-10-30,4,0,10,10,53,125,178,135.0
7148,2011-10-30,4,0,10,11,58,182,240,188.33333333333334
7149,2011-10-30,4,0,10,12,85,229,314,244.0
7150,2011-10-30,4,0,10,13,113,232,345,299.6666666666667
7151,2011-10-30,4,0,10,14,91,209,300,319.6666666666667
7152,2011-10-30,4,0,10,15,88,202,290,311.6666666666667
7153,2011-10-30,4,0,10,16,107,213,320,303.3333333333333
7154,2011-10-30,4,0,10,17,54,191,245,285.0
7155,2011-10-30,4,0,10,18,51,162,213,259.3333333333333
7156,2011-10-30,4,0,10,19,28,125,153,203.66666666666666
7157,2011-10-30,4,0,10,20,18,74,92,152.66666666666666
7158,2011-10-30,4,0,10,21,4,75,79,108.0
7159,2011-10-30,4,0,10,22,13,58,71,80.66666666666667
7160,2011-10-30,4,0,10,23,7,30,37,62.333333333333336
7161,2011-10-31,4,0,10,0,3,20,23,43.666666666666664
7162,2011-10-31,4,0,10,1,5,8,13,24.333333333333332
7163,2011-10-31,4,0,10,2,0,3,3,13.0
7164,2011-10-31,4,0,10,3,0,3,3,6.333333333333333
7165,2011-10-31,4,0,10,4,1,5,6,4.0
7166,2011-10-31,4,0,10,5,0,18,18,9.0
7167,2011-10-31,4,0,10,6,4,82,86,36.666666666666664
7168,2011-10-31,4,0,10,7,11,216,227,110.33333333333333
7169,2011-10-31,4,0,10,8,17,355,372,228.33333333333334
7170,2011-10-31,4,0,10,9,14,197,211,270.0
7171,2011-10-31,4,0,10,10,18,87,105,229.33333333333334
7172,2011-10-31,4,0,10,11,31,97,128,148.0
7173,2011-10-31,4,0,10,12,30,140,170,134.33333333333334
7174,2011-10-31,4,0,10,13,24,128,152,150.0
7175,2011-10-31,4,0,10,14,22,119,141,154.33333333333334
7176,2011-10-31,4,0,10,15,27,141,168,153.66666666666666
7177,2011-10-31,4,0,10,16,30,242,272,193.66666666666666
7178,2011-10-31,4,0,10,17,44,442,486,308.6666666666667
7179,2011-10-31,4,0,10,18,30,392,422,393.3333333333333
7180,2011-10-31,4,0,10,19,12,226,238,382.0
7181,2011-10-31,4,0,10,20,18,154,172,277.3333333333333
7182,2011-10-31,4,0,10,21,7,109,116,175.33333333333334
7183,2011-10-31,4,0,10,22,8,77,85,124.33333333333333
7184,2011-10-31,4,0,10,23,6,46,52,84.33333333333333
7185,2011-11-01,4,0,11,0,3,18,21,52.666666666666664
7186,2011-11-01,4,0,11,1,3,8,11,28.0
7187,2011-11-01,4,0,11,2,1,3,4,12.0
7188,2011-11-01,4,0,11,3,1,5,6,7.0
7189,2011-11-01,4,0,11,4,1,7,8,6.0
7190,2011-11-01,4,0,11,5,0,18,18,10.666666666666666
7191,2011-11-01,4,0,11,6,3,90,93,39.666666666666664
7192,2011-11-01,4,0,11,7,8,246,254,121.66666666666667
7193,2011-11-01,4,0,11,8,17,402,419,255.33333333333334
7194,2011-11-01,4,0,11,9,16,206,222,298.3333333333333
7195,2011-11-01,4,0,11,10,21,114,135,258.6666666666667
7196,2011-11-01,4,0,11,11,16,101,117,158.0
7197,2011-11-01,4,0,11,12,23,153,176,142.66666666666666
7198,2011-11-01,4,0,11,13,20,147,167,153.33333333333334
7199,2011-11-01,4,0,11,14,32,118,150,164.33333333333334
7200,2011-11-01,4,0,11,15,38,148,186,167.66666666666666
7201,2011-11-01,4,0,11,16,46,252,298,211.33333333333334
7202,2011-11-01,4,0,11,17,36,470,506,330.0
7203,2011-11-01,4,0,11,18,39,421,460,421.3333333333333
7204,2011-11-01,4,0,11,19,39,274,313,426.3333333333333
7205,2011-11-01,4,0,11,20,18,191,209,327.3333333333333
7206,2011-11-01,4,0,11,21,13,114,127,216.33333333333334
7207,2011-11-01,4,0,11,22,5,91,96,144.0
7208,2011-11-01,4,0,11,23,11,61,72,98.33333333333333
7209,2011-11-02,4,0,11,0,0,19,19,62.333333333333336
7210,2011-11-02,4,0,11,1,2,8,10,33.666666666666664
7211,2011-11-02,4,0,11,2,0,2,2,10.333333333333334
7212,2011-11-02,4,0,11,3,0,2,2,4.666666666666667
7213,2011-11-02,4,0,11,4,0,4,4,2.6666666666666665
7214,2011-11-02,4,0,11,5,0,27,27,11.0
7215,2011-11-02,4,0,11,6,1,91,92,41.0
7216,2011-11-02,4,0,11,7,11,240,251,123.33333333333333
7217,2011-11-02,4,0,11,8,20,452,472,271.6666666666667
7218,2011-11-02,4,0,11,9,15,213,228,317.0
7219,2011-11-02,4,0,11,10,25,108,133,277.6666666666667
7220,2011-11-02,4,0,11,11,27,117,144,168.33333333333334
7221,2011-11-02,4,0,11,12,32,157,189,155.33333333333334
7222,2011-11-02,4,0,11,13,22,139,161,164.66666666666666
7223,2011-11-02,4,0,11,14,40,132,172,174.0
7224,2011-11-02,4,0,11,15,26,161,187,173.33333333333334
7225,2011-11-02,4,0,11,16,35,231,266,208.33333333333334
7226,2011-11-02,4,0,11,17,30,523,553,335.3333333333333
7227,2011-11-02,4,0,11,18,31,448,479,432.6666666666667
7228,2011-11-02,4,0,11,19,25,257,282,438.0
7229,2011-11-02,4,0,11,20,5,177,182,314.3333333333333
7230,2011-11-02,4,0,11,21,13,155,168,210.66666666666666
7231,2011-11-02,4,0,11,22,7,99,106,152.0
7232,2011-11-02,4,0,11,23,3,54,57,110.33333333333333
7233,2011-11-03,4,0,11,0,3,28,31,64.66666666666667
7234,2011-11-03,4,0,11,1,3,12,15,34.333333333333336
7235,2011-11-03,4,0,11,2,2,5,7,17.666666666666668
7236,2011-11-03,4,0,11,3,1,4,5,9.0
7237,2011-11-03,4,0,11,4,1,3,4,5.333333333333333
7238,2011-11-03,4,0,11,5,1,27,28,12.333333333333334
7239,2011-11-03,4,0,11,6,3,96,99,43.666666666666664
7240,2011-11-03,4,0,11,7,12,280,292,139.66666666666666
7241,2011-11-03,4,0,11,8,8,394,402,264.3333333333333
7242,2011-11-03,4,0,11,9,9,155,164,286.0
7243,2011-11-03,4,0,11,10,12,98,110,225.33333333333334
7244,2011-11-03,4,0,11,11,12,108,120,131.33333333333334
7245,2011-11-03,4,0,11,12,17,162,179,136.33333333333334
7246,2011-11-03,4,0,11,13,19,150,169,156.0
7247,2011-11-03,4,0,11,14,32,120,152,166.66666666666666
7248,2011-11-03,4,0,11,15,24,138,162,161.0
7249,2011-11-03,4,0,11,16,33,234,267,193.66666666666666
7250,2011-11-03,4,0,11,17,33,465,498,309.0
7251,2011-11-03,4,0,11,18,24,409,433,399.3333333333333
7252,2011-11-03,4,0,11,19,18,234,252,394.3333333333333
7253,2011-11-03,4,0,11,20,11,198,209,298.0
7254,2011-11-03,4,0,11,21,4,140,144,201.66666666666666
7255,2011-11-03,4,0,11,22,21,116,137,163.33333333333334
7256,2011-11-03,4,0,11,23,15,80,95,125.33333333333333
7257,2011-11-04,4,0,11,0,11,32,43,91.66666666666667
7258,2011-11-04,4,0,11,1,1,16,17,51.666666666666664
7259,2011-11-04,4,0,11,2,2,8,10,23.333333333333332
7260,2011-11-04,4,0,11,3,1,7,8,11.666666666666666
7261,2011-11-04,4,0,11,4,1,6,7,8.333333333333334
7262,2011-11-04,4,0,11,5,0,23,23,12.666666666666666
7263,2011-11-04,4,0,11,6,2,64,66,32.0
7264,2011-11-04,4,0,11,7,10,235,245,111.33333333333333
7265,2011-11-04,4,0,11,8,8,387,395,235.33333333333334
7266,2011-11-04,4,0,11,9,15,239,254,298.0
7267,2011-11-04,4,0,11,10,19,115,134,261.0
7268,2011-11-04,4,0,11,11,34,128,162,183.33333333333334
7269,2011-11-04,4,0,11,12,44,153,197,164.33333333333334
7270,2011-11-04,4,0,11,13,33,161,194,184.33333333333334
7271,2011-11-04,4,0,11,14,54,147,201,197.33333333333334
7272,2011-11-04,4,0,11,15,45,192,237,210.66666666666666
7273,2011-11-04,4,0,11,16,53,237,290,242.66666666666666
7274,2011-11-04,4,0,11,17,42,438,480,335.6666666666667
7275,2011-11-04,4,0,11,18,35,339,374,381.3333333333333
7276,2011-11-04,4,0,11,19,14,182,196,350.0
7277,2011-11-04,4,0,11,20,15,171,186,252.0
7278,2011-11-04,4,0,11,21,8,115,123,168.33333333333334
7279,2011-11-04,4,0,11,22,6,109,115,141.33333333333334
7280,2011-11-04,4,0,11,23,17,72,89,109.0
7281,2011-11-05,4,0,11,0,4,48,52,85.33333333333333
7282,2011-11-05,4,0,11,1,5,57,62,67.66666666666667
7283,2011-11-05,4,0,11,2,7,24,31,48.333333333333336
7284,2011-11-05,4,0,11,3,0,8,8,33.666666666666664
7285,2011-11-05,4,0,11,4,3,5,8,15.666666666666666
7286,2011-11-05,4,0,11,5,0,2,2,6.0
7287,2011-11-05,4,0,11,6,3,20,23,11.0
7288,2011-11-05,4,0,11,7,3,31,34,19.666666666666668
7289,2011-11-05,4,0,11,8,4,80,84,47.0
7290,2011-11-05,4,0,11,9,30,111,141,86.33333333333333
7291,2011-11-05,4,0,11,10,56,171,227,150.66666666666666
7292,2011-11-05,4,0,11,11,69,169,238,202.0
7293,2011-11-05,4,0,11,12,137,235,372,279.0
7294,2011-11-05,4,0,11,13,148,207,355,321.6666666666667
7295,2011-11-05,4,0,11,14,159,227,386,371.0
7296,2011-11-05,4,0,11,15,141,202,343,361.3333333333333
7297,2011-11-05,4,0,11,16,128,207,335,354.6666666666667
7298,2011-11-05,4,0,11,17,100,234,334,337.3333333333333
7299,2011-11-05,4,0,11,18,52,185,237,302.0
7300,2011-11-05,4,0,11,19,45,159,204,258.3333333333333
7301,2011-11-05,4,0,11,20,29,136,165,202.0
7302,2011-11-05,4,0,11,21,19,99,118,162.33333333333334
7303,2011-11-05,4,0,11,22,10,72,82,121.66666666666667
7304,2011-11-05,4,0,11,23,4,81,85,95.0
7305,2011-11-06,4,0,11,0,10,65,75,80.66666666666667
7306,2011-11-06,4,0,11,1,11,104,115,91.66666666666667
7307,2011-11-06,4,0,11,2,6,23,29,73.0
7308,2011-11-06,4,0,11,3,5,4,9,51.0
7309,2011-11-06,4,0,11,4,0,6,6,14.666666666666666
7310,2011-11-06,4,0,11,5,0,5,5,6.666666666666667
7311,2011-11-06,4,0,11,6,5,11,16,9.0
7312,2011-11-06,4,0,11,7,4,24,28,16.333333333333332
7313,2011-11-06,4,0,11,8,19,71,90,44.666666666666664
7314,2011-11-06,4,0,11,9,36,134,170,96.0
7315,2011-11-06,4,0,11,10,76,186,262,174.0
7316,2011-11-06,4,0,11,11,104,216,320,250.66666666666666
7317,2011-11-06,4,0,11,12,120,226,346,309.3333333333333
7318,2011-11-06,4,0,11,13,105,209,314,326.6666666666667
7319,2011-11-06,4,0,11,14,101,219,320,326.6666666666667
7320,2011-11-06,4,0,11,15,96,210,306,313.3333333333333
7321,2011-11-06,4,0,11,16,84,263,347,324.3333333333333
7322,2011-11-06,4,0,11,17,71,185,256,303.0
7323,2011-11-06,4,0,11,18,39,146,185,262.6666666666667
7324,2011-11-06,4,0,11,19,21,130,151,197.33333333333334
7325,2011-11-06,4,0,11,20,16,100,116,150.66666666666666
7326,2011-11-06,4,0,11,21,11,77,88,118.33333333333333
7327,2011-11-06,4,0,11,22,5,40,45,83.0
7328,2011-11-06,4,0,11,23,7,43,50,61.0
7329,2011-11-07,4,0,11,0,1,14,15,36.666666666666664
7330,2011-11-07,4,0,11,1,2,6,8,24.333333333333332
7331,2011-11-07,4,0,11,2,0,2,2,8.333333333333334
7332,2011-11-07,4,0,11,3,0,3,3,4.333333333333333
7333,2011-11-07,4,0,11,4,2,4,6,3.6666666666666665
7334,2011-11-07,4,0,11,5,1,25,26,11.666666666666666
7335,2011-11-07,4,0,11,6,2,97,99,43.666666666666664
7336,2011-11-07,4,0,11,7,6,305,311,145.33333333333334
7337,2011-11-07,4,0,11,8,13,397,410,273.3333333333333
7338,2011-11-07,4,0,11,9,18,156,174,298.3333333333333
7339,2011-11-07,4,0,11,10,28,95,123,235.66666666666666
7340,2011-11-07,4,0,11,11,28,100,128,141.66666666666666
7341,2011-11-07,4,0,11,12,21,158,179,143.33333333333334
7342,2011-11-07,4,0,11,13,32,157,189,165.33333333333334
7343,2011-11-07,4,0,11,14,30,115,145,171.0
7344,2011-11-07,4,0,11,15,38,132,170,168.0
7345,2011-11-07,4,0,11,16,40,255,295,203.33333333333334
7346,2011-11-07,4,0,11,17,39,489,528,331.0
7347,2011-11-07,4,0,11,18,18,407,425,416.0
7348,2011-11-07,4,0,11,19,20,280,300,417.6666666666667
7349,2011-11-07,4,0,11,20,17,187,204,309.6666666666667
7350,2011-11-07,4,0,11,21,10,129,139,214.33333333333334
7351,2011-11-07,4,0,11,22,6,102,108,150.33333333333334
7352,2011-11-07,4,0,11,23,1,47,48,98.33333333333333
7353,2011-11-08,4,0,11,0,0,18,18,58.0
7354,2011-11-08,4,0,11,1,3,8,11,25.666666666666668
7355,2011-11-08,4,0,11,2,0,1,1,10.0
7356,2011-11-08,4,0,11,3,0,3,3,5.0
7357,2011-11-08,4,0,11,4,0,4,4,2.6666666666666665
7358,2011-11-08,4,0,11,5,1,17,18,8.333333333333334
7359,2011-11-08,4,0,11,6,3,96,99,40.333333333333336
7360,2011-11-08,4,0,11,7,7,316,323,146.66666666666666
7361,2011-11-08,4,0,11,8,11,455,466,296.0
7362,2011-11-08,4,0,11,9,14,177,191,326.6666666666667
7363,2011-11-08,4,0,11,10,25,104,129,262.0
7364,2011-11-08,4,0,11,11,21,126,147,155.66666666666666
7365,2011-11-08,4,0,11,12,28,175,203,159.66666666666666
7366,2011-11-08,4,0,11,13,31,165,196,182.0
7367,2011-11-08,4,0,11,14,32,129,161,186.66666666666666
7368,2011-11-08,4,0,11,15,33,155,188,181.66666666666666
7369,2011-11-08,4,0,11,16,39,250,289,212.66666666666666
7370,2011-11-08,4,0,11,17,40,459,499,325.3333333333333
7371,2011-11-08,4,0,11,18,30,432,462,416.6666666666667
7372,2011-11-08,4,0,11,19,14,264,278,413.0
7373,2011-11-08,4,0,11,20,12,169,181,307.0
7374,2011-11-08,4,0,11,21,16,166,182,213.66666666666666
7375,2011-11-08,4,0,11,22,13,95,108,157.0
7376,2011-11-08,4,0,11,23,3,45,48,112.66666666666667
7377,2011-11-09,4,0,11,0,0,13,13,56.333333333333336
7378,2011-11-09,4,0,11,1,0,10,10,23.666666666666668
7379,2011-11-09,4,0,11,2,0,5,5,9.333333333333334
7380,2011-11-09,4,0,11,3,0,4,4,6.333333333333333
7381,2011-11-09,4,0,11,4,0,4,4,4.333333333333333
7382,2011-11-09,4,0,11,5,0,28,28,12.0
7383,2011-11-09,4,0,11,6,0,98,98,43.333333333333336
7384,2011-11-09,4,0,11,7,0,300,300,142.0
7385,2011-11-09,4,0,11,8,19,437,456,284.6666666666667
7386,2011-11-09,4,0,11,9,22,197,219,325.0
7387,2011-11-09,4,0,11,10,16,89,105,260.0
7388,2011-11-09,4,0,11,11,21,131,152,158.66666666666666
7389,2011-11-09,4,0,11,12,24,156,180,145.66666666666666
7390,2011-11-09,4,0,11,13,31,136,167,166.33333333333334
7391,2011-11-09,4,0,11,14,26,153,179,175.33333333333334
7392,2011-11-09,4,0,11,15,21,130,151,165.66666666666666
7393,2011-11-09,4,0,11,16,24,257,281,203.66666666666666
7394,2011-11-09,4,0,11,17,27,458,485,305.6666666666667
7395,2011-11-09,4,0,11,18,21,387,408,391.3333333333333
7396,2011-11-09,4,0,11,19,12,292,304,399.0
7397,2011-11-09,4,0,11,20,18,201,219,310.3333333333333
7398,2011-11-09,4,0,11,21,9,152,161,228.0
7399,2011-11-09,4,0,11,22,9,105,114,164.66666666666666
7400,2011-11-09,4,0,11,23,5,61,66,113.66666666666667
7401,2011-11-10,4,0,11,0,0,24,24,68.0
7402,2011-11-10,4,0,11,1,1,10,11,33.666666666666664
7403,2011-11-10,4,0,11,2,0,5,5,13.333333333333334
7404,2011-11-10,4,0,11,3,0,11,11,9.0
7405,2011-11-10,4,0,11,4,1,2,3,6.333333333333333
7406,2011-11-10,4,0,11,5,1,22,23,12.333333333333334
7407,2011-11-10,4,0,11,6,4,110,114,46.666666666666664
7408,2011-11-10,4,0,11,7,6,266,272,136.33333333333334
7409,2011-11-10,4,0,11,8,18,418,436,274.0
7410,2011-11-10,4,0,11,9,23,188,211,306.3333333333333
7411,2011-11-10,4,0,11,10,17,100,117,254.66666666666666
7412,2011-11-10,4,0,11,11,9,99,108,145.33333333333334
7413,2011-11-10,4,0,11,12,18,149,167,130.66666666666666
7414,2011-11-10,4,0,11,13,9,87,96,123.66666666666667
7415,2011-11-10,4,0,11,14,6,58,64,109.0
7416,2011-11-10,4,0,11,15,5,57,62,74.0
7417,2011-11-10,4,0,11,16,6,67,73,66.33333333333333
7418,2011-11-10,4,0,11,17,9,168,177,104.0
7419,2011-11-10,4,0,11,18,10,263,273,174.33333333333334
7420,2011-11-10,4,0,11,19,19,192,211,220.33333333333334
7421,2011-11-10,4,0,11,20,8,160,168,217.33333333333334
7422,2011-11-10,4,0,11,21,6,130,136,171.66666666666666
7423,2011-11-10,4,0,11,22,5,84,89,131.0
7424,2011-11-10,4,0,11,23,9,73,82,102.33333333333333
7425,2011-11-11,4,0,11,0,10,56,66,79.0
7426,2011-11-11,4,0,11,1,3,16,19,55.666666666666664
7427,2011-11-11,4,0,11,2,1,10,11,32.0
7428,2011-11-11,4,0,11,3,0,6,6,12.0
7429,2011-11-11,4,0,11,4,0,8,8,8.333333333333334
7430,2011-11-11,4,0,11,5,0,13,13,9.0
7431,2011-11-11,4,0,11,6,0,46,46,22.333333333333332
7432,2011-11-11,4,0,11,7,5,116,121,60.0
7433,2011-11-11,4,0,11,8,9,249,258,141.66666666666666
7434,2011-11-11,4,0,11,9,15,186,201,193.33333333333334
7435,2011-11-11,4,0,11,10,38,162,200,219.66666666666666
7436,2011-11-11,4,0,11,11,20,150,170,190.33333333333334
7437,2011-11-11,4,0,11,12,41,198,239,203.0
7438,2011-11-11,4,0,11,13,57,179,236,215.0
7439,2011-11-11,4,0,11,14,64,183,247,240.66666666666666
7440,2011-11-11,4,0,11,15,29,187,216,233.0
7441,2011-11-11,4,0,11,16,49,189,238,233.66666666666666
7442,2011-11-11,4,0,11,17,24,286,310,254.66666666666666
7443,2011-11-11,4,0,11,18,23,185,208,252.0
7444,2011-11-11,4,0,11,19,17,182,199,239.0
7445,2011-11-11,4,0,11,20,12,97,109,172.0
7446,2011-11-11,4,0,11,21,4,79,83,130.33333333333334
7447,2011-11-11,4,0,11,22,13,78,91,94.33333333333333
7448,2011-11-11,4,0,11,23,6,67,73,82.33333333333333
7449,2011-11-12,4,0,11,0,12,52,64,76.0
7450,2011-11-12,4,0,11,1,9,45,54,63.666666666666664
7451,2011-11-12,4,0,11,2,7,39,46,54.666666666666664
7452,2011-11-12,4,0,11,3,4,13,17,39.0
7453,2011-11-12,4,0,11,4,0,7,7,23.333333333333332
7454,2011-11-12,4,0,11,5,1,3,4,9.333333333333334
7455,2011-11-12,4,0,11,6,0,7,7,6.0
7456,2011-11-12,4,0,11,7,3,24,27,12.666666666666666
7457,2011-11-12,4,0,11,8,14,87,101,45.0
7458,2011-11-12,4,0,11,9,18,142,160,96.0
7459,2011-11-12,4,0,11,10,62,170,232,164.33333333333334
7460,2011-11-12,4,0,11,11,102,213,315,235.66666666666666
7461,2011-11-12,4,0,11,12,142,224,366,304.3333333333333
7462,2011-11-12,4,0,11,13,128,225,353,344.6666666666667
7463,2011-11-12,4,0,11,14,191,244,435,384.6666666666667
7464,2011-11-12,4,0,11,15,165,221,386,391.3333333333333
7465,2011-11-12,4,0,11,16,137,224,361,394.0
7466,2011-11-12,4,0,11,17,92,193,285,344.0
7467,2011-11-12,4,0,11,18,53,150,203,283.0
7468,2011-11-12,4,0,11,19,32,139,171,219.66666666666666
7469,2011-11-12,4,0,11,20,31,101,132,168.66666666666666
7470,2011-11-12,4,0,11,21,19,103,122,141.66666666666666
7471,2011-11-12,4,0,11,22,30,88,118,124.0
7472,2011-11-12,4,0,11,23,23,78,101,113.66666666666667
7473,2011-11-13,4,0,11,0,12,61,73,97.33333333333333
7474,2011-11-13,4,0,11,1,13,58,71,81.66666666666667
7475,2011-11-13,4,0,11,2,9,48,57,67.0
7476,2011-11-13,4,0,11,3,8,20,28,52.0
7477,2011-11-13,4,0,11,4,1,5,6,30.333333333333332
7478,2011-11-13,4,0,11,5,2,3,5,13.0
7479,2011-11-13,4,0,11,6,5,18,23,11.333333333333334
7480,2011-11-13,4,0,11,7,13,30,43,23.666666666666668
7481,2011-11-13,4,0,11,8,24,55,79,48.333333333333336
7482,2011-11-13,4,0,11,9,38,97,135,85.66666666666667
7483,2011-11-13,4,0,11,10,63,178,241,151.66666666666666
7484,2011-11-13,4,0,11,11,108,187,295,223.66666666666666
7485,2011-11-13,4,0,11,12,112,242,354,296.6666666666667
7486,2011-11-13,4,0,11,13,105,234,339,329.3333333333333
7487,2011-11-13,4,0,11,14,108,263,371,354.6666666666667
7488,2011-11-13,4,0,11,15,89,221,310,340.0
7489,2011-11-13,4,0,11,16,93,226,319,333.3333333333333
7490,2011-11-13,4,0,11,17,44,187,231,286.6666666666667
7491,2011-11-13,4,0,11,18,35,155,190,246.66666666666666
7492,2011-11-13,4,0,11,19,36,121,157,192.66666666666666
7493,2011-11-13,4,0,11,20,24,115,139,162.0
7494,2011-11-13,4,0,11,21,19,76,95,130.33333333333334
7495,2011-11-13,4,0,11,22,25,64,89,107.66666666666667
7496,2011-11-13,4,0,11,23,18,49,67,83.66666666666667
7497,2011-11-14,4,0,11,0,8,22,30,62.0
7498,2011-11-14,4,0,11,1,5,6,11,36.0
7499,2011-11-14,4,0,11,2,7,10,17,19.333333333333332
7500,2011-11-14,4,0,11,3,4,3,7,11.666666666666666
7501,2011-11-14,4,0,11,4,0,5,5,9.666666666666666
7502,2011-11-14,4,0,11,5,0,19,19,10.333333333333334
7503,2011-11-14,4,0,11,6,10,104,114,46.0
7504,2011-11-14,4,0,11,7,11,311,322,151.66666666666666
7505,2011-11-14,4,0,11,8,27,425,452,296.0
7506,2011-11-14,4,0,11,9,29,204,233,335.6666666666667
7507,2011-11-14,4,0,11,10,26,85,111,265.3333333333333
7508,2011-11-14,4,0,11,11,22,106,128,157.33333333333334
7509,2011-11-14,4,0,11,12,36,166,202,147.0
7510,2011-11-14,4,0,11,13,50,153,203,177.66666666666666
7511,2011-11-14,4,0,11,14,47,138,185,196.66666666666666
7512,2011-11-14,4,0,11,15,53,142,195,194.33333333333334
7513,2011-11-14,4,0,11,16,51,264,315,231.66666666666666
7514,2011-11-14,4,0,11,17,55,464,519,343.0
7515,2011-11-14,4,0,11,18,29,460,489,441.0
7516,2011-11-14,4,0,11,19,28,274,302,436.6666666666667
7517,2011-11-14,4,0,11,20,30,210,240,343.6666666666667
7518,2011-11-14,4,0,11,21,37,176,213,251.66666666666666
7519,2011-11-14,4,0,11,22,17,96,113,188.66666666666666
7520,2011-11-14,4,0,11,23,13,48,61,129.0
7521,2011-11-15,4,0,11,0,7,15,22,65.33333333333333
7522,2011-11-15,4,0,11,1,5,5,10,31.0
7523,2011-11-15,4,0,11,2,7,8,15,15.666666666666666
7524,2011-11-15,4,0,11,3,0,4,4,9.666666666666666
7525,2011-11-15,4,0,11,4,1,6,7,8.666666666666666
7526,2011-11-15,4,0,11,5,2,26,28,13.0
7527,2011-11-15,4,0,11,6,4,104,108,47.666666666666664
7528,2011-11-15,4,0,11,7,21,298,319,151.66666666666666
7529,2011-11-15,4,0,11,8,27,453,480,302.3333333333333
7530,2011-11-15,4,0,11,9,26,174,200,333.0
7531,2011-11-15,4,0,11,10,23,115,138,272.6666666666667
7532,2011-11-15,4,0,11,11,18,116,134,157.33333333333334
7533,2011-11-15,4,0,11,12,28,148,176,149.33333333333334
7534,2011-11-15,4,0,11,13,21,132,153,154.33333333333334
7535,2011-11-15,4,0,11,14,27,120,147,158.66666666666666
7536,2011-11-15,4,0,11,15,36,155,191,163.66666666666666
7537,2011-11-15,4,0,11,16,31,240,271,203.0
7538,2011-11-15,4,0,11,17,29,422,451,304.3333333333333
7539,2011-11-15,4,0,11,18,27,414,441,387.6666666666667
7540,2011-11-15,4,0,11,19,27,259,286,392.6666666666667
7541,2011-11-15,4,0,11,20,26,212,238,321.6666666666667
7542,2011-11-15,4,0,11,21,23,145,168,230.66666666666666
7543,2011-11-15,4,0,11,22,19,109,128,178.0
7544,2011-11-15,4,0,11,23,14,66,80,125.33333333333333
7545,2011-11-16,4,0,11,0,5,26,31,79.66666666666667
7546,2011-11-16,4,0,11,1,0,5,5,38.666666666666664
7547,2011-11-16,4,0,11,2,4,6,10,15.333333333333334
7548,2011-11-16,4,0,11,3,2,3,5,6.666666666666667
7549,2011-11-16,4,0,11,4,1,3,4,6.333333333333333
7550,2011-11-16,4,0,11,5,0,13,13,7.333333333333333
7551,2011-11-16,4,0,11,6,4,52,56,24.333333333333332
7552,2011-11-16,4,0,11,7,7,130,137,68.66666666666667
7553,2011-11-16,4,0,11,8,9,223,232,141.66666666666666
7554,2011-11-16,4,0,11,9,5,77,82,150.33333333333334
7555,2011-11-16,4,0,11,10,4,32,36,116.66666666666667
7556,2011-11-16,4,0,11,11,7,53,60,59.333333333333336
7557,2011-11-16,4,0,11,12,5,49,54,50.0
7558,2011-11-16,4,0,11,13,6,52,58,57.333333333333336
7559,2011-11-16,4,0,11,14,12,49,61,57.666666666666664
7560,2011-11-16,4,0,11,15,16,50,66,61.666666666666664
7561,2011-11-16,4,0,11,16,13,110,123,83.33333333333333
7562,2011-11-16,4,0,11,17,17,216,233,140.66666666666666
7563,2011-11-16,4,0,11,18,13,176,189,181.66666666666666
7564,2011-11-16,4,0,11,19,3,108,111,177.66666666666666
7565,2011-11-16,4,0,11,20,5,94,99,133.0
7566,2011-11-16,4,0,11,21,3,72,75,95.0
7567,2011-11-16,4,0,11,22,1,45,46,73.33333333333333
7568,2011-11-16,4,0,11,23,3,28,31,50.666666666666664
7569,2011-11-17,4,0,11,0,2,22,24,33.666666666666664
7570,2011-11-17,4,0,11,1,0,5,5,20.0
7571,2011-11-17,4,0,11,2,0,5,5,11.333333333333334
7572,2011-11-17,4,0,11,3,0,3,3,4.333333333333333
7573,2011-11-17,4,0,11,4,1,3,4,4.0
7574,2011-11-17,4,0,11,5,1,21,22,9.666666666666666
7575,2011-11-17,4,0,11,6,3,72,75,33.666666666666664
7576,2011-11-17,4,0,11,7,4,164,168,88.33333333333333
7577,2011-11-17,4,0,11,8,12,343,355,199.33333333333334
7578,2011-11-17,4,0,11,9,14,184,198,240.33333333333334
7579,2011-11-17,4,0,11,10,7,74,81,211.33333333333334
7580,2011-11-17,4,0,11,11,4,93,97,125.33333333333333
7581,2011-11-17,4,0,11,12,6,115,121,99.66666666666667
7582,2011-11-17,4,0,11,13,15,109,124,114.0
7583,2011-11-17,4,0,11,14,5,105,110,118.33333333333333
7584,2011-11-17,4,0,11,15,10,106,116,116.66666666666667
7585,2011-11-17,4,0,11,16,8,187,195,140.33333333333334
7586,2011-11-17,4,0,11,17,20,379,399,236.66666666666666
7587,2011-11-17,4,0,11,18,9,298,307,300.3333333333333
7588,2011-11-17,4,0,11,19,7,210,217,307.6666666666667
7589,2011-11-17,4,0,11,20,7,162,169,231.0
7590,2011-11-17,4,0,11,21,3,113,116,167.33333333333334
7591,2011-11-17,4,0,11,22,1,83,84,123.0
7592,2011-11-17,4,0,11,23,0,58,58,86.0
7593,2011-11-18,4,0,11,0,2,28,30,57.333333333333336
7594,2011-11-18,4,0,11,1,0,10,10,32.666666666666664
7595,2011-11-18,4,0,11,2,2,8,10,16.666666666666668
7596,2011-11-18,4,0,11,3,0,2,2,7.333333333333333
7597,2011-11-18,4,0,11,4,0,5,5,5.666666666666667
7598,2011-11-18,4,0,11,5,0,22,22,9.666666666666666
7599,2011-11-18,4,0,11,6,1,70,71,32.666666666666664
7600,2011-11-18,4,0,11,7,5,211,216,103.0
7601,2011-11-18,4,0,11,8,6,369,375,220.66666666666666
7602,2011-11-18,4,0,11,9,6,207,213,268.0
7603,2011-11-18,4,0,11,10,10,105,115,234.33333333333334
7604,2011-11-18,4,0,11,11,18,122,140,156.0
7605,2011-11-18,4,0,11,12,22,143,165,140.0
7606,2011-11-18,4,0,11,13,31,146,177,160.66666666666666
7607,2011-11-18,4,0,11,14,31,123,154,165.33333333333334
7608,2011-11-18,4,0,11,15,27,151,178,169.66666666666666
7609,2011-11-18,4,0,11,16,19,190,209,180.33333333333334
7610,2011-11-18,4,0,11,17,17,361,378,255.0
7611,2011-11-18,4,0,11,18,16,312,328,305.0
7612,2011-11-18,4,0,11,19,7,183,190,298.6666666666667
7613,2011-11-18,4,0,11,20,8,129,137,218.33333333333334
7614,2011-11-18,4,0,11,21,3,108,111,146.0
7615,2011-11-18,4,0,11,22,9,88,97,115.0
7616,2011-11-18,4,0,11,23,5,54,59,89.0
7617,2011-11-19,4,0,11,0,4,49,53,69.66666666666667
7618,2011-11-19,4,0,11,1,1,34,35,49.0
7619,2011-11-19,4,0,11,2,12,34,46,44.666666666666664
7620,2011-11-19,4,0,11,3,4,11,15,32.0
7621,2011-11-19,4,0,11,4,4,4,8,23.0
7622,2011-11-19,4,0,11,5,0,2,2,8.333333333333334
7623,2011-11-19,4,0,11,6,2,10,12,7.333333333333333
7624,2011-11-19,4,0,11,7,3,38,41,18.333333333333332
7625,2011-11-19,4,0,11,8,12,80,92,48.333333333333336
7626,2011-11-19,4,0,11,9,12,130,142,91.66666666666667
7627,2011-11-19,4,0,11,10,35,165,200,144.66666666666666
7628,2011-11-19,4,0,11,11,50,183,233,191.66666666666666
7629,2011-11-19,4,0,11,12,93,218,311,248.0
7630,2011-11-19,4,0,11,13,118,245,363,302.3333333333333
7631,2011-11-19,4,0,11,14,121,228,349,341.0
7632,2011-11-19,4,0,11,15,120,262,382,364.6666666666667
7633,2011-11-19,4,0,11,16,99,188,287,339.3333333333333
7634,2011-11-19,4,0,11,17,61,171,232,300.3333333333333
7635,2011-11-19,4,0,11,18,36,172,208,242.33333333333334
7636,2011-11-19,4,0,11,19,33,149,182,207.33333333333334
7637,2011-11-19,4,0,11,20,48,115,163,184.33333333333334
7638,2011-11-19,4,0,11,21,29,79,108,151.0
7639,2011-11-19,4,0,11,22,26,80,106,125.66666666666667
7640,2011-11-19,4,0,11,23,20,73,93,102.33333333333333
7641,2011-11-20,4,0,11,0,14,79,93,97.33333333333333
7642,2011-11-20,4,0,11,1,11,73,84,90.0
7643,2011-11-20,4,0,11,2,12,44,56,77.66666666666667
7644,2011-11-20,4,0,11,3,6,31,37,59.0
7645,2011-11-20,4,0,11,4,2,10,12,35.0
7646,2011-11-20,4,0,11,5,0,4,4,17.666666666666668
7647,2011-11-20,4,0,11,6,3,6,9,8.333333333333334
7648,2011-11-20,4,0,11,7,4,19,23,12.0
7649,2011-11-20,4,0,11,8,13,52,65,32.333333333333336
7650,2011-11-20,4,0,11,9,29,109,138,75.33333333333333
7651,2011-11-20,4,0,11,10,46,183,229,144.0
7652,2011-11-20,4,0,11,11,74,212,286,217.66666666666666
7653,2011-11-20,4,0,11,12,70,234,304,273.0
7654,2011-11-20,4,0,11,13,84,285,369,319.6666666666667
7655,2011-11-20,4,0,11,14,113,250,363,345.3333333333333
7656,2011-11-20,4,0,11,15,109,242,351,361.0
7657,2011-11-20,4,0,11,16,81,225,306,340.0
7658,2011-11-20,4,0,11,17,35,168,203,286.6666666666667
7659,2011-11-20,4,0,11,18,22,123,145,218.0
7660,2011-11-20,4,0,11,19,17,140,157,168.33333333333334
7661,2011-11-20,4,0,11,20,23,90,113,138.33333333333334
7662,2011-11-20,4,0,11,21,11,94,105,125.0
7663,2011-11-20,4,0,11,22,5,35,40,86.0
7664,2011-11-20,4,0,11,23,3,25,28,57.666666666666664
7665,2011-11-21,4,0,11,0,4,13,17,28.333333333333332
7666,2011-11-21,4,0,11,1,4,8,12,19.0
7667,2011-11-21,4,0,11,2,1,2,3,10.666666666666666
7668,2011-11-21,4,0,11,3,0,4,4,6.333333333333333
7669,2011-11-21,4,0,11,4,0,5,5,4.0
7670,2011-11-21,4,0,11,5,0,20,20,9.666666666666666
7671,2011-11-21,4,0,11,6,0,76,76,33.666666666666664
7672,2011-11-21,4,0,11,7,17,229,246,114.0
7673,2011-11-21,4,0,11,8,13,378,391,237.66666666666666
7674,2011-11-21,4,0,11,9,15,222,237,291.3333333333333
7675,2011-11-21,4,0,11,10,25,110,135,254.33333333333334
7676,2011-11-21,4,0,11,11,16,112,128,166.66666666666666
7677,2011-11-21,4,0,11,12,24,138,162,141.66666666666666
7678,2011-11-21,4,0,11,13,13,121,134,141.33333333333334
7679,2011-11-21,4,0,11,14,14,121,135,143.66666666666666
7680,2011-11-21,4,0,11,15,15,93,108,125.66666666666667
7681,2011-11-21,4,0,11,16,13,95,108,117.0
7682,2011-11-21,4,0,11,17,10,200,210,142.0
7683,2011-11-21,4,0,11,18,8,184,192,170.0
7684,2011-11-21,4,0,11,19,2,135,137,179.66666666666666
7685,2011-11-21,4,0,11,20,5,75,80,136.33333333333334
7686,2011-11-21,4,0,11,21,11,103,114,110.33333333333333
7687,2011-11-21,4,0,11,22,6,72,78,90.66666666666667
7688,2011-11-21,4,0,11,23,4,29,33,75.0
7689,2011-11-22,4,0,11,0,0,14,14,41.666666666666664
7690,2011-11-22,4,0,11,1,1,5,6,17.666666666666668
7691,2011-11-22,4,0,11,2,2,4,6,8.666666666666666
7692,2011-11-22,4,0,11,3,1,2,3,5.0
7693,2011-11-22,4,0,11,4,0,7,7,5.333333333333333
7694,2011-11-22,4,0,11,5,1,17,18,9.333333333333334
7695,2011-11-22,4,0,11,6,1,63,64,29.666666666666668
7696,2011-11-22,4,0,11,7,2,119,121,67.66666666666667
7697,2011-11-22,4,0,11,8,5,185,190,125.0
7698,2011-11-22,4,0,11,9,2,147,149,153.33333333333334
7699,2011-11-22,4,0,11,10,6,46,52,130.33333333333334
7700,2011-11-22,4,0,11,11,4,28,32,77.66666666666667
7701,2011-11-22,4,0,11,12,3,18,21,35.0
7702,2011-11-22,4,0,11,13,4,22,26,26.333333333333332
7703,2011-11-22,4,0,11,14,4,31,35,27.333333333333332
7704,2011-11-22,4,0,11,15,2,32,34,31.666666666666668
7705,2011-11-22,4,0,11,16,3,59,62,43.666666666666664
7706,2011-11-22,4,0,11,17,4,161,165,87.0
7707,2011-11-22,4,0,11,18,0,148,148,125.0
7708,2011-11-22,4,0,11,19,5,106,111,141.33333333333334
7709,2011-11-22,4,0,11,20,6,121,127,128.66666666666666
7710,2011-11-22,4,0,11,21,4,86,90,109.33333333333333
7711,2011-11-22,4,0,11,22,6,81,87,101.33333333333333
7712,2011-11-22,4,0,11,23,3,36,39,72.0
7713,2011-11-23,4,0,11,0,2,14,16,47.333333333333336
7714,2011-11-23,4,0,11,1,0,8,8,21.0
7715,2011-11-23,4,0,11,2,1,5,6,10.0
7716,2011-11-23,4,0,11,3,1,2,3,5.666666666666667
7717,2011-11-23,4,0,11,4,0,5,5,4.666666666666667
7718,2011-11-23,4,0,11,5,1,16,17,8.333333333333334
7719,2011-11-23,4,0,11,6,1,68,69,30.333333333333332
7720,2011-11-23,4,0,11,7,2,154,156,80.66666666666667
7721,2011-11-23,4,0,11,8,7,316,323,182.66666666666666
7722,2011-11-23,4,0,11,9,3,164,167,215.33333333333334
7723,2011-11-23,4,0,11,10,6,70,76,188.66666666666666
7724,2011-11-23,4,0,11,11,9,107,116,119.66666666666667
7725,2011-11-23,4,0,11,12,9,151,160,117.33333333333333
7726,2011-11-23,4,0,11,13,12,162,174,150.0
7727,2011-11-23,4,0,11,14,13,200,213,182.33333333333334
7728,2011-11-23,4,0,11,15,13,194,207,198.0
7729,2011-11-23,4,0,11,16,4,169,173,197.66666666666666
7730,2011-11-23,4,0,11,17,7,156,163,181.0
7731,2011-11-23,4,0,11,18,7,138,145,160.33333333333334
7732,2011-11-23,4,0,11,19,6,116,122,143.33333333333334
7733,2011-11-23,4,0,11,20,1,67,68,111.66666666666667
7734,2011-11-23,4,0,11,21,0,66,66,85.33333333333333
7735,2011-11-23,4,0,11,22,3,59,62,65.33333333333333
7736,2011-11-23,4,0,11,23,4,47,51,59.666666666666664
7737,2011-11-24,4,0,11,0,1,22,23,45.333333333333336
7738,2011-11-24,4,0,11,1,1,23,24,32.666666666666664
7739,2011-11-24,4,0,11,2,3,19,22,23.0
7740,2011-11-24,4,0,11,3,1,4,5,17.0
7741,2011-11-24,4,0,11,4,1,1,2,9.666666666666666
7742,2011-11-24,4,0,11,5,1,10,11,6.0
7743,2011-11-24,4,0,11,6,1,5,6,6.333333333333333
7744,2011-11-24,4,0,11,7,9,31,40,19.0
7745,2011-11-24,4,0,11,8,4,42,46,30.666666666666668
7746,2011-11-24,4,0,11,9,13,68,81,55.666666666666664
7747,2011-11-24,4,0,11,10,34,64,98,75.0
7748,2011-11-24,4,0,11,11,52,90,142,107.0
7749,2011-11-24,4,0,11,12,62,88,150,130.0
7750,2011-11-24,4,0,11,13,84,91,175,155.66666666666666
7751,2011-11-24,4,0,11,14,74,94,168,164.33333333333334
7752,2011-11-24,4,0,11,15,78,71,149,164.0
7753,2011-11-24,4,0,11,16,48,66,114,143.66666666666666
7754,2011-11-24,4,0,11,17,34,40,74,112.33333333333333
7755,2011-11-24,4,0,11,18,13,24,37,75.0
7756,2011-11-24,4,0,11,19,15,13,28,46.333333333333336
7757,2011-11-24,4,0,11,20,14,17,31,32.0
7758,2011-11-24,4,0,11,21,7,19,26,28.333333333333332
7759,2011-11-24,4,0,11,22,8,14,22,26.333333333333332
7760,2011-11-24,4,0,11,23,2,19,21,23.0
7761,2011-11-25,4,0,11,0,7,22,29,24.0
7762,2011-11-25,4,0,11,1,2,12,14,21.333333333333332
7763,2011-11-25,4,0,11,2,4,6,10,17.666666666666668
7764,2011-11-25,4,0,11,3,0,2,2,8.666666666666666
7765,2011-11-25,4,0,11,4,4,3,7,6.333333333333333
7766,2011-11-25,4,0,11,5,2,3,5,4.666666666666667
7767,2011-11-25,4,0,11,6,4,9,13,8.333333333333334
7768,2011-11-25,4,0,11,7,4,31,35,17.666666666666668
7769,2011-11-25,4,0,11,8,6,68,74,40.666666666666664
7770,2011-11-25,4,0,11,9,25,70,95,68.0
7771,2011-11-25,4,0,11,10,60,82,142,103.66666666666667
7772,2011-11-25,4,0,11,11,99,127,226,154.33333333333334
7773,2011-11-25,4,0,11,12,126,146,272,213.33333333333334
7774,2011-11-25,4,0,11,13,143,140,283,260.3333333333333
7775,2011-11-25,4,0,11,14,122,150,272,275.6666666666667
7776,2011-11-25,4,0,11,15,165,145,310,288.3333333333333
7777,2011-11-25,4,0,11,16,122,139,261,281.0
7778,2011-11-25,4,0,11,17,57,127,184,251.66666666666666
7779,2011-11-25,4,0,11,18,45,108,153,199.33333333333334
7780,2011-11-25,4,0,11,19,38,96,134,157.0
7781,2011-11-25,4,0,11,20,19,76,95,127.33333333333333
7782,2011-11-25,4,0,11,21,24,61,85,104.66666666666667
7783,2011-11-25,4,0,11,22,12,46,58,79.33333333333333
7784,2011-11-25,4,0,11,23,5,28,33,58.666666666666664
7785,2011-11-26,4,0,11,0,9,38,47,46.0
7786,2011-11-26,4,0,11,1,5,24,29,36.333333333333336
7787,2011-11-26,4,0,11,2,3,20,23,33.0
7788,2011-11-26,4,0,11,3,8,9,17,23.0
7789,2011-11-26,4,0,11,4,0,4,4,14.666666666666666
7790,2011-11-26,4,0,11,5,0,3,3,8.0
7791,2011-11-26,4,0,11,6,2,8,10,5.666666666666667
7792,2011-11-26,4,0,11,7,4,13,17,10.0
7793,2011-11-26,4,0,11,8,10,50,60,29.0
7794,2011-11-26,4,0,11,9,16,67,83,53.333333333333336
7795,2011-11-26,4,0,11,10,57,84,141,94.66666666666667
7796,2011-11-26,4,0,11,11,107,123,230,151.33333333333334
7797,2011-11-26,4,0,11,12,137,172,309,226.66666666666666
7798,2011-11-26,4,0,11,13,177,148,325,288.0
7799,2011-11-26,4,0,11,14,141,158,299,311.0
7800,2011-11-26,4,0,11,15,154,160,314,312.6666666666667
7801,2011-11-26,4,0,11,16,137,138,275,296.0
7802,2011-11-26,4,0,11,17,62,122,184,257.6666666666667
7803,2011-11-26,4,0,11,18,67,118,185,214.66666666666666
7804,2011-11-26,4,0,11,19,46,100,146,171.66666666666666
7805,2011-11-26,4,0,11,20,55,86,141,157.33333333333334
7806,2011-11-26,4,0,11,21,20,72,92,126.33333333333333
7807,2011-11-26,4,0,11,22,14,51,65,99.33333333333333
7808,2011-11-26,4,0,11,23,18,51,69,75.33333333333333
7809,2011-11-27,4,0,11,0,7,39,46,60.0
7810,2011-11-27,4,0,11,1,9,35,44,53.0
7811,2011-11-27,4,0,11,2,9,22,31,40.333333333333336
7812,2011-11-27,4,0,11,3,9,8,17,30.666666666666668
7813,2011-11-27,4,0,11,4,0,4,4,17.333333333333332
7814,2011-11-27,4,0,11,5,0,5,5,8.666666666666666
7815,2011-11-27,4,0,11,6,0,9,9,6.0
7816,2011-11-27,4,0,11,7,12,11,23,12.333333333333334
7817,2011-11-27,4,0,11,8,6,36,42,24.666666666666668
7818,2011-11-27,4,0,11,9,21,90,111,58.666666666666664
7819,2011-11-27,4,0,11,10,58,131,189,114.0
7820,2011-11-27,4,0,11,11,83,157,240,180.0
7821,2011-11-27,4,0,11,12,63,193,256,228.33333333333334
7822,2011-11-27,4,0,11,13,97,216,313,269.6666666666667
7823,2011-11-27,4,0,11,14,113,200,313,294.0
7824,2011-11-27,4,0,11,15,96,221,317,314.3333333333333
7825,2011-11-27,4,0,11,16,94,229,323,317.6666666666667
7826,2011-11-27,4,0,11,17,37,167,204,281.3333333333333
7827,2011-11-27,4,0,11,18,25,130,155,227.33333333333334
7828,2011-11-27,4,0,11,19,30,109,139,166.0
7829,2011-11-27,4,0,11,20,10,94,104,132.66666666666666
7830,2011-11-27,4,0,11,21,13,75,88,110.33333333333333
7831,2011-11-27,4,0,11,22,13,53,66,86.0
7832,2011-11-27,4,0,11,23,5,27,32,62.0
7833,2011-11-28,4,0,11,0,6,10,16,38.0
7834,2011-11-28,4,0,11,1,1,12,13,20.333333333333332
7835,2011-11-28,4,0,11,3,1,4,5,11.333333333333334
7836,2011-11-28,4,0,11,4,0,4,4,7.333333333333333
7837,2011-11-28,4,0,11,5,0,34,34,14.333333333333334
7838,2011-11-28,4,0,11,6,6,98,104,47.333333333333336
7839,2011-11-28,4,0,11,7,7,270,277,138.33333333333334
7840,2011-11-28,4,0,11,8,13,394,407,262.6666666666667
7841,2011-11-28,4,0,11,9,17,191,208,297.3333333333333
7842,2011-11-28,4,0,11,10,21,86,107,240.66666666666666
7843,2011-11-28,4,0,11,11,11,107,118,144.33333333333334
7844,2011-11-28,4,0,11,12,13,165,178,134.33333333333334
7845,2011-11-28,4,0,11,13,25,137,162,152.66666666666666
7846,2011-11-28,4,0,11,14,14,129,143,161.0
7847,2011-11-28,4,0,11,15,18,132,150,151.66666666666666
7848,2011-11-28,4,0,11,16,24,240,264,185.66666666666666
7849,2011-11-28,4,0,11,17,24,444,468,294.0
7850,2011-11-28,4,0,11,18,20,396,416,382.6666666666667
7851,2011-11-28,4,0,11,19,4,260,264,382.6666666666667
7852,2011-11-28,4,0,11,20,12,206,218,299.3333333333333
7853,2011-11-28,4,0,11,21,4,152,156,212.66666666666666
7854,2011-11-28,4,0,11,22,7,102,109,161.0
7855,2011-11-28,4,0,11,23,5,41,46,103.66666666666667
7856,2011-11-29,4,0,11,0,4,18,22,59.0
7857,2011-11-29,4,0,11,1,1,16,17,28.333333333333332
7858,2011-11-29,4,0,11,2,0,5,5,14.666666666666666
7859,2011-11-29,4,0,11,3,0,2,2,8.0
7860,2011-11-29,4,0,11,4,1,5,6,4.333333333333333
7861,2011-11-29,4,0,11,5,1,21,22,10.0
7862,2011-11-29,4,0,11,6,1,88,89,39.0
7863,2011-11-29,4,0,11,7,12,330,342,151.0
7864,2011-11-29,4,0,11,8,9,440,449,293.3333333333333
7865,2011-11-29,4,0,11,9,5,197,202,331.0
7866,2011-11-29,4,0,11,10,2,34,36,229.0
7867,2011-11-29,4,0,11,11,1,10,11,83.0
7868,2011-11-29,4,0,11,12,1,17,18,21.666666666666668
7869,2011-11-29,4,0,11,13,0,22,22,17.0
7870,2011-11-29,4,0,11,14,1,35,36,25.333333333333332
7871,2011-11-29,4,0,11,15,5,60,65,41.0
7872,2011-11-29,4,0,11,16,5,146,151,84.0
7873,2011-11-29,4,0,11,17,8,346,354,190.0
7874,2011-11-29,4,0,11,18,11,347,358,287.6666666666667
7875,2011-11-29,4,0,11,19,6,244,250,320.6666666666667
7876,2011-11-29,4,0,11,20,8,176,184,264.0
7877,2011-11-29,4,0,11,21,9,116,125,186.33333333333334
7878,2011-11-29,4,0,11,22,5,90,95,134.66666666666666
7879,2011-11-29,4,0,11,23,0,53,53,91.0
7880,2011-11-30,4,0,11,0,1,23,24,57.333333333333336
7881,2011-11-30,4,0,11,1,0,8,8,28.333333333333332
7882,2011-11-30,4,0,11,2,0,5,5,12.333333333333334
7883,2011-11-30,4,0,11,3,0,1,1,4.666666666666667
7884,2011-11-30,4,0,11,4,0,5,5,3.6666666666666665
7885,2011-11-30,4,0,11,5,1,21,22,9.333333333333334
7886,2011-11-30,4,0,11,6,3,100,103,43.333333333333336
7887,2011-11-30,4,0,11,7,9,276,285,136.66666666666666
7888,2011-11-30,4,0,11,8,13,465,478,288.6666666666667
7889,2011-11-30,4,0,11,9,7,186,193,318.6666666666667
7890,2011-11-30,4,0,11,10,15,95,110,260.3333333333333
7891,2011-11-30,4,0,11,11,10,112,122,141.66666666666666
7892,2011-11-30,4,0,11,12,12,148,160,130.66666666666666
7893,2011-11-30,4,0,11,13,16,131,147,143.0
7894,2011-11-30,4,0,11,14,13,99,112,139.66666666666666
7895,2011-11-30,4,0,11,15,11,104,115,124.66666666666667
7896,2011-11-30,4,0,11,16,27,199,226,151.0
7897,2011-11-30,4,0,11,17,15,365,380,240.33333333333334
7898,2011-11-30,4,0,11,18,7,369,376,327.3333333333333
7899,2011-11-30,4,0,11,19,6,273,279,345.0
7900,2011-11-30,4,0,11,20,6,184,190,281.6666666666667
7901,2011-11-30,4,0,11,21,7,128,135,201.33333333333334
7902,2011-11-30,4,0,11,22,5,82,87,137.33333333333334
7903,2011-11-30,4,0,11,23,4,46,50,90.66666666666667
7904,2011-12-01,4,0,12,0,1,19,20,52.333333333333336
7905,2011-12-01,4,0,12,1,1,9,10,26.666666666666668
7906,2011-12-01,4,0,12,2,1,8,9,13.0
7907,2011-12-01,4,0,12,3,1,6,7,8.666666666666666
7908,2011-12-01,4,0,12,4,0,1,1,5.666666666666667
7909,2011-12-01,4,0,12,5,1,23,24,10.666666666666666
7910,2011-12-01,4,0,12,6,5,92,97,40.666666666666664
7911,2011-12-01,4,0,12,7,11,265,276,132.33333333333334
7912,2011-12-01,4,0,12,8,15,462,477,283.3333333333333
7913,2011-12-01,4,0,12,9,9,215,224,325.6666666666667
7914,2011-12-01,4,0,12,10,7,86,93,264.6666666666667
7915,2011-12-01,4,0,12,11,7,95,102,139.66666666666666
7916,2011-12-01,4,0,12,12,9,139,148,114.33333333333333
7917,2011-12-01,4,0,12,13,17,137,154,134.66666666666666
7918,2011-12-01,4,0,12,14,20,130,150,150.66666666666666
7919,2011-12-01,4,0,12,15,10,144,154,152.66666666666666
7920,2011-12-01,4,0,12,16,9,192,201,168.33333333333334
7921,2011-12-01,4,0,12,17,9,409,418,257.6666666666667
7922,2011-12-01,4,0,12,18,12,393,405,341.3333333333333
7923,2011-12-01,4,0,12,19,9,219,228,350.3333333333333
7924,2011-12-01,4,0,12,20,12,178,190,274.3333333333333
7925,2011-12-01,4,0,12,21,8,154,162,193.33333333333334
7926,2011-12-01,4,0,12,22,5,99,104,152.0
7927,2011-12-01,4,0,12,23,3,70,73,113.0
7928,2011-12-02,4,0,12,0,6,32,38,71.66666666666667
7929,2011-12-02,4,0,12,1,1,14,15,42.0
7930,2011-12-02,4,0,12,2,0,10,10,21.0
7931,2011-12-02,4,0,12,3,0,1,1,8.666666666666666
7932,2011-12-02,4,0,12,4,0,3,3,4.666666666666667
7933,2011-12-02,4,0,12,5,0,23,23,9.0
7934,2011-12-02,4,0,12,6,3,84,87,37.666666666666664
7935,2011-12-02,4,0,12,7,6,199,205,105.0
7936,2011-12-02,4,0,12,8,13,432,445,245.66666666666666
7937,2011-12-02,4,0,12,9,12,234,246,298.6666666666667
7938,2011-12-02,4,0,12,10,16,89,105,265.3333333333333
7939,2011-12-02,4,0,12,11,18,142,160,170.33333333333334
7940,2011-12-02,4,0,12,12,18,186,204,156.33333333333334
7941,2011-12-02,4,0,12,13,19,188,207,190.33333333333334
7942,2011-12-02,4,0,12,14,25,145,170,193.66666666666666
7943,2011-12-02,4,0,12,15,24,175,199,192.0
7944,2011-12-02,4,0,12,16,22,254,276,215.0
7945,2011-12-02,4,0,12,17,20,391,411,295.3333333333333
7946,2011-12-02,4,0,12,18,10,362,372,353.0
7947,2011-12-02,4,0,12,19,13,252,265,349.3333333333333
7948,2011-12-02,4,0,12,20,12,178,190,275.6666666666667
7949,2011-12-02,4,0,12,21,9,102,111,188.66666666666666
7950,2011-12-02,4,0,12,22,7,95,102,134.33333333333334
7951,2011-12-02,4,0,12,23,14,81,95,102.66666666666667
7952,2011-12-03,4,0,12,0,10,65,75,90.66666666666667
7953,2011-12-03,4,0,12,1,9,62,71,80.33333333333333
7954,2011-12-03,4,0,12,2,9,41,50,65.33333333333333
7955,2011-12-03,4,0,12,3,4,5,9,43.333333333333336
7956,2011-12-03,4,0,12,4,1,7,8,22.333333333333332
7957,2011-12-03,4,0,12,5,0,6,6,7.666666666666667
7958,2011-12-03,4,0,12,6,1,10,11,8.333333333333334
7959,2011-12-03,4,0,12,7,2,24,26,14.333333333333334
7960,2011-12-03,4,0,12,8,1,62,63,33.333333333333336
7961,2011-12-03,4,0,12,9,25,99,124,71.0
7962,2011-12-03,4,0,12,10,22,173,195,127.33333333333333
7963,2011-12-03,4,0,12,11,48,227,275,198.0
7964,2011-12-03,4,0,12,12,78,280,358,276.0
7965,2011-12-03,4,0,12,13,70,222,292,308.3333333333333
7966,2011-12-03,4,0,12,14,92,251,343,331.0
7967,2011-12-03,4,0,12,15,100,237,337,324.0
7968,2011-12-03,4,0,12,16,75,230,305,328.3333333333333
7969,2011-12-03,4,0,12,17,46,186,232,291.3333333333333
7970,2011-12-03,4,0,12,18,31,193,224,253.66666666666666
7971,2011-12-03,4,0,12,19,31,144,175,210.33333333333334
7972,2011-12-03,4,0,12,20,17,110,127,175.33333333333334
7973,2011-12-03,4,0,12,21,5,104,109,137.0
7974,2011-12-03,4,0,12,22,17,97,114,116.66666666666667
7975,2011-12-03,4,0,12,23,12,73,85,102.66666666666667
7976,2011-12-04,4,0,12,0,19,64,83,94.0
7977,2011-12-04,4,0,12,1,20,54,74,80.66666666666667
7978,2011-12-04,4,0,12,2,11,51,62,73.0
7979,2011-12-04,4,0,12,3,7,34,41,59.0
7980,2011-12-04,4,0,12,4,2,9,11,38.0
7981,2011-12-04,4,0,12,5,2,2,4,18.666666666666668
7982,2011-12-04,4,0,12,6,1,3,4,6.333333333333333
7983,2011-12-04,4,0,12,7,3,23,26,11.333333333333334
7984,2011-12-04,4,0,12,8,7,48,55,28.333333333333332
7985,2011-12-04,4,0,12,9,12,114,126,69.0
7986,2011-12-04,4,0,12,10,36,180,216,132.33333333333334
7987,2011-12-04,4,0,12,11,48,206,254,198.66666666666666
7988,2011-12-04,4,0,12,12,82,247,329,266.3333333333333
7989,2011-12-04,4,0,12,13,88,269,357,313.3333333333333
7990,2011-12-04,4,0,12,14,77,246,323,336.3333333333333
7991,2011-12-04,4,0,12,15,69,227,296,325.3333333333333
7992,2011-12-04,4,0,12,16,64,266,330,316.3333333333333
7993,2011-12-04,4,0,12,17,38,207,245,290.3333333333333
7994,2011-12-04,4,0,12,18,10,161,171,248.66666666666666
7995,2011-12-04,4,0,12,19,15,158,173,196.33333333333334
7996,2011-12-04,4,0,12,20,8,116,124,156.0
7997,2011-12-04,4,0,12,21,7,65,72,123.0
7998,2011-12-04,4,0,12,22,5,59,64,86.66666666666667
7999,2011-12-04,4,0,12,23,3,42,45,60.333333333333336
8000,2011-12-05,4,0,12,0,3,21,24,44.333333333333336
8001,2011-12-05,4,0,12,1,2,10,12,27.0
8002,2011-12-05,4,0,12,2,0,8,8,14.666666666666666
8003,2011-12-05,4,0,12,3,0,2,2,7.333333333333333
8004,2011-12-05,4,0,12,4,0,7,7,5.666666666666667
8005,2011-12-05,4,0,12,5,1,24,25,11.333333333333334
8006,2011-12-05,4,0,12,6,1,89,90,40.666666666666664
8007,2011-12-05,4,0,12,7,9,274,283,132.66666666666666
8008,2011-12-05,4,0,12,8,12,392,404,259.0
8009,2011-12-05,4,0,12,9,12,178,190,292.3333333333333
8010,2011-12-05,4,0,12,10,9,78,87,227.0
8011,2011-12-05,4,0,12,11,17,106,123,133.33333333333334
8012,2011-12-05,4,0,12,12,29,125,154,121.33333333333333
8013,2011-12-05,4,0,12,13,18,153,171,149.33333333333334
8014,2011-12-05,4,0,12,14,7,126,133,152.66666666666666
8015,2011-12-05,4,0,12,15,16,132,148,150.66666666666666
8016,2011-12-05,4,0,12,16,10,238,248,176.33333333333334
8017,2011-12-05,4,0,12,17,16,430,446,280.6666666666667
8018,2011-12-05,4,0,12,18,13,386,399,364.3333333333333
8019,2011-12-05,4,0,12,19,13,295,308,384.3333333333333
8020,2011-12-05,4,0,12,20,15,190,205,304.0
8021,2011-12-05,4,0,12,21,10,166,176,229.66666666666666
8022,2011-12-05,4,0,12,22,12,94,106,162.33333333333334
8023,2011-12-05,4,0,12,23,8,54,62,114.66666666666667
8024,2011-12-06,4,0,12,0,3,25,28,65.33333333333333
8025,2011-12-06,4,0,12,1,2,14,16,35.333333333333336
8026,2011-12-06,4,0,12,2,0,3,3,15.666666666666666
8027,2011-12-06,4,0,12,3,0,3,3,7.333333333333333
8028,2011-12-06,4,0,12,4,0,7,7,4.333333333333333
8029,2011-12-06,4,0,12,5,0,20,20,10.0
8030,2011-12-06,4,0,12,6,5,81,86,37.666666666666664
8031,2011-12-06,4,0,12,7,7,227,234,113.33333333333333
8032,2011-12-06,4,0,12,8,13,401,414,244.66666666666666
8033,2011-12-06,4,0,12,9,4,200,204,284.0
8034,2011-12-06,4,0,12,10,6,44,50,222.66666666666666
8035,2011-12-06,4,0,12,11,4,28,32,95.33333333333333
8036,2011-12-06,4,0,12,12,5,50,55,45.666666666666664
8037,2011-12-06,4,0,12,13,6,65,71,52.666666666666664
8038,2011-12-06,4,0,12,14,6,69,75,67.0
8039,2011-12-06,4,0,12,15,2,43,45,63.666666666666664
8040,2011-12-06,4,0,12,16,4,84,88,69.33333333333333
8041,2011-12-06,4,0,12,17,13,249,262,131.66666666666666
8042,2011-12-06,4,0,12,18,17,287,304,218.0
8043,2011-12-06,4,0,12,19,10,223,233,266.3333333333333
8044,2011-12-06,4,0,12,20,3,107,110,215.66666666666666
8045,2011-12-06,4,0,12,21,6,108,114,152.33333333333334
8046,2011-12-06,4,0,12,22,5,82,87,103.66666666666667
8047,2011-12-06,4,0,12,23,5,48,53,84.66666666666667
8048,2011-12-07,4,0,12,0,3,30,33,57.666666666666664
8049,2011-12-07,4,0,12,1,4,9,13,33.0
8050,2011-12-07,4,0,12,2,2,4,6,17.333333333333332
8051,2011-12-07,4,0,12,3,0,3,3,7.333333333333333
8052,2011-12-07,4,0,12,4,0,1,1,3.3333333333333335
8053,2011-12-07,4,0,12,5,0,3,3,2.3333333333333335
8054,2011-12-07,4,0,12,6,0,18,18,7.333333333333333
8055,2011-12-07,4,0,12,7,3,43,46,22.333333333333332
8056,2011-12-07,4,0,12,8,6,80,86,50.0
8057,2011-12-07,4,0,12,9,0,64,64,65.33333333333333
8058,2011-12-07,4,0,12,10,1,32,33,61.0
8059,2011-12-07,4,0,12,11,3,47,50,49.0
8060,2011-12-07,4,0,12,12,4,29,33,38.666666666666664
8061,2011-12-07,4,0,12,13,5,28,33,38.666666666666664
8062,2011-12-07,4,0,12,14,1,24,25,30.333333333333332
8063,2011-12-07,4,0,12,15,5,25,30,29.333333333333332
8064,2011-12-07,4,0,12,16,3,28,31,28.666666666666668
8065,2011-12-07,4,0,12,17,4,48,52,37.666666666666664
8066,2011-12-07,4,0,12,18,3,48,51,44.666666666666664
8067,2011-12-07,4,0,12,19,2,31,33,45.333333333333336
8068,2011-12-07,4,0,12,20,1,25,26,36.666666666666664
8069,2011-12-07,4,0,12,21,0,6,6,21.666666666666668
8070,2011-12-07,4,0,12,22,0,13,13,15.0
8071,2011-12-07,4,0,12,23,0,16,16,11.666666666666666
8072,2011-12-08,4,0,12,0,0,21,21,16.666666666666668
8073,2011-12-08,4,0,12,1,1,6,7,14.666666666666666
8074,2011-12-08,4,0,12,2,0,4,4,10.666666666666666
8075,2011-12-08,4,0,12,3,0,1,1,4.0
8076,2011-12-08,4,0,12,4,0,2,2,2.3333333333333335
8077,2011-12-08,4,0,12,5,0,12,12,5.0
8078,2011-12-08,4,0,12,6,0,71,71,28.333333333333332
8079,2011-12-08,4,0,12,7,11,233,244,109.0
8080,2011-12-08,4,0,12,8,11,418,429,248.0
8081,2011-12-08,4,0,12,9,7,218,225,299.3333333333333
8082,2011-12-08,4,0,12,10,1,109,110,254.66666666666666
8083,2011-12-08,4,0,12,11,6,100,106,147.0
8084,2011-12-08,4,0,12,12,8,148,156,124.0
8085,2011-12-08,4,0,12,13,9,115,124,128.66666666666666
8086,2011-12-08,4,0,12,14,16,121,137,139.0
8087,2011-12-08,4,0,12,15,19,98,117,126.0
8088,2011-12-08,4,0,12,16,7,201,208,154.0
8089,2011-12-08,4,0,12,17,10,321,331,218.66666666666666
8090,2011-12-08,4,0,12,18,12,306,318,285.6666666666667
8091,2011-12-08,4,0,12,19,12,220,232,293.6666666666667
8092,2011-12-08,4,0,12,20,5,170,175,241.66666666666666
8093,2011-12-08,4,0,12,21,4,135,139,182.0
8094,2011-12-08,4,0,12,22,8,84,92,135.33333333333334
8095,2011-12-08,4,0,12,23,3,58,61,97.33333333333333
8096,2011-12-09,4,0,12,0,8,26,34,62.333333333333336
8097,2011-12-09,4,0,12,1,2,12,14,36.333333333333336
8098,2011-12-09,4,0,12,2,2,10,12,20.0
8099,2011-12-09,4,0,12,3,1,5,6,10.666666666666666
8100,2011-12-09,4,0,12,4,1,1,2,6.666666666666667
8101,2011-12-09,4,0,12,5,0,20,20,9.333333333333334
8102,2011-12-09,4,0,12,6,1,62,63,28.333333333333332
8103,2011-12-09,4,0,12,7,4,195,199,94.0
8104,2011-12-09,4,0,12,8,7,378,385,215.66666666666666
8105,2011-12-09,4,0,12,9,8,256,264,282.6666666666667
8106,2011-12-09,4,0,12,10,11,115,126,258.3333333333333
8107,2011-12-09,4,0,12,11,15,121,136,175.33333333333334
8108,2011-12-09,4,0,12,12,27,146,173,145.0
8109,2011-12-09,4,0,12,13,27,141,168,159.0
8110,2011-12-09,4,0,12,14,24,163,187,176.0
8111,2011-12-09,4,0,12,15,29,160,189,181.33333333333334
8112,2011-12-09,4,0,12,16,24,226,250,208.66666666666666
8113,2011-12-09,4,0,12,17,10,352,362,267.0
8114,2011-12-09,4,0,12,18,10,308,318,310.0
8115,2011-12-09,4,0,12,19,10,189,199,293.0
8116,2011-12-09,4,0,12,20,10,140,150,222.33333333333334
8117,2011-12-09,4,0,12,21,9,131,140,163.0
8118,2011-12-09,4,0,12,22,15,114,129,139.66666666666666
8119,2011-12-09,4,0,12,23,6,88,94,121.0
8120,2011-12-10,4,0,12,0,11,66,77,100.0
8121,2011-12-10,4,0,12,1,11,55,66,79.0
8122,2011-12-10,4,0,12,2,12,48,60,67.66666666666667
8123,2011-12-10,4,0,12,3,5,20,25,50.333333333333336
8124,2011-12-10,4,0,12,4,0,3,3,29.333333333333332
8125,2011-12-10,4,0,12,5,0,6,6,11.333333333333334
8126,2011-12-10,4,0,12,6,1,10,11,6.666666666666667
8127,2011-12-10,4,0,12,7,0,11,11,9.333333333333334
8128,2011-12-10,4,0,12,8,5,68,73,31.666666666666668
8129,2011-12-10,4,0,12,9,15,134,149,77.66666666666667
8130,2011-12-10,4,0,12,10,31,161,192,138.0
8131,2011-12-10,4,0,12,11,44,192,236,192.33333333333334
8132,2011-12-10,4,0,12,12,48,235,283,237.0
8133,2011-12-10,4,0,12,13,47,239,286,268.3333333333333
8134,2011-12-10,4,0,12,14,51,242,293,287.3333333333333
8135,2011-12-10,4,0,12,15,60,239,299,292.6666666666667
8136,2011-12-10,4,0,12,16,58,183,241,277.6666666666667
8137,2011-12-10,4,0,12,17,34,151,185,241.66666666666666
8138,2011-12-10,4,0,12,18,28,144,172,199.33333333333334
8139,2011-12-10,4,0,12,19,15,139,154,170.33333333333334
8140,2011-12-10,4,0,12,20,10,114,124,150.0
8141,2011-12-10,4,0,12,21,4,79,83,120.33333333333333
8142,2011-12-10,4,0,12,22,7,88,95,100.66666666666667
8143,2011-12-10,4,0,12,23,5,61,66,81.33333333333333
8144,2011-12-11,4,0,12,0,5,69,74,78.33333333333333
8145,2011-12-11,4,0,12,1,8,54,62,67.33333333333333
8146,2011-12-11,4,0,12,2,5,47,52,62.666666666666664
8147,2011-12-11,4,0,12,3,2,17,19,44.333333333333336
8148,2011-12-11,4,0,12,4,0,5,5,25.333333333333332
8149,2011-12-11,4,0,12,5,0,6,6,10.0
8150,2011-12-11,4,0,12,6,0,10,10,7.0
8151,2011-12-11,4,0,12,7,1,30,31,15.666666666666666
8152,2011-12-11,4,0,12,8,4,68,72,37.666666666666664
8153,2011-12-11,4,0,12,9,19,88,107,70.0
8154,2011-12-11,4,0,12,10,30,164,194,124.33333333333333
8155,2011-12-11,4,0,12,11,31,166,197,166.0
8156,2011-12-11,4,0,12,12,42,246,288,226.33333333333334
8157,2011-12-11,4,0,12,13,44,224,268,251.0
8158,2011-12-11,4,0,12,14,44,198,242,266.0
8159,2011-12-11,4,0,12,15,47,219,266,258.6666666666667
8160,2011-12-11,4,0,12,16,32,174,206,238.0
8161,2011-12-11,4,0,12,17,13,150,163,211.66666666666666
8162,2011-12-11,4,0,12,18,12,151,163,177.33333333333334
8163,2011-12-11,4,0,12,19,7,98,105,143.66666666666666
8164,2011-12-11,4,0,12,20,10,62,72,113.33333333333333
8165,2011-12-11,4,0,12,21,10,53,63,80.0
8166,2011-12-11,4,0,12,22,7,36,43,59.333333333333336
8167,2011-12-11,4,0,12,23,4,31,35,47.0
8168,2011-12-12,4,0,12,0,4,16,20,32.666666666666664
8169,2011-12-12,4,0,12,1,0,9,9,21.333333333333332
8170,2011-12-12,4,0,12,2,0,4,4,11.0
8171,2011-12-12,4,0,12,3,0,2,2,5.0
8172,2011-12-12,4,0,12,4,0,3,3,3.0
8173,2011-12-12,4,0,12,5,0,21,21,8.666666666666666
8174,2011-12-12,4,0,12,6,1,63,64,29.333333333333332
8175,2011-12-12,4,0,12,7,4,231,235,106.66666666666667
8176,2011-12-12,4,0,12,8,7,378,385,228.0
8177,2011-12-12,4,0,12,9,12,208,220,280.0
8178,2011-12-12,4,0,12,10,14,91,105,236.66666666666666
8179,2011-12-12,4,0,12,11,15,100,115,146.66666666666666
8180,2011-12-12,4,0,12,12,7,138,145,121.66666666666667
8181,2011-12-12,4,0,12,13,13,153,166,142.0
8182,2011-12-12,4,0,12,14,16,95,111,140.66666666666666
8183,2011-12-12,4,0,12,15,8,124,132,136.33333333333334
8184,2011-12-12,4,0,12,16,5,209,214,152.33333333333334
8185,2011-12-12,4,0,12,17,7,352,359,235.0
8186,2011-12-12,4,0,12,18,8,349,357,310.0
8187,2011-12-12,4,0,12,19,9,232,241,319.0
8188,2011-12-12,4,0,12,20,8,157,165,254.33333333333334
8189,2011-12-12,4,0,12,21,2,119,121,175.66666666666666
8190,2011-12-12,4,0,12,22,0,71,71,119.0
8191,2011-12-12,4,0,12,23,3,42,45,79.0
8192,2011-12-13,4,0,12,0,1,16,17,44.333333333333336
8193,2011-12-13,4,0,12,1,0,4,4,22.0
8194,2011-12-13,4,0,12,2,1,1,2,7.666666666666667
8195,2011-12-13,4,0,12,3,0,3,3,3.0
8196,2011-12-13,4,0,12,4,0,4,4,3.0
8197,2011-12-13,4,0,12,5,0,20,20,9.0
8198,2011-12-13,4,0,12,6,0,92,92,38.666666666666664
8199,2011-12-13,4,0,12,7,2,221,223,111.66666666666667
8200,2011-12-13,4,0,12,8,9,391,400,238.33333333333334
8201,2011-12-13,4,0,12,9,10,223,233,285.3333333333333
8202,2011-12-13,4,0,12,10,3,99,102,245.0
8203,2011-12-13,4,0,12,11,9,115,124,153.0
8204,2011-12-13,4,0,12,12,20,147,167,131.0
8205,2011-12-13,4,0,12,13,7,120,127,139.33333333333334
8206,2011-12-13,4,0,12,14,18,116,134,142.66666666666666
8207,2011-12-13,4,0,12,15,7,144,151,137.33333333333334
8208,2011-12-13,4,0,12,16,13,194,207,164.0
8209,2011-12-13,4,0,12,17,17,381,398,252.0
8210,2011-12-13,4,0,12,18,12,370,382,329.0
8211,2011-12-13,4,0,12,19,5,262,267,349.0
8212,2011-12-13,4,0,12,20,7,154,161,270.0
8213,2011-12-13,4,0,12,21,5,134,139,189.0
8214,2011-12-13,4,0,12,22,5,102,107,135.66666666666666
8215,2011-12-13,4,0,12,23,4,55,59,101.66666666666667
8216,2011-12-14,4,0,12,0,0,22,22,62.666666666666664
8217,2011-12-14,4,0,12,1,0,8,8,29.666666666666668
8218,2011-12-14,4,0,12,2,0,2,2,10.666666666666666
8219,2011-12-14,4,0,12,3,0,3,3,4.333333333333333
8220,2011-12-14,4,0,12,4,0,4,4,3.0
8221,2011-12-14,4,0,12,5,0,26,26,11.0
8222,2011-12-14,4,0,12,6,0,87,87,39.0
8223,2011-12-14,4,0,12,7,4,243,247,120.0
8224,2011-12-14,4,0,12,8,9,458,467,267.0
8225,2011-12-14,4,0,12,9,9,230,239,317.6666666666667
8226,2011-12-14,4,0,12,10,9,133,142,282.6666666666667
8227,2011-12-14,4,0,12,11,12,103,115,165.33333333333334
8228,2011-12-14,4,0,12,12,6,138,144,133.66666666666666
8229,2011-12-14,4,0,12,13,14,119,133,130.66666666666666
8230,2011-12-14,4,0,12,14,17,134,151,142.66666666666666
8231,2011-12-14,4,0,12,15,24,143,167,150.33333333333334
8232,2011-12-14,4,0,12,16,12,233,245,187.66666666666666
8233,2011-12-14,4,0,12,17,19,377,396,269.3333333333333
8234,2011-12-14,4,0,12,18,11,379,390,343.6666666666667
8235,2011-12-14,4,0,12,19,9,259,268,351.3333333333333
8236,2011-12-14,4,0,12,20,6,169,175,277.6666666666667
8237,2011-12-14,4,0,12,21,9,145,154,199.0
8238,2011-12-14,4,0,12,22,5,99,104,144.33333333333334
8239,2011-12-14,4,0,12,23,3,48,51,103.0
8240,2011-12-15,4,0,12,0,5,45,50,68.33333333333333
8241,2011-12-15,4,0,12,1,5,15,20,40.333333333333336
8242,2011-12-15,4,0,12,2,2,5,7,25.666666666666668
8243,2011-12-15,4,0,12,3,1,2,3,10.0
8244,2011-12-15,4,0,12,4,0,6,6,5.333333333333333
8245,2011-12-15,4,0,12,5,0,24,24,11.0
8246,2011-12-15,4,0,12,6,2,90,92,40.666666666666664
8247,2011-12-15,4,0,12,7,6,252,258,124.66666666666667
8248,2011-12-15,4,0,12,8,8,449,457,269.0
8249,2011-12-15,4,0,12,9,6,274,280,331.6666666666667
8250,2011-12-15,4,0,12,10,4,105,109,282.0
8251,2011-12-15,4,0,12,11,9,126,135,174.66666666666666
8252,2011-12-15,4,0,12,12,17,140,157,133.66666666666666
8253,2011-12-15,4,0,12,13,14,150,164,152.0
8254,2011-12-15,4,0,12,14,8,124,132,151.0
8255,2011-12-15,4,0,12,15,6,76,82,126.0
8256,2011-12-15,4,0,12,16,7,124,131,115.0
8257,2011-12-15,4,0,12,17,14,310,324,179.0
8258,2011-12-15,4,0,12,18,14,363,377,277.3333333333333
8259,2011-12-15,4,0,12,19,13,274,287,329.3333333333333
8260,2011-12-15,4,0,12,20,12,209,221,295.0
8261,2011-12-15,4,0,12,21,10,145,155,221.0
8262,2011-12-15,4,0,12,22,8,116,124,166.66666666666666
8263,2011-12-15,4,0,12,23,10,104,114,131.0
8264,2011-12-16,4,0,12,0,12,60,72,103.33333333333333
8265,2011-12-16,4,0,12,1,3,28,31,72.33333333333333
8266,2011-12-16,4,0,12,2,0,23,23,42.0
8267,2011-12-16,4,0,12,3,2,3,5,19.666666666666668
8268,2011-12-16,4,0,12,4,1,4,5,11.0
8269,2011-12-16,4,0,12,5,0,26,26,12.0
8270,2011-12-16,4,0,12,6,2,80,82,37.666666666666664
8271,2011-12-16,4,0,12,7,5,226,231,113.0
8272,2011-12-16,4,0,12,8,10,449,459,257.3333333333333
8273,2011-12-16,4,0,12,9,8,235,243,311.0
8274,2011-12-16,4,0,12,10,10,122,132,278.0
8275,2011-12-16,4,0,12,11,9,135,144,173.0
8276,2011-12-16,4,0,12,12,10,163,173,149.66666666666666
8277,2011-12-16,4,0,12,13,12,125,137,151.33333333333334
8278,2011-12-16,4,0,12,14,13,115,128,146.0
8279,2011-12-16,4,0,12,15,12,141,153,139.33333333333334
8280,2011-12-16,4,0,12,16,12,212,224,168.33333333333334
8281,2011-12-16,4,0,12,17,13,352,365,247.33333333333334
8282,2011-12-16,4,0,12,18,10,285,295,294.6666666666667
8283,2011-12-16,4,0,12,19,11,203,214,291.3333333333333
8284,2011-12-16,4,0,12,20,6,146,152,220.33333333333334
8285,2011-12-16,4,0,12,21,7,95,102,156.0
8286,2011-12-16,4,0,12,22,6,100,106,120.0
8287,2011-12-16,4,0,12,23,4,71,75,94.33333333333333
8288,2011-12-17,4,0,12,0,3,59,62,81.0
8289,2011-12-17,4,0,12,1,4,39,43,60.0
8290,2011-12-17,4,0,12,2,11,47,58,54.333333333333336
8291,2011-12-17,4,0,12,3,4,22,26,42.333333333333336
8292,2011-12-17,4,0,12,4,0,9,9,31.0
8293,2011-12-17,4,0,12,5,2,7,9,14.666666666666666
8294,2011-12-17,4,0,12,6,0,17,17,11.666666666666666
8295,2011-12-17,4,0,12,7,0,20,20,15.333333333333334
8296,2011-12-17,4,0,12,8,4,55,59,32.0
8297,2011-12-17,4,0,12,9,5,95,100,59.666666666666664
8298,2011-12-17,4,0,12,10,10,171,181,113.33333333333333
8299,2011-12-17,4,0,12,11,21,188,209,163.33333333333334
8300,2011-12-17,4,0,12,12,28,216,244,211.33333333333334
8301,2011-12-17,4,0,12,13,32,204,236,229.66666666666666
8302,2011-12-17,4,0,12,14,30,207,237,239.0
8303,2011-12-17,4,0,12,15,33,195,228,233.66666666666666
8304,2011-12-17,4,0,12,16,30,192,222,229.0
8305,2011-12-17,4,0,12,17,12,153,165,205.0
8306,2011-12-17,4,0,12,18,7,150,157,181.33333333333334
8307,2011-12-17,4,0,12,19,11,95,106,142.66666666666666
8308,2011-12-17,4,0,12,20,7,99,106,123.0
8309,2011-12-17,4,0,12,21,8,88,96,102.66666666666667
8310,2011-12-17,4,0,12,22,7,73,80,94.0
8311,2011-12-17,4,0,12,23,6,63,69,81.66666666666667
8312,2011-12-18,4,0,12,0,7,64,71,73.33333333333333
8313,2011-12-18,4,0,12,1,3,43,46,62.0
8314,2011-12-18,4,0,12,2,2,39,41,52.666666666666664
8315,2011-12-18,4,0,12,3,2,16,18,35.0
8316,2011-12-18,4,0,12,4,0,1,1,20.0
8317,2011-12-18,4,0,12,5,1,4,5,8.0
8318,2011-12-18,4,0,12,6,0,3,3,3.0
8319,2011-12-18,4,0,12,7,1,11,12,6.666666666666667
8320,2011-12-18,4,0,12,8,1,31,32,15.666666666666666
8321,2011-12-18,4,0,12,9,6,75,81,41.666666666666664
8322,2011-12-18,4,0,12,10,7,122,129,80.66666666666667
8323,2011-12-18,4,0,12,11,20,168,188,132.66666666666666
8324,2011-12-18,4,0,12,12,26,202,228,181.66666666666666
8325,2011-12-18,4,0,12,13,18,210,228,214.66666666666666
8326,2011-12-18,4,0,12,14,19,200,219,225.0
8327,2011-12-18,4,0,12,15,23,184,207,218.0
8328,2011-12-18,4,0,12,16,27,207,234,220.0
8329,2011-12-18,4,0,12,17,10,126,136,192.33333333333334
8330,2011-12-18,4,0,12,18,15,123,138,169.33333333333334
8331,2011-12-18,4,0,12,19,5,130,135,136.33333333333334
8332,2011-12-18,4,0,12,20,10,94,104,125.66666666666667
8333,2011-12-18,4,0,12,21,9,80,89,109.33333333333333
8334,2011-12-18,4,0,12,22,2,47,49,80.66666666666667
8335,2011-12-18,4,0,12,23,6,31,37,58.333333333333336
8336,2011-12-19,4,0,12,0,3,14,17,34.333333333333336
8337,2011-12-19,4,0,12,1,3,8,11,21.666666666666668
8338,2011-12-19,4,0,12,2,0,3,3,10.333333333333334
8339,2011-12-19,4,0,12,3,0,3,3,5.666666666666667
8340,2011-12-19,4,0,12,4,0,4,4,3.3333333333333335
8341,2011-12-19,4,0,12,5,0,21,21,9.333333333333334
8342,2011-12-19,4,0,12,6,0,68,68,31.0
8343,2011-12-19,4,0,12,7,4,187,191,93.33333333333333
8344,2011-12-19,4,0,12,8,8,389,397,218.66666666666666
8345,2011-12-19,4,0,12,9,17,166,183,257.0
8346,2011-12-19,4,0,12,10,12,96,108,229.33333333333334
8347,2011-12-19,4,0,12,11,22,105,127,139.33333333333334
8348,2011-12-19,4,0,12,12,13,128,141,125.33333333333333
8349,2011-12-19,4,0,12,13,15,127,142,136.66666666666666
8350,2011-12-19,4,0,12,14,30,107,137,140.0
8351,2011-12-19,4,0,12,15,24,135,159,146.0
8352,2011-12-19,4,0,12,16,19,189,208,168.0
8353,2011-12-19,4,0,12,17,16,362,378,248.33333333333334
8354,2011-12-19,4,0,12,18,11,343,354,313.3333333333333
8355,2011-12-19,4,0,12,19,17,234,251,327.6666666666667
8356,2011-12-19,4,0,12,20,9,197,206,270.3333333333333
8357,2011-12-19,4,0,12,21,15,112,127,194.66666666666666
8358,2011-12-19,4,0,12,22,12,95,107,146.66666666666666
8359,2011-12-19,4,0,12,23,10,50,60,98.0
8360,2011-12-20,4,0,12,0,0,21,21,62.666666666666664
8361,2011-12-20,4,0,12,1,0,6,6,29.0
8362,2011-12-20,4,0,12,2,1,10,11,12.666666666666666
8363,2011-12-20,4,0,12,3,1,1,2,6.333333333333333
8364,2011-12-20,4,0,12,4,0,4,4,5.666666666666667
8365,2011-12-20,4,0,12,5,0,15,15,7.0
8366,2011-12-20,4,0,12,6,1,71,72,30.333333333333332
8367,2011-12-20,4,0,12,7,7,261,268,118.33333333333333
8368,2011-12-20,4,0,12,8,10,422,432,257.3333333333333
8369,2011-12-20,4,0,12,9,14,245,259,319.6666666666667
8370,2011-12-20,4,0,12,10,20,109,129,273.3333333333333
8371,2011-12-20,4,0,12,11,13,116,129,172.33333333333334
8372,2011-12-20,4,0,12,12,16,159,175,144.33333333333334
8373,2011-12-20,4,0,12,13,18,163,181,161.66666666666666
8374,2011-12-20,4,0,12,14,11,127,138,164.66666666666666
8375,2011-12-20,4,0,12,15,15,139,154,157.66666666666666
8376,2011-12-20,4,0,12,16,20,218,238,176.66666666666666
8377,2011-12-20,4,0,12,17,14,417,431,274.3333333333333
8378,2011-12-20,4,0,12,18,26,385,411,360.0
8379,2011-12-20,4,0,12,19,6,218,224,355.3333333333333
8380,2011-12-20,4,0,12,20,3,144,147,260.6666666666667
8381,2011-12-20,4,0,12,21,4,139,143,171.33333333333334
8382,2011-12-20,4,0,12,22,3,104,107,132.33333333333334
8383,2011-12-20,4,0,12,23,13,40,53,101.0
8384,2011-12-21,1,0,12,0,7,18,25,61.666666666666664
8385,2011-12-21,1,0,12,1,1,10,11,29.666666666666668
8386,2011-12-21,1,0,12,2,0,4,4,13.333333333333334
8387,2011-12-21,1,0,12,3,0,2,2,5.666666666666667
8388,2011-12-21,1,0,12,4,0,2,2,2.6666666666666665
8389,2011-12-21,1,0,12,5,0,28,28,10.666666666666666
8390,2011-12-21,1,0,12,6,1,75,76,35.333333333333336
8391,2011-12-21,1,0,12,7,5,224,229,111.0
8392,2011-12-21,1,0,12,8,12,393,405,236.66666666666666
8393,2011-12-21,1,0,12,9,14,220,234,289.3333333333333
8394,2011-12-21,1,0,12,10,6,83,89,242.66666666666666
8395,2011-12-21,1,0,12,11,3,53,56,126.33333333333333
8396,2011-12-21,1,0,12,12,3,58,61,68.66666666666667
8397,2011-12-21,1,0,12,13,3,55,58,58.333333333333336
8398,2011-12-21,1,0,12,14,11,40,51,56.666666666666664
8399,2011-12-21,1,0,12,15,4,57,61,56.666666666666664
8400,2011-12-21,1,0,12,16,6,95,101,71.0
8401,2011-12-21,1,0,12,17,3,226,229,130.33333333333334
8402,2011-12-21,1,0,12,18,2,278,280,203.33333333333334
8403,2011-12-21,1,0,12,19,9,200,209,239.33333333333334
8404,2011-12-21,1,0,12,20,5,162,167,218.66666666666666
8405,2011-12-21,1,0,12,21,9,114,123,166.33333333333334
8406,2011-12-21,1,0,12,22,3,102,105,131.66666666666666
8407,2011-12-21,1,0,12,23,0,54,54,94.0
8408,2011-12-22,1,0,12,0,3,24,27,62.0
8409,2011-12-22,1,0,12,1,0,15,15,32.0
8410,2011-12-22,1,0,12,2,1,10,11,17.666666666666668
8411,2011-12-22,1,0,12,3,0,6,6,10.666666666666666
8412,2011-12-22,1,0,12,4,0,3,3,6.666666666666667
8413,2011-12-22,1,0,12,5,1,15,16,8.333333333333334
8414,2011-12-22,1,0,12,6,1,63,64,27.666666666666668
8415,2011-12-22,1,0,12,7,4,182,186,88.66666666666667
8416,2011-12-22,1,0,12,8,10,333,343,197.66666666666666
8417,2011-12-22,1,0,12,9,10,218,228,252.33333333333334
8418,2011-12-22,1,0,12,10,13,128,141,237.33333333333334
8419,2011-12-22,1,0,12,11,10,135,145,171.33333333333334
8420,2011-12-22,1,0,12,12,22,180,202,162.66666666666666
8421,2011-12-22,1,0,12,13,21,167,188,178.33333333333334
8422,2011-12-22,1,0,12,14,23,136,159,183.0
8423,2011-12-22,1,0,12,15,28,186,214,187.0
8424,2011-12-22,1,0,12,16,30,226,256,209.66666666666666
8425,2011-12-22,1,0,12,17,24,332,356,275.3333333333333
8426,2011-12-22,1,0,12,18,11,277,288,300.0
8427,2011-12-22,1,0,12,19,12,130,142,262.0
8428,2011-12-22,1,0,12,20,0,33,33,154.33333333333334
8429,2011-12-22,1,0,12,21,2,15,17,64.0
8430,2011-12-22,1,0,12,22,0,17,17,22.333333333333332
8431,2011-12-22,1,0,12,23,1,10,11,15.0
8432,2011-12-23,1,0,12,0,2,7,9,12.333333333333334
8433,2011-12-23,1,0,12,1,1,11,12,10.666666666666666
8434,2011-12-23,1,0,12,2,1,12,13,11.333333333333334
8435,2011-12-23,1,0,12,3,0,4,4,9.666666666666666
8436,2011-12-23,1,0,12,4,0,2,2,6.333333333333333
8437,2011-12-23,1,0,12,5,0,8,8,4.666666666666667
8438,2011-12-23,1,0,12,6,0,40,40,16.666666666666668
8439,2011-12-23,1,0,12,7,4,88,92,46.666666666666664
8440,2011-12-23,1,0,12,8,9,173,182,104.66666666666667
8441,2011-12-23,1,0,12,9,4,152,156,143.33333333333334
8442,2011-12-23,1,0,12,10,8,96,104,147.33333333333334
8443,2011-12-23,1,0,12,11,26,148,174,144.66666666666666
8444,2011-12-23,1,0,12,12,14,156,170,149.33333333333334
8445,2011-12-23,1,0,12,13,17,177,194,179.33333333333334
8446,2011-12-23,1,0,12,14,23,177,200,188.0
8447,2011-12-23,1,0,12,15,12,191,203,199.0
8448,2011-12-23,1,0,12,16,15,166,181,194.66666666666666
8449,2011-12-23,1,0,12,17,11,129,140,174.66666666666666
8450,2011-12-23,1,0,12,18,4,91,95,138.66666666666666
8451,2011-12-23,1,0,12,19,1,75,76,103.66666666666667
8452,2011-12-23,1,0,12,20,3,47,50,73.66666666666667
8453,2011-12-23,1,0,12,21,0,32,32,52.666666666666664
8454,2011-12-23,1,0,12,22,4,43,47,43.0
8455,2011-12-23,1,0,12,23,4,21,25,34.666666666666664
8456,2011-12-24,1,0,12,0,3,20,23,31.666666666666668
8457,2011-12-24,1,0,12,1,1,15,16,21.333333333333332
8458,2011-12-24,1,0,12,2,4,22,26,21.666666666666668
8459,2011-12-24,1,0,12,3,0,5,5,15.666666666666666
8460,2011-12-24,1,0,12,4,0,3,3,11.333333333333334
8461,2011-12-24,1,0,12,5,1,3,4,4.0
8462,2011-12-24,1,0,12,6,0,10,10,5.666666666666667
8463,2011-12-24,1,0,12,7,0,10,10,8.0
8464,2011-12-24,1,0,12,8,0,27,27,15.666666666666666
8465,2011-12-24,1,0,12,9,3,53,56,31.0
8466,2011-12-24,1,0,12,10,4,52,56,46.333333333333336
8467,2011-12-24,1,0,12,11,9,62,71,61.0
8468,2011-12-24,1,0,12,12,15,79,94,73.66666666666667
8469,2011-12-24,1,0,12,13,24,97,121,95.33333333333333
8470,2011-12-24,1,0,12,14,15,70,85,100.0
8471,2011-12-24,1,0,12,15,15,82,97,101.0
8472,2011-12-24,1,0,12,16,25,74,99,93.66666666666667
8473,2011-12-24,1,0,12,17,15,53,68,88.0
8474,2011-12-24,1,0,12,18,2,33,35,67.33333333333333
8475,2011-12-24,1,0,12,19,1,24,25,42.666666666666664
8476,2011-12-24,1,0,12,20,5,19,24,28.0
8477,2011-12-24,1,0,12,21,4,15,19,22.666666666666668
8478,2011-12-24,1,0,12,22,8,12,20,21.0
8479,2011-12-24,1,0,12,23,1,16,17,18.666666666666668
8480,2011-12-25,1,0,12,0,2,4,6,14.333333333333334
8481,2011-12-25,1,0,12,1,2,2,4,9.0
8482,2011-12-25,1,0,12,2,0,2,2,4.0
8483,2011-12-25,1,0,12,3,1,3,4,3.3333333333333335
8484,2011-12-25,1,0,12,5,0,1,1,2.3333333333333335
8485,2011-12-25,1,0,12,6,0,1,1,2.0
8486,2011-12-25,1,0,12,7,0,4,4,2.0
8487,2011-12-25,1,0,12,8,1,4,5,3.3333333333333335
8488,2011-12-25,1,0,12,9,3,20,23,10.666666666666666
8489,2011-12-25,1,0,12,10,31,12,43,23.666666666666668
8490,2011-12-25,1,0,12,11,43,42,85,50.333333333333336
8491,2011-12-25,1,0,12,12,25,41,66,64.66666666666667
8492,2011-12-25,1,0,12,13,40,39,79,76.66666666666667
8493,2011-12-25,1,0,12,14,41,45,86,77.0
8494,2011-12-25,1,0,12,15,43,48,91,85.33333333333333
8495,2011-12-25,1,0,12,16,35,51,86,87.66666666666667
8496,2011-12-25,1,0,12,17,11,33,44,73.66666666666667
8497,2011-12-25,1,0,12,18,7,23,30,53.333333333333336
8498,2011-12-25,1,0,12,19,2,14,16,30.0
8499,2011-12-25,1,0,12,20,8,18,26,24.0
8500,2011-12-25,1,0,12,21,4,15,19,20.333333333333332
8501,2011-12-25,1,0,12,22,2,15,17,20.666666666666668
8502,2011-12-25,1,0,12,23,2,14,16,17.333333333333332
8503,2011-12-26,1,0,12,0,5,6,11,14.666666666666666
8504,2011-12-26,1,0,12,1,3,7,10,12.333333333333334
8505,2011-12-26,1,0,12,2,2,5,7,9.333333333333334
8506,2011-12-26,1,0,12,4,0,2,2,6.333333333333333
8507,2011-12-26,1,0,12,5,0,4,4,4.333333333333333
8508,2011-12-26,1,0,12,6,0,4,4,3.3333333333333335
8509,2011-12-26,1,0,12,7,2,17,19,9.0
8510,2011-12-26,1,0,12,8,5,13,18,13.666666666666666
8511,2011-12-26,1,0,12,9,24,38,62,33.0
8512,2011-12-26,1,0,12,10,31,39,70,50.0
8513,2011-12-26,1,0,12,11,40,51,91,74.33333333333333
8514,2011-12-26,1,0,12,12,34,66,100,87.0
8515,2011-12-26,1,0,12,13,57,83,140,110.33333333333333
8516,2011-12-26,1,0,12,14,73,80,153,131.0
8517,2011-12-26,1,0,12,15,26,105,131,141.33333333333334
8518,2011-12-26,1,0,12,16,28,69,97,127.0
8519,2011-12-26,1,0,12,17,30,67,97,108.33333333333333
8520,2011-12-26,1,0,12,18,21,54,75,89.66666666666667
8521,2011-12-26,1,0,12,19,16,49,65,79.0
8522,2011-12-26,1,0,12,20,14,42,56,65.33333333333333
8523,2011-12-26,1,0,12,21,10,39,49,56.666666666666664
8524,2011-12-26,1,0,12,22,5,22,27,44.0
8525,2011-12-26,1,0,12,23,4,25,29,35.0
8526,2011-12-27,1,0,12,0,3,9,12,22.666666666666668
8527,2011-12-27,1,0,12,1,0,6,6,15.666666666666666
8528,2011-12-27,1,0,12,2,2,2,4,7.333333333333333
8529,2011-12-27,1,0,12,3,0,3,3,4.333333333333333
8530,2011-12-27,1,0,12,4,0,3,3,3.3333333333333335
8531,2011-12-27,1,0,12,5,0,8,8,4.666666666666667
8532,2011-12-27,1,0,12,6,0,35,35,15.333333333333334
8533,2011-12-27,1,0,12,7,1,79,80,41.0
8534,2011-12-27,1,0,12,8,9,155,164,93.0
8535,2011-12-27,1,0,12,9,19,85,104,116.0
8536,2011-12-27,1,0,12,10,13,47,60,109.33333333333333
8537,2011-12-27,1,0,12,11,6,24,30,64.66666666666667
8538,2011-12-27,1,0,12,12,8,16,24,38.0
8539,2011-12-27,1,0,12,13,1,19,20,24.666666666666668
8540,2011-12-27,1,0,12,14,0,14,14,19.333333333333332
8541,2011-12-27,1,0,12,15,2,17,19,17.666666666666668
8542,2011-12-27,1,0,12,16,2,44,46,26.333333333333332
8543,2011-12-27,1,0,12,17,6,109,115,60.0
8544,2011-12-27,1,0,12,18,9,126,135,98.66666666666667
8545,2011-12-27,1,0,12,19,3,87,90,113.33333333333333
8546,2011-12-27,1,0,12,20,3,66,69,98.0
8547,2011-12-27,1,0,12,21,11,52,63,74.0
8548,2011-12-27,1,0,12,22,3,29,32,54.666666666666664
8549,2011-12-27,1,0,12,23,2,24,26,40.333333333333336
8550,2011-12-28,1,0,12,0,0,10,10,22.666666666666668
8551,2011-12-28,1,0,12,1,0,12,12,16.0
8552,2011-12-28,1,0,12,2,0,7,7,9.666666666666666
8553,2011-12-28,1,0,12,3,0,4,4,7.666666666666667
8554,2011-12-28,1,0,12,5,0,9,9,6.666666666666667
8555,2011-12-28,1,0,12,6,1,42,43,18.666666666666668
8556,2011-12-28,1,0,12,7,4,106,110,54.0
8557,2011-12-28,1,0,12,8,11,206,217,123.33333333333333
8558,2011-12-28,1,0,12,9,18,171,189,172.0
8559,2011-12-28,1,0,12,10,12,84,96,167.33333333333334
8560,2011-12-28,1,0,12,11,18,93,111,132.0
8561,2011-12-28,1,0,12,12,32,108,140,115.66666666666667
8562,2011-12-28,1,0,12,13,24,135,159,136.66666666666666
8563,2011-12-28,1,0,12,14,24,96,120,139.66666666666666
8564,2011-12-28,1,0,12,15,16,101,117,132.0
8565,2011-12-28,1,0,12,16,23,144,167,134.66666666666666
8566,2011-12-28,1,0,12,17,25,225,250,178.0
8567,2011-12-28,1,0,12,18,10,159,169,195.33333333333334
8568,2011-12-28,1,0,12,19,16,135,151,190.0
8569,2011-12-28,1,0,12,20,9,70,79,133.0
8570,2011-12-28,1,0,12,21,7,63,70,100.0
8571,2011-12-28,1,0,12,22,2,31,33,60.666666666666664
8572,2011-12-28,1,0,12,23,3,36,39,47.333333333333336
8573,2011-12-29,1,0,12,0,4,24,28,33.333333333333336
8574,2011-12-29,1,0,12,1,0,15,15,27.333333333333332
8575,2011-12-29,1,0,12,2,0,3,3,15.333333333333334
8576,2011-12-29,1,0,12,3,0,2,2,6.666666666666667
8577,2011-12-29,1,0,12,4,1,2,3,2.6666666666666665
8578,2011-12-29,1,0,12,5,0,10,10,5.0
8579,2011-12-29,1,0,12,6,2,39,41,18.0
8580,2011-12-29,1,0,12,7,2,104,106,52.333333333333336
8581,2011-12-29,1,0,12,8,3,207,210,119.0
8582,2011-12-29,1,0,12,9,15,155,170,162.0
8583,2011-12-29,1,0,12,10,13,97,110,163.33333333333334
8584,2011-12-29,1,0,12,11,23,99,122,134.0
8585,2011-12-29,1,0,12,12,12,118,130,120.66666666666667
8586,2011-12-29,1,0,12,13,36,95,131,127.66666666666667
8587,2011-12-29,1,0,12,14,30,112,142,134.33333333333334
8588,2011-12-29,1,0,12,15,27,150,177,150.0
8589,2011-12-29,1,0,12,16,22,155,177,165.33333333333334
8590,2011-12-29,1,0,12,17,14,226,240,198.0
8591,2011-12-29,1,0,12,18,15,192,207,208.0
8592,2011-12-29,1,0,12,19,11,124,135,194.0
8593,2011-12-29,1,0,12,20,8,88,96,146.0
8594,2011-12-29,1,0,12,21,8,60,68,99.66666666666667
8595,2011-12-29,1,0,12,22,7,48,55,73.0
8596,2011-12-29,1,0,12,23,1,44,45,56.0
8597,2011-12-30,1,0,12,0,4,26,30,43.333333333333336
8598,2011-12-30,1,0,12,1,9,11,20,31.666666666666668
8599,2011-12-30,1,0,12,2,2,10,12,20.666666666666668
8600,2011-12-30,1,0,12,3,0,6,6,12.666666666666666
8601,2011-12-30,1,0,12,4,0,2,2,6.666666666666667
8602,2011-12-30,1,0,12,5,0,10,10,6.0
8603,2011-12-30,1,0,12,6,1,31,32,14.666666666666666
8604,2011-12-30,1,0,12,7,3,92,95,45.666666666666664
8605,2011-12-30,1,0,12,8,12,193,205,110.66666666666667
8606,2011-12-30,1,0,12,9,19,175,194,164.66666666666666
8607,2011-12-30,1,0,12,10,10,108,118,172.33333333333334
8608,2011-12-30,1,0,12,11,45,126,171,161.0
8609,2011-12-30,1,0,12,12,38,159,197,162.0
8610,2011-12-30,1,0,12,13,53,154,207,191.66666666666666
8611,2011-12-30,1,0,12,14,67,178,245,216.33333333333334
8612,2011-12-30,1,0,12,15,56,236,292,248.0
8613,2011-12-30,1,0,12,16,36,247,283,273.3333333333333
8614,2011-12-30,1,0,12,17,54,188,242,272.3333333333333
8615,2011-12-30,1,0,12,18,19,163,182,235.66666666666666
8616,2011-12-30,1,0,12,19,16,96,112,178.66666666666666
8617,2011-12-30,1,0,12,20,16,75,91,128.33333333333334
8618,2011-12-30,1,0,12,21,11,84,95,99.33333333333333
8619,2011-12-30,1,0,12,22,7,78,85,90.33333333333333
8620,2011-12-30,1,0,12,23,13,60,73,84.33333333333333
8621,2011-12-31,1,0,12,0,7,37,44,67.33333333333333
8622,2011-12-31,1,0,12,1,4,31,35,50.666666666666664
8623,2011-12-31,1,0,12,2,1,27,28,35.666666666666664
8624,2011-12-31,1,0,12,3,1,17,18,27.0
8625,2011-12-31,1,0,12,4,1,9,10,18.666666666666668
8626,2011-12-31,1,0,12,5,1,0,1,9.666666666666666
8627,2011-12-31,1,0,12,6,1,5,6,5.666666666666667
8628,2011-12-31,1,0,12,7,6,13,19,8.666666666666666
8629,2011-12-31,1,0,12,8,7,42,49,24.666666666666668
8630,2011-12-31,1,0,12,9,18,72,90,52.666666666666664
8631,2011-12-31,1,0,12,10,20,108,128,89.0
8632,2011-12-31,1,0,12,11,65,152,217,145.0
8633,2011-12-31,1,0,12,12,93,180,273,206.0
8634,2011-12-31,1,0,12,13,108,205,313,267.6666666666667
8635,2011-12-31,1,0,12,14,115,185,300,295.3333333333333
8636,2011-12-31,1,0,12,15,89,164,253,288.6666666666667
8637,2011-12-31,1,0,12,16,52,143,195,249.33333333333334
8638,2011-12-31,1,0,12,17,28,101,129,192.33333333333334
8639,2011-12-31,1,0,12,18,13,80,93,139.0
8640,2011-12-31,1,0,12,19,19,73,92,104.66666666666667
8641,2011-12-31,1,0,12,20,8,63,71,85.33333333333333
8642,2011-12-31,1,0,12,21,2,50,52,71.66666666666667
8643,2011-12-31,1,0,12,22,2,36,38,53.666666666666664
8644,2011-12-31,1,0,12,23,4,27,31,40.333333333333336
8645,2012-01-01,1,1,1,0,5,43,48,39.0
8646,2012-01-01,1,1,1,1,15,78,93,57.333333333333336
8647,2012-01-01,1,1,1,2,16,59,75,72.0
8648,2012-01-01,1,1,1,3,11,41,52,73.33333333333333
8649,2012-01-01,1,1,1,4,0,8,8,45.0
8650,2012-01-01,1,1,1,5,0,5,5,21.666666666666668
8651,2012-01-01,1,1,1,6,1,1,2,5.0
8652,2012-01-01,1,1,1,7,1,6,7,4.666666666666667
8653,2012-01-01,1,1,1,8,4,10,14,7.666666666666667
8654,2012-01-01,1,1,1,9,13,27,40,20.333333333333332
8655,2012-01-01,1,1,1,10,18,52,70,41.333333333333336
8656,2012-01-01,1,1,1,11,40,98,138,82.66666666666667
8657,2012-01-01,1,1,1,12,58,143,201,136.33333333333334
8658,2012-01-01,1,1,1,13,82,141,223,187.33333333333334
8659,2012-01-01,1,1,1,14,120,147,267,230.33333333333334
8660,2012-01-01,1,1,1,15,101,164,265,251.66666666666666
8661,2012-01-01,1,1,1,16,68,147,215,249.0
8662,2012-01-01,1,1,1,17,36,75,111,197.0
8663,2012-01-01,1,1,1,18,25,81,106,144.0
8664,2012-01-01,1,1,1,19,20,85,105,107.33333333333333
8665,2012-01-01,1,1,1,20,25,58,83,98.0
8666,2012-01-01,1,1,1,21,10,61,71,86.33333333333333
8667,2012-01-01,1,1,1,22,13,53,66,73.33333333333333
8668,2012-01-01,1,1,1,23,4,25,29,55.333333333333336
8669,2012-01-02,1,1,1,0,8,31,39,44.666666666666664
8670,2012-01-02,1,1,1,1,1,11,12,26.666666666666668
8671,2012-01-02,1,1,1,2,1,6,7,19.333333333333332
8672,2012-01-02,1,1,1,4,0,4,4,7.666666666666667
8673,2012-01-02,1,1,1,5,1,3,4,5.0
8674,2012-01-02,1,1,1,6,0,14,14,7.333333333333333
8675,2012-01-02,1,1,1,7,0,16,16,11.333333333333334
8676,2012-01-02,1,1,1,8,2,51,53,27.666666666666668
8677,2012-01-02,1,1,1,9,15,53,68,45.666666666666664
8678,2012-01-02,1,1,1,10,20,89,109,76.66666666666667
8679,2012-01-02,1,1,1,11,33,142,175,117.33333333333333
8680,2012-01-02,1,1,1,12,41,161,202,162.0
8681,2012-01-02,1,1,1,13,26,150,176,184.33333333333334
8682,2012-01-02,1,1,1,14,10,141,151,176.33333333333334
8683,2012-01-02,1,1,1,15,29,139,168,165.0
8684,2012-01-02,1,1,1,16,10,144,154,157.66666666666666
8685,2012-01-02,1,1,1,17,17,136,153,158.33333333333334
8686,2012-01-02,1,1,1,18,13,113,126,144.33333333333334
8687,2012-01-02,1,1,1,19,4,89,93,124.0
8688,2012-01-02,1,1,1,20,5,83,88,102.33333333333333
8689,2012-01-02,1,1,1,21,3,63,66,82.33333333333333
8690,2012-01-02,1,1,1,22,3,36,39,64.33333333333333
8691,2012-01-02,1,1,1,23,2,32,34,46.333333333333336
8692,2012-01-03,1,1,1,0,0,13,13,28.666666666666668
8693,2012-01-03,1,1,1,1,1,5,6,17.666666666666668
8694,2012-01-03,1,1,1,2,0,3,3,7.333333333333333
8695,2012-01-03,1,1,1,3,0,2,2,3.6666666666666665
8696,2012-01-03,1,1,1,4,0,5,5,3.3333333333333335
8697,2012-01-03,1,1,1,5,0,12,12,6.333333333333333
8698,2012-01-03,1,1,1,6,4,81,85,34.0
8699,2012-01-03,1,1,1,7,2,168,170,89.0
8700,2012-01-03,1,1,1,8,5,349,354,203.0
8701,2012-01-03,1,1,1,9,8,145,153,225.66666666666666
8702,2012-01-03,1,1,1,10,5,55,60,189.0
8703,2012-01-03,1,1,1,11,12,63,75,96.0
8704,2012-01-03,1,1,1,12,4,70,74,69.66666666666667
8705,2012-01-03,1,1,1,13,5,68,73,74.0
8706,2012-01-03,1,1,1,14,7,72,79,75.33333333333333
8707,2012-01-03,1,1,1,15,9,68,77,76.33333333333333
8708,2012-01-03,1,1,1,16,7,129,136,97.33333333333333
8709,2012-01-03,1,1,1,17,4,241,245,152.66666666666666
8710,2012-01-03,1,1,1,18,10,214,224,201.66666666666666
8711,2012-01-03,1,1,1,19,4,152,156,208.33333333333334
8712,2012-01-03,1,1,1,20,0,115,115,165.0
8713,2012-01-03,1,1,1,21,2,66,68,113.0
8714,2012-01-03,1,1,1,22,0,33,33,72.0
8715,2012-01-03,1,1,1,23,0,18,18,39.666666666666664
8716,2012-01-04,1,1,1,0,0,9,9,20.0
8717,2012-01-04,1,1,1,1,0,3,3,10.0
8718,2012-01-04,1,1,1,2,0,1,1,4.333333333333333
8719,2012-01-04,1,1,1,3,0,1,1,1.6666666666666667
8720,2012-01-04,1,1,1,4,0,2,2,1.3333333333333333
8721,2012-01-04,1,1,1,5,0,14,14,5.666666666666667
8722,2012-01-04,1,1,1,6,0,59,59,25.0
8723,2012-01-04,1,1,1,7,1,151,152,75.0
8724,2012-01-04,1,1,1,8,5,310,315,175.33333333333334
8725,2012-01-04,1,1,1,9,7,173,180,215.66666666666666
8726,2012-01-04,1,1,1,10,7,57,64,186.33333333333334
8727,2012-01-04,1,1,1,11,6,40,46,96.66666666666667
8728,2012-01-04,1,1,1,12,9,75,84,64.66666666666667
8729,2012-01-04,1,1,1,13,9,82,91,73.66666666666667
8730,2012-01-04,1,1,1,14,6,69,75,83.33333333333333
8731,2012-01-04,1,1,1,15,9,81,90,85.33333333333333
8732,2012-01-04,1,1,1,16,8,123,131,98.66666666666667
8733,2012-01-04,1,1,1,17,9,272,281,167.33333333333334
8734,2012-01-04,1,1,1,18,9,280,289,233.66666666666666
8735,2012-01-04,1,1,1,19,2,182,184,251.33333333333334
8736,2012-01-04,1,1,1,20,2,121,123,198.66666666666666
8737,2012-01-04,1,1,1,21,2,88,90,132.33333333333334
8738,2012-01-04,1,1,1,22,4,48,52,88.33333333333333
8739,2012-01-04,1,1,1,23,0,32,32,58.0
8740,2012-01-05,1,1,1,0,1,13,14,32.666666666666664
8741,2012-01-05,1,1,1,1,0,5,5,17.0
8742,2012-01-05,1,1,1,2,0,4,4,7.666666666666667
8743,2012-01-05,1,1,1,3,0,4,4,4.333333333333333
8744,2012-01-05,1,1,1,4,0,5,5,4.333333333333333
8745,2012-01-05,1,1,1,5,0,26,26,11.666666666666666
8746,2012-01-05,1,1,1,6,0,78,78,36.333333333333336
8747,2012-01-05,1,1,1,7,3,212,215,106.33333333333333
8748,2012-01-05,1,1,1,8,11,377,388,227.0
8749,2012-01-05,1,1,1,9,7,220,227,276.6666666666667
8750,2012-01-05,1,1,1,10,5,81,86,233.66666666666666
8751,2012-01-05,1,1,1,11,6,78,84,132.33333333333334
8752,2012-01-05,1,1,1,12,6,114,120,96.66666666666667
8753,2012-01-05,1,1,1,13,6,112,118,107.33333333333333
8754,2012-01-05,1,1,1,14,13,104,117,118.33333333333333
8755,2012-01-05,1,1,1,15,6,113,119,118.0
8756,2012-01-05,1,1,1,16,19,178,197,144.33333333333334
8757,2012-01-05,1,1,1,17,19,393,412,242.66666666666666
8758,2012-01-05,1,1,1,18,9,374,383,330.6666666666667
8759,2012-01-05,1,1,1,19,10,255,265,353.3333333333333
8760,2012-01-05,1,1,1,20,5,172,177,275.0
8761,2012-01-05,1,1,1,21,9,88,97,179.66666666666666
8762,2012-01-05,1,1,1,22,1,70,71,115.0
8763,2012-01-05,1,1,1,23,4,56,60,76.0
8764,2012-01-06,1,1,1,0,1,24,25,52.0
8765,2012-01-06,1,1,1,1,2,6,8,31.0
8766,2012-01-06,1,1,1,2,2,3,5,12.666666666666666
8767,2012-01-06,1,1,1,3,1,3,4,5.666666666666667
8768,2012-01-06,1,1,1,4,0,3,3,4.0
8769,2012-01-06,1,1,1,5,0,13,13,6.666666666666667
8770,2012-01-06,1,1,1,6,1,69,70,28.666666666666668
8771,2012-01-06,1,1,1,7,4,201,205,96.0
8772,2012-01-06,1,1,1,8,11,436,447,240.66666666666666
8773,2012-01-06,1,1,1,9,4,237,241,297.6666666666667
8774,2012-01-06,1,1,1,10,14,102,116,268.0
8775,2012-01-06,1,1,1,11,8,130,138,165.0
8776,2012-01-06,1,1,1,12,23,168,191,148.33333333333334
8777,2012-01-06,1,1,1,13,16,188,204,177.66666666666666
8778,2012-01-06,1,1,1,14,26,152,178,191.0
8779,2012-01-06,1,1,1,15,44,178,222,201.33333333333334
8780,2012-01-06,1,1,1,16,35,259,294,231.33333333333334
8781,2012-01-06,1,1,1,17,20,456,476,330.6666666666667
8782,2012-01-06,1,1,1,18,28,391,419,396.3333333333333
8783,2012-01-06,1,1,1,19,11,261,272,389.0
8784,2012-01-06,1,1,1,20,14,163,177,289.3333333333333
8785,2012-01-06,1,1,1,21,17,137,154,201.0
8786,2012-01-06,1,1,1,22,12,123,135,155.33333333333334
8787,2012-01-06,1,1,1,23,13,88,101,130.0
8788,2012-01-07,1,1,1,0,2,77,79,105.0
8789,2012-01-07,1,1,1,1,6,56,62,80.66666666666667
8790,2012-01-07,1,1,1,2,2,36,38,59.666666666666664
8791,2012-01-07,1,1,1,3,1,19,20,40.0
8792,2012-01-07,1,1,1,4,1,9,10,22.666666666666668
8793,2012-01-07,1,1,1,5,2,7,9,13.0
8794,2012-01-07,1,1,1,6,0,7,7,8.666666666666666
8795,2012-01-07,1,1,1,7,0,20,20,12.0
8796,2012-01-07,1,1,1,8,0,64,64,30.333333333333332
8797,2012-01-07,1,1,1,9,14,116,130,71.33333333333333
8798,2012-01-07,1,1,1,10,43,160,203,132.33333333333334
8799,2012-01-07,1,1,1,11,74,250,324,219.0
8800,2012-01-07,1,1,1,12,100,276,376,301.0
8801,2012-01-07,1,1,1,13,149,296,445,381.6666666666667
8802,2012-01-07,1,1,1,14,156,356,512,444.3333333333333
8803,2012-01-07,1,1,1,15,132,317,449,468.6666666666667
8804,2012-01-07,1,1,1,16,133,268,401,454.0
8805,2012-01-07,1,1,1,17,87,235,322,390.6666666666667
8806,2012-01-07,1,1,1,18,49,248,297,340.0
8807,2012-01-07,1,1,1,19,44,171,215,278.0
8808,2012-01-07,1,1,1,20,21,149,170,227.33333333333334
8809,2012-01-07,1,1,1,21,22,118,140,175.0
8810,2012-01-07,1,1,1,22,16,93,109,139.66666666666666
8811,2012-01-07,1,1,1,23,16,103,119,122.66666666666667
8812,2012-01-08,1,1,1,0,14,77,91,106.33333333333333
8813,2012-01-08,1,1,1,1,10,62,72,94.0
8814,2012-01-08,1,1,1,2,10,57,67,76.66666666666667
8815,2012-01-08,1,1,1,3,6,26,32,57.0
8816,2012-01-08,1,1,1,4,2,4,6,35.0
8817,2012-01-08,1,1,1,5,0,2,2,13.333333333333334
8818,2012-01-08,1,1,1,6,0,2,2,3.3333333333333335
8819,2012-01-08,1,1,1,7,1,23,24,9.333333333333334
8820,2012-01-08,1,1,1,8,4,53,57,27.666666666666668
8821,2012-01-08,1,1,1,9,23,102,125,68.66666666666667
8822,2012-01-08,1,1,1,10,27,181,208,130.0
8823,2012-01-08,1,1,1,11,55,201,256,196.33333333333334
8824,2012-01-08,1,1,1,12,78,273,351,271.6666666666667
8825,2012-01-08,1,1,1,13,77,266,343,316.6666666666667
8826,2012-01-08,1,1,1,14,75,253,328,340.6666666666667
8827,2012-01-08,1,1,1,15,89,241,330,333.6666666666667
8828,2012-01-08,1,1,1,16,58,256,314,324.0
8829,2012-01-08,1,1,1,17,22,197,219,287.6666666666667
8830,2012-01-08,1,1,1,18,19,162,181,238.0
8831,2012-01-08,1,1,1,19,8,104,112,170.66666666666666
8832,2012-01-08,1,1,1,20,7,119,126,139.66666666666666
8833,2012-01-08,1,1,1,21,10,81,91,109.66666666666667
8834,2012-01-08,1,1,1,22,4,54,58,91.66666666666667
8835,2012-01-08,1,1,1,23,0,30,30,59.666666666666664
8836,2012-01-09,1,1,1,0,3,12,15,34.333333333333336
8837,2012-01-09,1,1,1,1,1,4,5,16.666666666666668
8838,2012-01-09,1,1,1,2,2,3,5,8.333333333333334
8839,2012-01-09,1,1,1,3,0,3,3,4.333333333333333
8840,2012-01-09,1,1,1,4,0,4,4,4.0
8841,2012-01-09,1,1,1,5,0,21,21,9.333333333333334
8842,2012-01-09,1,1,1,6,3,85,88,37.666666666666664
8843,2012-01-09,1,1,1,7,1,239,240,116.33333333333333
8844,2012-01-09,1,1,1,8,13,407,420,249.33333333333334
8845,2012-01-09,1,1,1,9,9,188,197,285.6666666666667
8846,2012-01-09,1,1,1,10,13,95,108,241.66666666666666
8847,2012-01-09,1,1,1,11,6,82,88,131.0
8848,2012-01-09,1,1,1,12,10,93,103,99.66666666666667
8849,2012-01-09,1,1,1,13,3,77,80,90.33333333333333
8850,2012-01-09,1,1,1,14,5,45,50,77.66666666666667
8851,2012-01-09,1,1,1,15,5,64,69,66.33333333333333
8852,2012-01-09,1,1,1,16,3,46,49,56.0
8853,2012-01-09,1,1,1,17,5,147,152,90.0
8854,2012-01-09,1,1,1,18,6,158,164,121.66666666666667
8855,2012-01-09,1,1,1,19,3,187,190,168.66666666666666
8856,2012-01-09,1,1,1,20,5,127,132,162.0
8857,2012-01-09,1,1,1,21,1,78,79,133.66666666666666
8858,2012-01-09,1,1,1,22,8,54,62,91.0
8859,2012-01-09,1,1,1,23,1,51,52,64.33333333333333
8860,2012-01-10,1,1,1,0,0,14,14,42.666666666666664
8861,2012-01-10,1,1,1,1,2,3,5,23.666666666666668
8862,2012-01-10,1,1,1,2,2,2,4,7.666666666666667
8863,2012-01-10,1,1,1,4,0,4,4,4.333333333333333
8864,2012-01-10,1,1,1,5,0,23,23,10.333333333333334
8865,2012-01-10,1,1,1,6,0,79,79,35.333333333333336
8866,2012-01-10,1,1,1,7,3,219,222,108.0
8867,2012-01-10,1,1,1,8,6,465,471,257.3333333333333
8868,2012-01-10,1,1,1,9,11,184,195,296.0
8869,2012-01-10,1,1,1,10,3,80,83,249.66666666666666
8870,2012-01-10,1,1,1,11,8,93,101,126.33333333333333
8871,2012-01-10,1,1,1,12,13,127,140,108.0
8872,2012-01-10,1,1,1,13,15,163,178,139.66666666666666
8873,2012-01-10,1,1,1,14,10,96,106,141.33333333333334
8874,2012-01-10,1,1,1,15,17,119,136,140.0
8875,2012-01-10,1,1,1,16,15,225,240,160.66666666666666
8876,2012-01-10,1,1,1,17,14,446,460,278.6666666666667
8877,2012-01-10,1,1,1,18,13,372,385,361.6666666666667
8878,2012-01-10,1,1,1,19,11,270,281,375.3333333333333
8879,2012-01-10,1,1,1,20,10,190,200,288.6666666666667
8880,2012-01-10,1,1,1,21,7,109,116,199.0
8881,2012-01-10,1,1,1,22,10,104,114,143.33333333333334
8882,2012-01-10,1,1,1,23,3,38,41,90.33333333333333
8883,2012-01-11,1,1,1,0,2,26,28,61.0
8884,2012-01-11,1,1,1,1,1,6,7,25.333333333333332
8885,2012-01-11,1,1,1,2,0,5,5,13.333333333333334
8886,2012-01-11,1,1,1,3,0,4,4,5.333333333333333
8887,2012-01-11,1,1,1,4,0,2,2,3.6666666666666665
8888,2012-01-11,1,1,1,5,0,22,22,9.333333333333334
8889,2012-01-11,1,1,1,6,2,72,74,32.666666666666664
8890,2012-01-11,1,1,1,7,9,247,256,117.33333333333333
8891,2012-01-11,1,1,1,8,11,488,499,276.3333333333333
8892,2012-01-11,1,1,1,9,7,218,225,326.6666666666667
8893,2012-01-11,1,1,1,10,13,84,97,273.6666666666667
8894,2012-01-11,1,1,1,11,9,90,99,140.33333333333334
8895,2012-01-11,1,1,1,12,4,51,55,83.66666666666667
8896,2012-01-11,1,1,1,13,8,57,65,73.0
8897,2012-01-11,1,1,1,14,3,70,73,64.33333333333333
8898,2012-01-11,1,1,1,15,6,73,79,72.33333333333333
8899,2012-01-11,1,1,1,16,6,112,118,90.0
8900,2012-01-11,1,1,1,17,6,128,134,110.33333333333333
8901,2012-01-11,1,1,1,18,2,96,98,116.66666666666667
8902,2012-01-11,1,1,1,19,1,92,93,108.33333333333333
8903,2012-01-11,1,1,1,20,2,55,57,82.66666666666667
8904,2012-01-11,1,1,1,21,0,29,29,59.666666666666664
8905,2012-01-11,1,1,1,22,0,49,49,45.0
8906,2012-01-11,1,1,1,23,0,9,9,29.0
8907,2012-01-12,1,1,1,0,0,3,3,20.333333333333332
8908,2012-01-12,1,1,1,1,0,3,3,5.0
8909,2012-01-12,1,1,1,2,1,1,2,2.6666666666666665
8910,2012-01-12,1,1,1,3,0,3,3,2.6666666666666665
8911,2012-01-12,1,1,1,4,0,2,2,2.3333333333333335
8912,2012-01-12,1,1,1,5,0,16,16,7.0
8913,2012-01-12,1,1,1,6,1,88,89,35.666666666666664
8914,2012-01-12,1,1,1,7,2,218,220,108.33333333333333
8915,2012-01-12,1,1,1,8,11,497,508,272.3333333333333
8916,2012-01-12,1,1,1,9,10,220,230,319.3333333333333
8917,2012-01-12,1,1,1,10,6,84,90,276.0
8918,2012-01-12,1,1,1,11,18,101,119,146.33333333333334
8919,2012-01-12,1,1,1,12,14,130,144,117.66666666666667
8920,2012-01-12,1,1,1,13,13,170,183,148.66666666666666
8921,2012-01-12,1,1,1,14,24,132,156,161.0
8922,2012-01-12,1,1,1,15,32,156,188,175.66666666666666
8923,2012-01-12,1,1,1,16,33,248,281,208.33333333333334
8924,2012-01-12,1,1,1,17,23,472,495,321.3333333333333
8925,2012-01-12,1,1,1,18,22,399,421,399.0
8926,2012-01-12,1,1,1,19,17,313,330,415.3333333333333
8927,2012-01-12,1,1,1,20,11,229,240,330.3333333333333
8928,2012-01-12,1,1,1,21,12,162,174,248.0
8929,2012-01-12,1,1,1,22,12,121,133,182.33333333333334
8930,2012-01-12,1,1,1,23,7,60,67,124.66666666666667
8931,2012-01-13,1,1,1,0,4,38,42,80.66666666666667
8932,2012-01-13,1,1,1,1,0,12,12,40.333333333333336
8933,2012-01-13,1,1,1,2,1,13,14,22.666666666666668
8934,2012-01-13,1,1,1,3,3,4,7,11.0
8935,2012-01-13,1,1,1,4,1,2,3,8.0
8936,2012-01-13,1,1,1,5,0,21,21,10.333333333333334
8937,2012-01-13,1,1,1,6,2,71,73,32.333333333333336
8938,2012-01-13,1,1,1,7,3,174,177,90.33333333333333
8939,2012-01-13,1,1,1,8,11,408,419,223.0
8940,2012-01-13,1,1,1,9,10,204,214,270.0
8941,2012-01-13,1,1,1,10,2,101,103,245.33333333333334
8942,2012-01-13,1,1,1,11,12,102,114,143.66666666666666
8943,2012-01-13,1,1,1,12,14,140,154,123.66666666666667
8944,2012-01-13,1,1,1,13,14,140,154,140.66666666666666
8945,2012-01-13,1,1,1,14,10,119,129,145.66666666666666
8946,2012-01-13,1,1,1,15,15,123,138,140.33333333333334
8947,2012-01-13,1,1,1,16,18,215,233,166.66666666666666
8948,2012-01-13,1,1,1,17,15,317,332,234.33333333333334
8949,2012-01-13,1,1,1,18,7,294,301,288.6666666666667
8950,2012-01-13,1,1,1,19,7,199,206,279.6666666666667
8951,2012-01-13,1,1,1,20,6,130,136,214.33333333333334
8952,2012-01-13,1,1,1,21,7,95,102,148.0
8953,2012-01-13,1,1,1,22,7,58,65,101.0
8954,2012-01-13,1,1,1,23,5,60,65,77.33333333333333
8955,2012-01-14,1,1,1,0,2,42,44,58.0
8956,2012-01-14,1,1,1,1,6,44,50,53.0
8957,2012-01-14,1,1,1,2,6,32,38,44.0
8958,2012-01-14,1,1,1,3,6,14,20,36.0
8959,2012-01-14,1,1,1,4,0,3,3,20.333333333333332
8960,2012-01-14,1,1,1,5,0,4,4,9.0
8961,2012-01-14,1,1,1,6,0,5,5,4.0
8962,2012-01-14,1,1,1,7,0,24,24,11.0
8963,2012-01-14,1,1,1,8,3,89,92,40.333333333333336
8964,2012-01-14,1,1,1,9,3,78,81,65.66666666666667
8965,2012-01-14,1,1,1,10,14,135,149,107.33333333333333
8966,2012-01-14,1,1,1,11,28,150,178,136.0
8967,2012-01-14,1,1,1,12,30,189,219,182.0
8968,2012-01-14,1,1,1,13,38,182,220,205.66666666666666
8969,2012-01-14,1,1,1,14,52,179,231,223.33333333333334
8970,2012-01-14,1,1,1,15,49,177,226,225.66666666666666
8971,2012-01-14,1,1,1,16,28,178,206,221.0
8972,2012-01-14,1,1,1,17,15,129,144,192.0
8973,2012-01-14,1,1,1,18,21,122,143,164.33333333333334
8974,2012-01-14,1,1,1,19,12,90,102,129.66666666666666
8975,2012-01-14,1,1,1,20,8,95,103,116.0
8976,2012-01-14,1,1,1,21,3,66,69,91.33333333333333
8977,2012-01-14,1,1,1,22,4,62,66,79.33333333333333
8978,2012-01-14,1,1,1,23,5,71,76,70.33333333333333
8979,2012-01-15,1,1,1,0,9,50,59,67.0
8980,2012-01-15,1,1,1,1,2,40,42,59.0
8981,2012-01-15,1,1,1,2,5,38,43,48.0
8982,2012-01-15,1,1,1,3,1,24,25,36.666666666666664
8983,2012-01-15,1,1,1,4,1,5,6,24.666666666666668
8984,2012-01-15,1,1,1,5,0,5,5,12.0
8985,2012-01-15,1,1,1,6,1,7,8,6.333333333333333
8986,2012-01-15,1,1,1,7,3,14,17,10.0
8987,2012-01-15,1,1,1,8,2,34,36,20.333333333333332
8988,2012-01-15,1,1,1,9,10,80,90,47.666666666666664
8989,2012-01-15,1,1,1,10,11,115,126,84.0
8990,2012-01-15,1,1,1,11,21,144,165,127.0
8991,2012-01-15,1,1,1,12,42,192,234,175.0
8992,2012-01-15,1,1,1,13,40,184,224,207.66666666666666
8993,2012-01-15,1,1,1,14,25,163,188,215.33333333333334
8994,2012-01-15,1,1,1,15,33,173,206,206.0
8995,2012-01-15,1,1,1,16,31,174,205,199.66666666666666
8996,2012-01-15,1,1,1,17,15,131,146,185.66666666666666
8997,2012-01-15,1,1,1,18,7,113,120,157.0
8998,2012-01-15,1,1,1,19,9,101,110,125.33333333333333
8999,2012-01-15,1,1,1,20,10,85,95,108.33333333333333
9000,2012-01-15,1,1,1,21,1,71,72,92.33333333333333
9001,2012-01-15,1,1,1,22,2,58,60,75.66666666666667
9002,2012-01-15,1,1,1,23,3,26,29,53.666666666666664
9003,2012-01-16,1,1,1,0,2,23,25,38.0
9004,2012-01-16,1,1,1,1,2,18,20,24.666666666666668
9005,2012-01-16,1,1,1,2,3,14,17,20.666666666666668
9006,2012-01-16,1,1,1,3,0,3,3,13.333333333333334
9007,2012-01-16,1,1,1,4,2,6,8,9.333333333333334
9008,2012-01-16,1,1,1,5,1,5,6,5.666666666666667
9009,2012-01-16,1,1,1,6,0,13,13,9.0
9010,2012-01-16,1,1,1,7,5,28,33,17.333333333333332
9011,2012-01-16,1,1,1,8,3,75,78,41.333333333333336
9012,2012-01-16,1,1,1,9,7,89,96,69.0
9013,2012-01-16,1,1,1,10,19,107,126,100.0
9014,2012-01-16,1,1,1,11,21,158,179,133.66666666666666
9015,2012-01-16,1,1,1,12,20,165,185,163.33333333333334
9016,2012-01-16,1,1,1,13,26,202,228,197.33333333333334
9017,2012-01-16,1,1,1,14,23,158,181,198.0
9018,2012-01-16,1,1,1,15,17,175,192,200.33333333333334
9019,2012-01-16,1,1,1,16,22,158,180,184.33333333333334
9020,2012-01-16,1,1,1,17,19,174,193,188.33333333333334
9021,2012-01-16,1,1,1,18,6,175,181,184.66666666666666
9022,2012-01-16,1,1,1,19,10,134,144,172.66666666666666
9023,2012-01-16,1,1,1,20,2,88,90,138.33333333333334
9024,2012-01-16,1,1,1,21,3,46,49,94.33333333333333
9025,2012-01-16,1,1,1,22,4,39,43,60.666666666666664
9026,2012-01-16,1,1,1,23,0,28,28,40.0
9027,2012-01-17,1,1,1,0,0,12,12,27.666666666666668
9028,2012-01-17,1,1,1,1,0,2,2,14.0
9029,2012-01-17,1,1,1,2,0,12,12,8.666666666666666
9030,2012-01-17,1,1,1,4,0,2,2,5.333333333333333
9031,2012-01-17,1,1,1,5,0,13,13,9.0
9032,2012-01-17,1,1,1,6,0,57,57,24.0
9033,2012-01-17,1,1,1,7,5,121,126,65.33333333333333
9034,2012-01-17,1,1,1,8,3,90,93,92.0
9035,2012-01-17,1,1,1,9,7,61,68,95.66666666666667
9036,2012-01-17,1,1,1,10,1,61,62,74.33333333333333
9037,2012-01-17,1,1,1,11,2,73,75,68.33333333333333
9038,2012-01-17,1,1,1,12,3,83,86,74.33333333333333
9039,2012-01-17,1,1,1,13,8,95,103,88.0
9040,2012-01-17,1,1,1,14,12,120,132,107.0
9041,2012-01-17,1,1,1,15,6,123,129,121.33333333333333
9042,2012-01-17,1,1,1,16,14,205,219,160.0
9043,2012-01-17,1,1,1,17,20,442,462,270.0
9044,2012-01-17,1,1,1,18,12,451,463,381.3333333333333
9045,2012-01-17,1,1,1,19,11,297,308,411.0
9046,2012-01-17,1,1,1,20,11,169,180,317.0
9047,2012-01-17,1,1,1,21,6,174,180,222.66666666666666
9048,2012-01-17,1,1,1,22,5,85,90,150.0
9049,2012-01-17,1,1,1,23,1,60,61,110.33333333333333
9050,2012-01-18,1,1,1,0,3,14,17,56.0
9051,2012-01-18,1,1,1,1,0,10,10,29.333333333333332
9052,2012-01-18,1,1,1,2,1,1,2,9.666666666666666
9053,2012-01-18,1,1,1,3,1,3,4,5.333333333333333
9054,2012-01-18,1,1,1,4,0,1,1,2.3333333333333335
9055,2012-01-18,1,1,1,5,0,29,29,11.333333333333334
9056,2012-01-18,1,1,1,6,0,88,88,39.333333333333336
9057,2012-01-18,1,1,1,7,1,262,263,126.66666666666667
9058,2012-01-18,1,1,1,8,15,474,489,280.0
9059,2012-01-18,1,1,1,9,6,196,202,318.0
9060,2012-01-18,1,1,1,10,5,88,93,261.3333333333333
9061,2012-01-18,1,1,1,11,4,110,114,136.33333333333334
9062,2012-01-18,1,1,1,12,6,155,161,122.66666666666667
9063,2012-01-18,1,1,1,13,6,124,130,135.0
9064,2012-01-18,1,1,1,14,7,98,105,132.0
9065,2012-01-18,1,1,1,15,8,122,130,121.66666666666667
9066,2012-01-18,1,1,1,16,13,163,176,137.0
9067,2012-01-18,1,1,1,17,8,338,346,217.33333333333334
9068,2012-01-18,1,1,1,18,8,347,355,292.3333333333333
9069,2012-01-18,1,1,1,19,5,251,256,319.0
9070,2012-01-18,1,1,1,20,1,164,165,258.6666666666667
9071,2012-01-18,1,1,1,21,5,119,124,181.66666666666666
9072,2012-01-18,1,1,1,22,4,74,78,122.33333333333333
9073,2012-01-18,1,1,1,23,2,36,38,80.0
9074,2012-01-19,1,1,1,0,0,16,16,44.0
9075,2012-01-19,1,1,1,1,0,5,5,19.666666666666668
9076,2012-01-19,1,1,1,2,0,3,3,8.0
9077,2012-01-19,1,1,1,3,0,4,4,4.0
9078,2012-01-19,1,1,1,4,0,1,1,2.6666666666666665
9079,2012-01-19,1,1,1,5,0,19,19,8.0
9080,2012-01-19,1,1,1,6,0,86,86,35.333333333333336
9081,2012-01-19,1,1,1,7,2,204,206,103.66666666666667
9082,2012-01-19,1,1,1,8,9,414,423,238.33333333333334
9083,2012-01-19,1,1,1,9,6,204,210,279.6666666666667
9084,2012-01-19,1,1,1,10,10,98,108,247.0
9085,2012-01-19,1,1,1,11,6,93,99,139.0
9086,2012-01-19,1,1,1,12,5,106,111,106.0
9087,2012-01-19,1,1,1,13,6,118,124,111.33333333333333
9088,2012-01-19,1,1,1,14,15,104,119,118.0
9089,2012-01-19,1,1,1,15,9,118,127,123.33333333333333
9090,2012-01-19,1,1,1,16,8,185,193,146.33333333333334
9091,2012-01-19,1,1,1,17,21,364,385,235.0
9092,2012-01-19,1,1,1,18,16,345,361,313.0
9093,2012-01-19,1,1,1,19,5,229,234,326.6666666666667
9094,2012-01-19,1,1,1,20,7,184,191,262.0
9095,2012-01-19,1,1,1,21,4,117,121,182.0
9096,2012-01-19,1,1,1,22,0,90,90,134.0
9097,2012-01-19,1,1,1,23,1,55,56,89.0
9098,2012-01-20,1,1,1,0,3,24,27,57.666666666666664
9099,2012-01-20,1,1,1,1,0,15,15,32.666666666666664
9100,2012-01-20,1,1,1,2,0,11,11,17.666666666666668
9101,2012-01-20,1,1,1,3,0,4,4,10.0
9102,2012-01-20,1,1,1,4,0,3,3,6.0
9103,2012-01-20,1,1,1,5,0,19,19,8.666666666666666
9104,2012-01-20,1,1,1,6,0,68,68,30.0
9105,2012-01-20,1,1,1,7,2,183,185,90.66666666666667
9106,2012-01-20,1,1,1,8,4,421,425,226.0
9107,2012-01-20,1,1,1,9,21,242,263,291.0
9108,2012-01-20,1,1,1,10,1,96,97,261.6666666666667
9109,2012-01-20,1,1,1,11,6,117,123,161.0
9110,2012-01-20,1,1,1,12,5,119,124,114.66666666666667
9111,2012-01-20,1,1,1,13,12,144,156,134.33333333333334
9112,2012-01-20,1,1,1,14,8,107,115,131.66666666666666
9113,2012-01-20,1,1,1,15,12,144,156,142.33333333333334
9114,2012-01-20,1,1,1,16,11,163,174,148.33333333333334
9115,2012-01-20,1,1,1,17,9,340,349,226.33333333333334
9116,2012-01-20,1,1,1,18,5,296,301,274.6666666666667
9117,2012-01-20,1,1,1,19,6,186,192,280.6666666666667
9118,2012-01-20,1,1,1,20,1,141,142,211.66666666666666
9119,2012-01-20,1,1,1,21,5,99,104,146.0
9120,2012-01-20,1,1,1,22,1,71,72,106.0
9121,2012-01-20,1,1,1,23,3,35,38,71.33333333333333
9122,2012-01-21,1,1,1,0,0,24,24,44.666666666666664
9123,2012-01-21,1,1,1,1,1,22,23,28.333333333333332
9124,2012-01-21,1,1,1,2,1,25,26,24.333333333333332
9125,2012-01-21,1,1,1,3,0,13,13,20.666666666666668
9126,2012-01-21,1,1,1,4,0,1,1,13.333333333333334
9127,2012-01-21,1,1,1,5,0,2,2,5.333333333333333
9128,2012-01-21,1,1,1,6,0,1,1,1.3333333333333333
9129,2012-01-21,1,1,1,7,3,10,13,5.333333333333333
9130,2012-01-21,1,1,1,8,3,22,25,13.0
9131,2012-01-21,1,1,1,9,2,40,42,26.666666666666668
9132,2012-01-21,1,1,1,10,0,45,45,37.333333333333336
9133,2012-01-21,1,1,1,11,1,62,63,50.0
9134,2012-01-21,1,1,1,12,5,62,67,58.333333333333336
9135,2012-01-21,1,1,1,13,10,66,76,68.66666666666667
9136,2012-01-21,1,1,1,14,6,89,95,79.33333333333333
9137,2012-01-21,1,1,1,15,6,113,119,96.66666666666667
9138,2012-01-21,1,1,1,16,5,113,118,110.66666666666667
9139,2012-01-21,1,1,1,17,7,99,106,114.33333333333333
9140,2012-01-21,1,1,1,18,3,107,110,111.33333333333333
9141,2012-01-21,1,1,1,19,0,85,85,100.33333333333333
9142,2012-01-21,1,1,1,20,5,62,67,87.33333333333333
9143,2012-01-21,1,1,1,21,5,64,69,73.66666666666667
9144,2012-01-21,1,1,1,22,3,56,59,65.0
9145,2012-01-21,1,1,1,23,1,51,52,60.0
9146,2012-01-22,1,1,1,0,1,51,52,54.333333333333336
9147,2012-01-22,1,1,1,1,1,49,50,51.333333333333336
9148,2012-01-22,1,1,1,2,1,46,47,49.666666666666664
9149,2012-01-22,1,1,1,3,1,20,21,39.333333333333336
9150,2012-01-22,1,1,1,4,1,1,2,23.333333333333332
9151,2012-01-22,1,1,1,5,1,2,3,8.666666666666666
9152,2012-01-22,1,1,1,6,0,4,4,3.0
9153,2012-01-22,1,1,1,7,2,11,13,6.666666666666667
9154,2012-01-22,1,1,1,8,3,29,32,16.333333333333332
9155,2012-01-22,1,1,1,9,9,54,63,36.0
9156,2012-01-22,1,1,1,10,9,120,129,74.66666666666667
9157,2012-01-22,1,1,1,11,18,115,133,108.33333333333333
9158,2012-01-22,1,1,1,12,24,161,185,149.0
9159,2012-01-22,1,1,1,13,24,175,199,172.33333333333334
9160,2012-01-22,1,1,1,14,19,163,182,188.66666666666666
9161,2012-01-22,1,1,1,15,27,149,176,185.66666666666666
9162,2012-01-22,1,1,1,16,12,143,155,171.0
9163,2012-01-22,1,1,1,17,8,100,108,146.33333333333334
9164,2012-01-22,1,1,1,18,11,110,121,128.0
9165,2012-01-22,1,1,1,19,9,80,89,106.0
9166,2012-01-22,1,1,1,20,5,69,74,94.66666666666667
9167,2012-01-22,1,1,1,21,8,36,44,69.0
9168,2012-01-22,1,1,1,22,0,58,58,58.666666666666664
9169,2012-01-22,1,1,1,23,2,35,37,46.333333333333336
9170,2012-01-23,1,1,1,0,2,17,19,38.0
9171,2012-01-23,1,1,1,1,0,4,4,20.0
9172,2012-01-23,1,1,1,2,0,2,2,8.333333333333334
9173,2012-01-23,1,1,1,3,0,1,1,2.3333333333333335
9174,2012-01-23,1,1,1,4,0,1,1,1.3333333333333333
9175,2012-01-23,1,1,1,5,0,19,19,7.0
9176,2012-01-23,1,1,1,6,6,36,42,20.666666666666668
9177,2012-01-23,1,1,1,7,8,114,122,61.0
9178,2012-01-23,1,1,1,8,5,267,272,145.33333333333334
9179,2012-01-23,1,1,1,9,13,198,211,201.66666666666666
9180,2012-01-23,1,1,1,10,10,139,149,210.66666666666666
9181,2012-01-23,1,1,1,11,5,57,62,140.66666666666666
9182,2012-01-23,1,1,1,12,10,52,62,91.0
9183,2012-01-23,1,1,1,13,5,32,37,53.666666666666664
9184,2012-01-23,1,1,1,14,13,48,61,53.333333333333336
9185,2012-01-23,1,1,1,15,10,64,74,57.333333333333336
9186,2012-01-23,1,1,1,16,14,108,122,85.66666666666667
9187,2012-01-23,1,1,1,17,6,270,276,157.33333333333334
9188,2012-01-23,1,1,1,18,7,275,282,226.66666666666666
9189,2012-01-23,1,1,1,19,9,211,220,259.3333333333333
9190,2012-01-23,1,1,1,20,8,161,169,223.66666666666666
9191,2012-01-23,1,1,1,21,8,112,120,169.66666666666666
9192,2012-01-23,1,1,1,22,4,64,68,119.0
9193,2012-01-23,1,1,1,23,2,35,37,75.0
9194,2012-01-24,1,1,1,0,6,19,25,43.333333333333336
9195,2012-01-24,1,1,1,1,2,7,9,23.666666666666668
9196,2012-01-24,1,1,1,2,2,6,8,14.0
9197,2012-01-24,1,1,1,3,0,3,3,6.666666666666667
9198,2012-01-24,1,1,1,4,0,2,2,4.333333333333333
9199,2012-01-24,1,1,1,5,0,26,26,10.333333333333334
9200,2012-01-24,1,1,1,6,1,88,89,39.0
9201,2012-01-24,1,1,1,7,11,221,232,115.66666666666667
9202,2012-01-24,1,1,1,8,11,479,490,270.3333333333333
9203,2012-01-24,1,1,1,9,11,244,255,325.6666666666667
9204,2012-01-24,1,1,1,10,23,93,116,287.0
9205,2012-01-24,1,1,1,11,30,123,153,174.66666666666666
9206,2012-01-24,1,1,1,12,25,150,175,148.0
9207,2012-01-24,1,1,1,13,33,170,203,177.0
9208,2012-01-24,1,1,1,14,35,138,173,183.66666666666666
9209,2012-01-24,1,1,1,15,52,156,208,194.66666666666666
9210,2012-01-24,1,1,1,16,35,243,278,219.66666666666666
9211,2012-01-24,1,1,1,17,41,474,515,333.6666666666667
9212,2012-01-24,1,1,1,18,32,391,423,405.3333333333333
9213,2012-01-24,1,1,1,19,20,311,331,423.0
9214,2012-01-24,1,1,1,20,18,211,229,327.6666666666667
9215,2012-01-24,1,1,1,21,18,154,172,244.0
9216,2012-01-24,1,1,1,22,14,111,125,175.33333333333334
9217,2012-01-24,1,1,1,23,19,80,99,132.0
9218,2012-01-25,1,1,1,0,6,25,31,85.0
9219,2012-01-25,1,1,1,1,4,9,13,47.666666666666664
9220,2012-01-25,1,1,1,2,3,3,6,16.666666666666668
9221,2012-01-25,1,1,1,3,0,1,1,6.666666666666667
9222,2012-01-25,1,1,1,4,0,4,4,3.6666666666666665
9223,2012-01-25,1,1,1,5,0,33,33,12.666666666666666
9224,2012-01-25,1,1,1,6,1,87,88,41.666666666666664
9225,2012-01-25,1,1,1,7,14,243,257,126.0
9226,2012-01-25,1,1,1,8,18,495,513,286.0
9227,2012-01-25,1,1,1,9,18,218,236,335.3333333333333
9228,2012-01-25,1,1,1,10,30,111,141,296.6666666666667
9229,2012-01-25,1,1,1,11,52,105,157,178.0
9230,2012-01-25,1,1,1,12,46,147,193,163.66666666666666
9231,2012-01-25,1,1,1,13,63,149,212,187.33333333333334
9232,2012-01-25,1,1,1,14,53,107,160,188.33333333333334
9233,2012-01-25,1,1,1,15,30,125,155,175.66666666666666
9234,2012-01-25,1,1,1,16,29,217,246,187.0
9235,2012-01-25,1,1,1,17,27,443,470,290.3333333333333
9236,2012-01-25,1,1,1,18,24,415,439,385.0
9237,2012-01-25,1,1,1,19,5,311,316,408.3333333333333
9238,2012-01-25,1,1,1,20,10,225,235,330.0
9239,2012-01-25,1,1,1,21,19,166,185,245.33333333333334
9240,2012-01-25,1,1,1,22,12,101,113,177.66666666666666
9241,2012-01-25,1,1,1,23,3,63,66,121.33333333333333
9242,2012-01-26,1,1,1,0,3,22,25,68.0
9243,2012-01-26,1,1,1,1,5,16,21,37.333333333333336
9244,2012-01-26,1,1,1,2,1,6,7,17.666666666666668
9245,2012-01-26,1,1,1,3,1,5,6,11.333333333333334
9246,2012-01-26,1,1,1,4,0,3,3,5.333333333333333
9247,2012-01-26,1,1,1,5,0,28,28,12.333333333333334
9248,2012-01-26,1,1,1,6,0,88,88,39.666666666666664
9249,2012-01-26,1,1,1,7,11,228,239,118.33333333333333
9250,2012-01-26,1,1,1,8,16,514,530,285.6666666666667
9251,2012-01-26,1,1,1,9,18,256,274,347.6666666666667
9252,2012-01-26,1,1,1,10,16,92,108,304.0
9253,2012-01-26,1,1,1,11,11,100,111,164.33333333333334
9254,2012-01-26,1,1,1,12,29,136,165,128.0
9255,2012-01-26,1,1,1,13,17,156,173,149.66666666666666
9256,2012-01-26,1,1,1,14,16,112,128,155.33333333333334
9257,2012-01-26,1,1,1,15,22,142,164,155.0
9258,2012-01-26,1,1,1,16,15,209,224,172.0
9259,2012-01-26,1,1,1,17,16,397,413,267.0
9260,2012-01-26,1,1,1,18,12,394,406,347.6666666666667
9261,2012-01-26,1,1,1,19,11,302,313,377.3333333333333
9262,2012-01-26,1,1,1,20,8,216,224,314.3333333333333
9263,2012-01-26,1,1,1,21,8,184,192,243.0
9264,2012-01-26,1,1,1,22,3,139,142,186.0
9265,2012-01-26,1,1,1,23,5,86,91,141.66666666666666
9266,2012-01-27,1,1,1,0,6,32,38,90.33333333333333
9267,2012-01-27,1,1,1,1,6,23,29,52.666666666666664
9268,2012-01-27,1,1,1,2,2,11,13,26.666666666666668
9269,2012-01-27,1,1,1,3,3,5,8,16.666666666666668
9270,2012-01-27,1,1,1,4,1,3,4,8.333333333333334
9271,2012-01-27,1,1,1,5,0,24,24,12.0
9272,2012-01-27,1,1,1,6,0,72,72,33.333333333333336
9273,2012-01-27,1,1,1,7,6,128,134,76.66666666666667
9274,2012-01-27,1,1,1,8,14,206,220,142.0
9275,2012-01-27,1,1,1,9,6,101,107,153.66666666666666
9276,2012-01-27,1,1,1,10,9,117,126,151.0
9277,2012-01-27,1,1,1,11,10,95,105,112.66666666666667
9278,2012-01-27,1,1,1,12,25,155,180,137.0
9279,2012-01-27,1,1,1,13,26,175,201,162.0
9280,2012-01-27,1,1,1,14,23,153,176,185.66666666666666
9281,2012-01-27,1,1,1,15,27,170,197,191.33333333333334
9282,2012-01-27,1,1,1,16,26,241,267,213.33333333333334
9283,2012-01-27,1,1,1,17,16,406,422,295.3333333333333
9284,2012-01-27,1,1,1,18,20,363,383,357.3333333333333
9285,2012-01-27,1,1,1,19,10,241,251,352.0
9286,2012-01-27,1,1,1,20,6,153,159,264.3333333333333
9287,2012-01-27,1,1,1,21,8,127,135,181.66666666666666
9288,2012-01-27,1,1,1,22,11,108,119,137.66666666666666
9289,2012-01-27,1,1,1,23,8,78,86,113.33333333333333
9290,2012-01-28,1,1,1,0,1,68,69,91.33333333333333
9291,2012-01-28,1,1,1,1,1,57,58,71.0
9292,2012-01-28,1,1,1,2,3,38,41,56.0
9293,2012-01-28,1,1,1,3,1,16,17,38.666666666666664
9294,2012-01-28,1,1,1,4,0,8,8,22.0
9295,2012-01-28,1,1,1,5,0,10,10,11.666666666666666
9296,2012-01-28,1,1,1,6,3,12,15,11.0
9297,2012-01-28,1,1,1,7,3,28,31,18.666666666666668
9298,2012-01-28,1,1,1,8,9,82,91,45.666666666666664
9299,2012-01-28,1,1,1,9,13,145,158,93.33333333333333
9300,2012-01-28,1,1,1,10,27,164,191,146.66666666666666
9301,2012-01-28,1,1,1,11,55,241,296,215.0
9302,2012-01-28,1,1,1,12,70,244,314,267.0
9303,2012-01-28,1,1,1,13,80,293,373,327.6666666666667
9304,2012-01-28,1,1,1,14,123,239,362,349.6666666666667
9305,2012-01-28,1,1,1,15,90,320,410,381.6666666666667
9306,2012-01-28,1,1,1,16,131,276,407,393.0
9307,2012-01-28,1,1,1,17,57,233,290,369.0
9308,2012-01-28,1,1,1,18,40,201,241,312.6666666666667
9309,2012-01-28,1,1,1,19,33,173,206,245.66666666666666
9310,2012-01-28,1,1,1,20,5,115,120,189.0
9311,2012-01-28,1,1,1,21,18,109,127,151.0
9312,2012-01-28,1,1,1,22,6,97,103,116.66666666666667
9313,2012-01-28,1,1,1,23,6,79,85,105.0
9314,2012-01-29,1,1,1,0,15,81,96,94.66666666666667
9315,2012-01-29,1,1,1,1,5,68,73,84.66666666666667
9316,2012-01-29,1,1,1,2,3,48,51,73.33333333333333
9317,2012-01-29,1,1,1,3,4,17,21,48.333333333333336
9318,2012-01-29,1,1,1,4,0,5,5,25.666666666666668
9319,2012-01-29,1,1,1,5,1,6,7,11.0
9320,2012-01-29,1,1,1,6,1,4,5,5.666666666666667
9321,2012-01-29,1,1,1,7,0,12,12,8.0
9322,2012-01-29,1,1,1,8,9,61,70,29.0
9323,2012-01-29,1,1,1,9,13,98,111,64.33333333333333
9324,2012-01-29,1,1,1,10,38,153,191,124.0
9325,2012-01-29,1,1,1,11,57,198,255,185.66666666666666
9326,2012-01-29,1,1,1,12,73,215,288,244.66666666666666
9327,2012-01-29,1,1,1,13,78,238,316,286.3333333333333
9328,2012-01-29,1,1,1,14,51,229,280,294.6666666666667
9329,2012-01-29,1,1,1,15,68,242,310,302.0
9330,2012-01-29,1,1,1,16,54,268,322,304.0
9331,2012-01-29,1,1,1,17,33,201,234,288.6666666666667
9332,2012-01-29,1,1,1,18,17,151,168,241.33333333333334
9333,2012-01-29,1,1,1,19,14,145,159,187.0
9334,2012-01-29,1,1,1,20,13,98,111,146.0
9335,2012-01-29,1,1,1,21,0,69,69,113.0
9336,2012-01-29,1,1,1,22,7,57,64,81.33333333333333
9337,2012-01-29,1,1,1,23,4,21,25,52.666666666666664
9338,2012-01-30,1,1,1,0,0,10,10,33.0
9339,2012-01-30,1,1,1,1,0,9,9,14.666666666666666
9340,2012-01-30,1,1,1,2,1,6,7,8.666666666666666
9341,2012-01-30,1,1,1,3,0,4,4,6.666666666666667
9342,2012-01-30,1,1,1,4,0,5,5,5.333333333333333
9343,2012-01-30,1,1,1,5,0,26,26,11.666666666666666
9344,2012-01-30,1,1,1,6,0,80,80,37.0
9345,2012-01-30,1,1,1,7,4,221,225,110.33333333333333
9346,2012-01-30,1,1,1,8,12,481,493,266.0
9347,2012-01-30,1,1,1,9,5,193,198,305.3333333333333
9348,2012-01-30,1,1,1,10,3,82,85,258.6666666666667
9349,2012-01-30,1,1,1,11,6,93,99,127.33333333333333
9350,2012-01-30,1,1,1,12,5,129,134,106.0
9351,2012-01-30,1,1,1,13,15,117,132,121.66666666666667
9352,2012-01-30,1,1,1,14,15,100,115,127.0
9353,2012-01-30,1,1,1,15,7,131,138,128.33333333333334
9354,2012-01-30,1,1,1,16,11,210,221,158.0
9355,2012-01-30,1,1,1,17,16,422,438,265.6666666666667
9356,2012-01-30,1,1,1,18,11,399,410,356.3333333333333
9357,2012-01-30,1,1,1,19,8,298,306,384.6666666666667
9358,2012-01-30,1,1,1,20,2,179,181,299.0
9359,2012-01-30,1,1,1,21,3,159,162,216.33333333333334
9360,2012-01-30,1,1,1,22,2,92,94,145.66666666666666
9361,2012-01-30,1,1,1,23,0,52,52,102.66666666666667
9362,2012-01-31,1,1,1,0,0,15,15,53.666666666666664
9363,2012-01-31,1,1,1,1,1,7,8,25.0
9364,2012-01-31,1,1,1,2,0,2,2,8.333333333333334
9365,2012-01-31,1,1,1,3,0,2,2,4.0
9366,2012-01-31,1,1,1,4,0,1,1,1.6666666666666667
9367,2012-01-31,1,1,1,5,0,22,22,8.333333333333334
9368,2012-01-31,1,1,1,6,0,104,104,42.333333333333336
9369,2012-01-31,1,1,1,7,6,273,279,135.0
9370,2012-01-31,1,1,1,8,14,498,512,298.3333333333333
9371,2012-01-31,1,1,1,9,30,231,261,350.6666666666667
9372,2012-01-31,1,1,1,10,34,110,144,305.6666666666667
9373,2012-01-31,1,1,1,11,14,125,139,181.33333333333334
9374,2012-01-31,1,1,1,12,13,181,194,159.0
9375,2012-01-31,1,1,1,13,27,171,198,177.0
9376,2012-01-31,1,1,1,14,18,142,160,184.0
9377,2012-01-31,1,1,1,15,27,150,177,178.33333333333334
9378,2012-01-31,1,1,1,16,30,277,307,214.66666666666666
9379,2012-01-31,1,1,1,17,41,518,559,347.6666666666667
9380,2012-01-31,1,1,1,18,16,486,502,456.0
9381,2012-01-31,1,1,1,19,22,306,328,463.0
9382,2012-01-31,1,1,1,20,15,223,238,356.0
9383,2012-01-31,1,1,1,21,3,162,165,243.66666666666666
9384,2012-01-31,1,1,1,22,11,118,129,177.33333333333334
9385,2012-01-31,1,1,1,23,2,61,63,119.0
9386,2012-02-01,1,1,2,0,0,31,31,74.33333333333333
9387,2012-02-01,1,1,2,1,0,4,4,32.666666666666664
9388,2012-02-01,1,1,2,2,1,6,7,14.0
9389,2012-02-01,1,1,2,3,0,3,3,4.666666666666667
9390,2012-02-01,1,1,2,4,0,1,1,3.6666666666666665
9391,2012-02-01,1,1,2,5,0,18,18,7.333333333333333
9392,2012-02-01,1,1,2,6,0,67,67,28.666666666666668
9393,2012-02-01,1,1,2,7,7,201,208,97.66666666666667
9394,2012-02-01,1,1,2,8,15,505,520,265.0
9395,2012-02-01,1,1,2,9,9,267,276,334.6666666666667
9396,2012-02-01,1,1,2,10,9,124,133,309.6666666666667
9397,2012-02-01,1,1,2,11,27,116,143,184.0
9398,2012-02-01,1,1,2,12,26,153,179,151.66666666666666
9399,2012-02-01,1,1,2,13,12,174,186,169.33333333333334
9400,2012-02-01,1,1,2,14,33,159,192,185.66666666666666
9401,2012-02-01,1,1,2,15,25,169,194,190.66666666666666
9402,2012-02-01,1,1,2,16,22,261,283,223.0
9403,2012-02-01,1,1,2,17,31,508,539,338.6666666666667
9404,2012-02-01,1,1,2,18,12,514,526,449.3333333333333
9405,2012-02-01,1,1,2,19,20,315,335,466.6666666666667
9406,2012-02-01,1,1,2,20,10,254,264,375.0
9407,2012-02-01,1,1,2,21,16,217,233,277.3333333333333
9408,2012-02-01,1,1,2,22,7,133,140,212.33333333333334
9409,2012-02-01,1,1,2,23,22,75,97,156.66666666666666
9410,2012-02-02,1,1,2,0,7,24,31,89.33333333333333
9411,2012-02-02,1,1,2,1,3,14,17,48.333333333333336
9412,2012-02-02,1,1,2,2,2,7,9,19.0
9413,2012-02-02,1,1,2,3,0,2,2,9.333333333333334
9414,2012-02-02,1,1,2,4,0,1,1,4.0
9415,2012-02-02,1,1,2,5,0,19,19,7.333333333333333
9416,2012-02-02,1,1,2,6,1,73,74,31.333333333333332
9417,2012-02-02,1,1,2,7,4,201,205,99.33333333333333
9418,2012-02-02,1,1,2,8,9,436,445,241.33333333333334
9419,2012-02-02,1,1,2,9,15,213,228,292.6666666666667
9420,2012-02-02,1,1,2,10,6,72,78,250.33333333333334
9421,2012-02-02,1,1,2,11,6,99,105,137.0
9422,2012-02-02,1,1,2,12,8,140,148,110.33333333333333
9423,2012-02-02,1,1,2,13,13,124,137,130.0
9424,2012-02-02,1,1,2,14,12,129,141,142.0
9425,2012-02-02,1,1,2,15,24,150,174,150.66666666666666
9426,2012-02-02,1,1,2,16,18,211,229,181.33333333333334
9427,2012-02-02,1,1,2,17,13,437,450,284.3333333333333
9428,2012-02-02,1,1,2,18,17,393,410,363.0
9429,2012-02-02,1,1,2,19,16,311,327,395.6666666666667
9430,2012-02-02,1,1,2,20,9,204,213,316.6666666666667
9431,2012-02-02,1,1,2,21,4,144,148,229.33333333333334
9432,2012-02-02,1,1,2,22,3,106,109,156.66666666666666
9433,2012-02-02,1,1,2,23,0,61,61,106.0
9434,2012-02-03,1,1,2,0,1,37,38,69.33333333333333
9435,2012-02-03,1,1,2,1,3,19,22,40.333333333333336
9436,2012-02-03,1,1,2,2,0,6,6,22.0
9437,2012-02-03,1,1,2,3,0,4,4,10.666666666666666
9438,2012-02-03,1,1,2,4,0,2,2,4.0
9439,2012-02-03,1,1,2,5,0,17,17,7.666666666666667
9440,2012-02-03,1,1,2,6,0,88,88,35.666666666666664
9441,2012-02-03,1,1,2,7,10,216,226,110.33333333333333
9442,2012-02-03,1,1,2,8,12,429,441,251.66666666666666
9443,2012-02-03,1,1,2,9,18,252,270,312.3333333333333
9444,2012-02-03,1,1,2,10,15,114,129,280.0
9445,2012-02-03,1,1,2,11,15,149,164,187.66666666666666
9446,2012-02-03,1,1,2,12,25,191,216,169.66666666666666
9447,2012-02-03,1,1,2,13,25,173,198,192.66666666666666
9448,2012-02-03,1,1,2,14,22,148,170,194.66666666666666
9449,2012-02-03,1,1,2,15,48,168,216,194.66666666666666
9450,2012-02-03,1,1,2,16,36,275,311,232.33333333333334
9451,2012-02-03,1,1,2,17,30,458,488,338.3333333333333
9452,2012-02-03,1,1,2,18,17,368,385,394.6666666666667
9453,2012-02-03,1,1,2,19,11,256,267,380.0
9454,2012-02-03,1,1,2,20,8,155,163,271.6666666666667
9455,2012-02-03,1,1,2,21,8,126,134,188.0
9456,2012-02-03,1,1,2,22,3,116,119,138.66666666666666
9457,2012-02-03,1,1,2,23,3,74,77,110.0
9458,2012-02-04,1,1,2,0,10,76,86,94.0
9459,2012-02-04,1,1,2,1,0,43,43,68.66666666666667
9460,2012-02-04,1,1,2,2,6,38,44,57.666666666666664
9461,2012-02-04,1,1,2,3,1,17,18,35.0
9462,2012-02-04,1,1,2,4,1,5,6,22.666666666666668
9463,2012-02-04,1,1,2,5,1,3,4,9.333333333333334
9464,2012-02-04,1,1,2,6,1,4,5,5.0
9465,2012-02-04,1,1,2,7,1,27,28,12.333333333333334
9466,2012-02-04,1,1,2,8,4,86,90,41.0
9467,2012-02-04,1,1,2,9,16,141,157,91.66666666666667
9468,2012-02-04,1,1,2,10,31,193,224,157.0
9469,2012-02-04,1,1,2,11,46,224,270,217.0
9470,2012-02-04,1,1,2,12,40,260,300,264.6666666666667
9471,2012-02-04,1,1,2,13,58,244,302,290.6666666666667
9472,2012-02-04,1,1,2,14,47,229,276,292.6666666666667
9473,2012-02-04,1,1,2,15,61,244,305,294.3333333333333
9474,2012-02-04,1,1,2,16,20,123,143,241.33333333333334
9475,2012-02-04,1,1,2,17,13,54,67,171.66666666666666
9476,2012-02-04,1,1,2,18,6,58,64,91.33333333333333
9477,2012-02-04,1,1,2,19,5,75,80,70.33333333333333
9478,2012-02-04,1,1,2,20,4,73,77,73.66666666666667
9479,2012-02-04,1,1,2,21,4,74,78,78.33333333333333
9480,2012-02-04,1,1,2,22,4,91,95,83.33333333333333
9481,2012-02-04,1,1,2,23,4,66,70,81.0
9482,2012-02-05,1,1,2,0,3,58,61,75.33333333333333
9483,2012-02-05,1,1,2,1,5,46,51,60.666666666666664
9484,2012-02-05,1,1,2,2,4,59,63,58.333333333333336
9485,2012-02-05,1,1,2,3,4,13,17,43.666666666666664
9486,2012-02-05,1,1,2,4,0,9,9,29.666666666666668
9487,2012-02-05,1,1,2,5,0,4,4,10.0
9488,2012-02-05,1,1,2,6,0,4,4,5.666666666666667
9489,2012-02-05,1,1,2,7,0,16,16,8.0
9490,2012-02-05,1,1,2,8,4,58,62,27.333333333333332
9491,2012-02-05,1,1,2,9,9,83,92,56.666666666666664
9492,2012-02-05,1,1,2,10,10,138,148,100.66666666666667
9493,2012-02-05,1,1,2,11,22,160,182,140.66666666666666
9494,2012-02-05,1,1,2,12,25,223,248,192.66666666666666
9495,2012-02-05,1,1,2,13,33,241,274,234.66666666666666
9496,2012-02-05,1,1,2,14,40,203,243,255.0
9497,2012-02-05,1,1,2,15,55,217,272,263.0
9498,2012-02-05,1,1,2,16,35,261,296,270.3333333333333
9499,2012-02-05,1,1,2,17,31,275,306,291.3333333333333
9500,2012-02-05,1,1,2,18,10,171,181,261.0
9501,2012-02-05,1,1,2,19,6,63,69,185.33333333333334
9502,2012-02-05,1,1,2,20,3,47,50,100.0
9503,2012-02-05,1,1,2,21,6,60,66,61.666666666666664
9504,2012-02-05,1,1,2,22,9,182,191,102.33333333333333
9505,2012-02-05,1,1,2,23,4,38,42,99.66666666666667
9506,2012-02-06,1,1,2,0,7,14,21,84.66666666666667
9507,2012-02-06,1,1,2,1,0,6,6,23.0
9508,2012-02-06,1,1,2,2,0,3,3,10.0
9509,2012-02-06,1,1,2,4,0,2,2,3.6666666666666665
9510,2012-02-06,1,1,2,5,0,17,17,7.333333333333333
9511,2012-02-06,1,1,2,6,0,72,72,30.333333333333332
9512,2012-02-06,1,1,2,7,5,229,234,107.66666666666667
9513,2012-02-06,1,1,2,8,10,434,444,250.0
9514,2012-02-06,1,1,2,9,8,269,277,318.3333333333333
9515,2012-02-06,1,1,2,10,20,96,116,279.0
9516,2012-02-06,1,1,2,11,12,104,116,169.66666666666666
9517,2012-02-06,1,1,2,12,19,131,150,127.33333333333333
9518,2012-02-06,1,1,2,13,17,124,141,135.66666666666666
9519,2012-02-06,1,1,2,14,14,126,140,143.66666666666666
9520,2012-02-06,1,1,2,15,25,146,171,150.66666666666666
9521,2012-02-06,1,1,2,16,13,215,228,179.66666666666666
9522,2012-02-06,1,1,2,17,13,417,430,276.3333333333333
9523,2012-02-06,1,1,2,18,11,426,437,365.0
9524,2012-02-06,1,1,2,19,7,284,291,386.0
9525,2012-02-06,1,1,2,20,7,194,201,309.6666666666667
9526,2012-02-06,1,1,2,21,11,143,154,215.33333333333334
9527,2012-02-06,1,1,2,22,4,83,87,147.33333333333334
9528,2012-02-06,1,1,2,23,3,43,46,95.66666666666667
9529,2012-02-07,1,1,2,0,1,22,23,52.0
9530,2012-02-07,1,1,2,1,8,6,14,27.666666666666668
9531,2012-02-07,1,1,2,2,0,4,4,13.666666666666666
9532,2012-02-07,1,1,2,3,1,1,2,6.666666666666667
9533,2012-02-07,1,1,2,4,0,3,3,3.0
9534,2012-02-07,1,1,2,5,0,15,15,6.666666666666667
9535,2012-02-07,1,1,2,6,2,98,100,39.333333333333336
9536,2012-02-07,1,1,2,7,6,293,299,138.0
9537,2012-02-07,1,1,2,8,7,522,529,309.3333333333333
9538,2012-02-07,1,1,2,9,11,278,289,372.3333333333333
9539,2012-02-07,1,1,2,10,12,104,116,311.3333333333333
9540,2012-02-07,1,1,2,11,9,120,129,178.0
9541,2012-02-07,1,1,2,12,9,163,172,139.0
9542,2012-02-07,1,1,2,13,15,169,184,161.66666666666666
9543,2012-02-07,1,1,2,14,11,127,138,164.66666666666666
9544,2012-02-07,1,1,2,15,13,133,146,156.0
9545,2012-02-07,1,1,2,16,19,257,276,186.66666666666666
9546,2012-02-07,1,1,2,17,15,494,509,310.3333333333333
9547,2012-02-07,1,1,2,18,10,508,518,434.3333333333333
9548,2012-02-07,1,1,2,19,11,327,338,455.0
9549,2012-02-07,1,1,2,20,6,206,212,356.0
9550,2012-02-07,1,1,2,21,20,170,190,246.66666666666666
9551,2012-02-07,1,1,2,22,11,107,118,173.33333333333334
9552,2012-02-07,1,1,2,23,2,49,51,119.66666666666667
9553,2012-02-08,1,1,2,0,2,21,23,64.0
9554,2012-02-08,1,1,2,1,1,9,10,28.0
9555,2012-02-08,1,1,2,2,0,1,1,11.333333333333334
9556,2012-02-08,1,1,2,3,0,1,1,4.0
9557,2012-02-08,1,1,2,4,0,1,1,1.0
9558,2012-02-08,1,1,2,5,0,20,20,7.333333333333333
9559,2012-02-08,1,1,2,6,3,95,98,39.666666666666664
9560,2012-02-08,1,1,2,7,5,276,281,133.0
9561,2012-02-08,1,1,2,8,13,495,508,295.6666666666667
9562,2012-02-08,1,1,2,9,8,245,253,347.3333333333333
9563,2012-02-08,1,1,2,10,1,107,108,289.6666666666667
9564,2012-02-08,1,1,2,11,5,97,102,154.33333333333334
9565,2012-02-08,1,1,2,12,14,124,138,116.0
9566,2012-02-08,1,1,2,13,15,111,126,122.0
9567,2012-02-08,1,1,2,14,8,100,108,124.0
9568,2012-02-08,1,1,2,15,5,49,54,96.0
9569,2012-02-08,1,1,2,16,2,73,75,79.0
9570,2012-02-08,1,1,2,17,8,147,155,94.66666666666667
9571,2012-02-08,1,1,2,18,4,163,167,132.33333333333334
9572,2012-02-08,1,1,2,19,3,158,161,161.0
9573,2012-02-08,1,1,2,20,3,122,125,151.0
9574,2012-02-08,1,1,2,21,3,126,129,138.33333333333334
9575,2012-02-08,1,1,2,22,3,95,98,117.33333333333333
9576,2012-02-08,1,1,2,23,3,57,60,95.66666666666667
9577,2012-02-09,1,1,2,0,3,23,26,61.333333333333336
9578,2012-02-09,1,1,2,1,2,10,12,32.666666666666664
9579,2012-02-09,1,1,2,2,0,2,2,13.333333333333334
9580,2012-02-09,1,1,2,3,0,4,4,6.0
9581,2012-02-09,1,1,2,4,0,1,1,2.3333333333333335
9582,2012-02-09,1,1,2,5,0,18,18,7.666666666666667
9583,2012-02-09,1,1,2,6,1,75,76,31.666666666666668
9584,2012-02-09,1,1,2,7,4,263,267,120.33333333333333
9585,2012-02-09,1,1,2,8,11,473,484,275.6666666666667
9586,2012-02-09,1,1,2,9,9,229,238,329.6666666666667
9587,2012-02-09,1,1,2,10,7,90,97,273.0
9588,2012-02-09,1,1,2,11,4,95,99,144.66666666666666
9589,2012-02-09,1,1,2,12,10,148,158,118.0
9590,2012-02-09,1,1,2,13,10,144,154,137.0
9591,2012-02-09,1,1,2,14,18,126,144,152.0
9592,2012-02-09,1,1,2,15,14,120,134,144.0
9593,2012-02-09,1,1,2,16,15,223,238,172.0
9594,2012-02-09,1,1,2,17,12,387,399,257.0
9595,2012-02-09,1,1,2,18,13,404,417,351.3333333333333
9596,2012-02-09,1,1,2,19,8,287,295,370.3333333333333
9597,2012-02-09,1,1,2,20,2,197,199,303.6666666666667
9598,2012-02-09,1,1,2,21,8,169,177,223.66666666666666
9599,2012-02-09,1,1,2,22,3,104,107,161.0
9600,2012-02-09,1,1,2,23,9,75,84,122.66666666666667
9601,2012-02-10,1,1,2,0,4,39,43,78.0
9602,2012-02-10,1,1,2,1,2,11,13,46.666666666666664
9603,2012-02-10,1,1,2,2,7,9,16,24.0
9604,2012-02-10,1,1,2,3,0,5,5,11.333333333333334
9605,2012-02-10,1,1,2,4,0,2,2,7.666666666666667
9606,2012-02-10,1,1,2,5,0,17,17,8.0
9607,2012-02-10,1,1,2,6,3,61,64,27.666666666666668
9608,2012-02-10,1,1,2,7,5,225,230,103.66666666666667
9609,2012-02-10,1,1,2,8,1,447,448,247.33333333333334
9610,2012-02-10,1,1,2,9,10,265,275,317.6666666666667
9611,2012-02-10,1,1,2,10,5,119,124,282.3333333333333
9612,2012-02-10,1,1,2,11,19,134,153,184.0
9613,2012-02-10,1,1,2,12,8,168,176,151.0
9614,2012-02-10,1,1,2,13,22,170,192,173.66666666666666
9615,2012-02-10,1,1,2,14,8,138,146,171.33333333333334
9616,2012-02-10,1,1,2,15,27,164,191,176.33333333333334
9617,2012-02-10,1,1,2,16,28,240,268,201.66666666666666
9618,2012-02-10,1,1,2,17,15,381,396,285.0
9619,2012-02-10,1,1,2,18,14,345,359,341.0
9620,2012-02-10,1,1,2,19,16,246,262,339.0
9621,2012-02-10,1,1,2,20,7,144,151,257.3333333333333
9622,2012-02-10,1,1,2,21,14,108,122,178.33333333333334
9623,2012-02-10,1,1,2,22,11,102,113,128.66666666666666
9624,2012-02-10,1,1,2,23,1,64,65,100.0
9625,2012-02-11,1,1,2,0,3,50,53,77.0
9626,2012-02-11,1,1,2,1,2,43,45,54.333333333333336
9627,2012-02-11,1,1,2,2,2,24,26,41.333333333333336
9628,2012-02-11,1,1,2,3,0,9,9,26.666666666666668
9629,2012-02-11,1,1,2,4,0,4,4,13.0
9630,2012-02-11,1,1,2,5,0,2,2,5.0
9631,2012-02-11,1,1,2,6,1,8,9,5.0
9632,2012-02-11,1,1,2,7,0,19,19,10.0
9633,2012-02-11,1,1,2,8,1,77,78,35.333333333333336
9634,2012-02-11,1,1,2,9,5,85,90,62.333333333333336
9635,2012-02-11,1,1,2,10,23,143,166,111.33333333333333
9636,2012-02-11,1,1,2,11,26,157,183,146.33333333333334
9637,2012-02-11,1,1,2,12,25,196,221,190.0
9638,2012-02-11,1,1,2,13,18,217,235,213.0
9639,2012-02-11,1,1,2,14,38,205,243,233.0
9640,2012-02-11,1,1,2,15,12,112,124,200.66666666666666
9641,2012-02-11,1,1,2,16,12,134,146,171.0
9642,2012-02-11,1,1,2,17,13,131,144,138.0
9643,2012-02-11,1,1,2,18,3,105,108,132.66666666666666
9644,2012-02-11,1,1,2,19,2,85,87,113.0
9645,2012-02-11,1,1,2,20,1,62,63,86.0
9646,2012-02-11,1,1,2,21,5,43,48,66.0
9647,2012-02-11,1,1,2,22,0,46,46,52.333333333333336
9648,2012-02-11,1,1,2,23,0,20,20,38.0
9649,2012-02-12,1,1,2,0,0,21,21,29.0
9650,2012-02-12,1,1,2,1,0,24,24,21.666666666666668
9651,2012-02-12,1,1,2,2,1,26,27,24.0
9652,2012-02-12,1,1,2,3,0,14,14,21.666666666666668
9653,2012-02-12,1,1,2,4,0,1,1,14.0
9654,2012-02-12,1,1,2,5,0,3,3,6.0
9655,2012-02-12,1,1,2,6,0,2,2,2.0
9656,2012-02-12,1,1,2,7,0,18,18,7.666666666666667
9657,2012-02-12,1,1,2,8,0,26,26,15.333333333333334
9658,2012-02-12,1,1,2,9,3,60,63,35.666666666666664
9659,2012-02-12,1,1,2,10,8,83,91,60.0
9660,2012-02-12,1,1,2,11,3,121,124,92.66666666666667
9661,2012-02-12,1,1,2,12,7,133,140,118.33333333333333
9662,2012-02-12,1,1,2,13,10,128,138,134.0
9663,2012-02-12,1,1,2,14,9,102,111,129.66666666666666
9664,2012-02-12,1,1,2,15,5,150,155,134.66666666666666
9665,2012-02-12,1,1,2,16,16,148,164,143.33333333333334
9666,2012-02-12,1,1,2,17,4,83,87,135.33333333333334
9667,2012-02-12,1,1,2,18,4,92,96,115.66666666666667
9668,2012-02-12,1,1,2,19,2,78,80,87.66666666666667
9669,2012-02-12,1,1,2,20,1,56,57,77.66666666666667
9670,2012-02-12,1,1,2,21,0,36,36,57.666666666666664
9671,2012-02-12,1,1,2,22,0,28,28,40.333333333333336
9672,2012-02-12,1,1,2,23,0,23,23,29.0
9673,2012-02-13,1,1,2,0,0,9,9,20.0
9674,2012-02-13,1,1,2,1,0,6,6,12.666666666666666
9675,2012-02-13,1,1,2,2,0,4,4,6.333333333333333
9676,2012-02-13,1,1,2,3,0,1,1,3.6666666666666665
9677,2012-02-13,1,1,2,4,0,2,2,2.3333333333333335
9678,2012-02-13,1,1,2,5,0,17,17,6.666666666666667
9679,2012-02-13,1,1,2,6,1,71,72,30.333333333333332
9680,2012-02-13,1,1,2,7,1,194,195,94.66666666666667
9681,2012-02-13,1,1,2,8,4,413,417,228.0
9682,2012-02-13,1,1,2,9,7,198,205,272.3333333333333
9683,2012-02-13,1,1,2,10,1,70,71,231.0
9684,2012-02-13,1,1,2,11,5,85,90,122.0
9685,2012-02-13,1,1,2,12,7,111,118,93.0
9686,2012-02-13,1,1,2,13,11,129,140,116.0
9687,2012-02-13,1,1,2,14,10,125,135,131.0
9688,2012-02-13,1,1,2,15,10,145,155,143.33333333333334
9689,2012-02-13,1,1,2,16,5,206,211,167.0
9690,2012-02-13,1,1,2,17,8,399,407,257.6666666666667
9691,2012-02-13,1,1,2,18,6,399,405,341.0
9692,2012-02-13,1,1,2,19,7,256,263,358.3333333333333
9693,2012-02-13,1,1,2,20,4,210,214,294.0
9694,2012-02-13,1,1,2,21,2,145,147,208.0
9695,2012-02-13,1,1,2,22,3,99,102,154.33333333333334
9696,2012-02-13,1,1,2,23,2,34,36,95.0
9697,2012-02-14,1,1,2,0,0,14,14,50.666666666666664
9698,2012-02-14,1,1,2,1,0,6,6,18.666666666666668
9699,2012-02-14,1,1,2,2,0,3,3,7.666666666666667
9700,2012-02-14,1,1,2,3,0,3,3,4.0
9701,2012-02-14,1,1,2,4,0,2,2,2.6666666666666665
9702,2012-02-14,1,1,2,5,2,20,22,9.0
9703,2012-02-14,1,1,2,6,1,89,90,38.0
9704,2012-02-14,1,1,2,7,4,276,280,130.66666666666666
9705,2012-02-14,1,1,2,8,3,510,513,294.3333333333333
9706,2012-02-14,1,1,2,9,6,256,262,351.6666666666667
9707,2012-02-14,1,1,2,10,8,90,98,291.0
9708,2012-02-14,1,1,2,11,5,107,112,157.33333333333334
9709,2012-02-14,1,1,2,12,10,162,172,127.33333333333333
9710,2012-02-14,1,1,2,13,6,167,173,152.33333333333334
9711,2012-02-14,1,1,2,14,13,111,124,156.33333333333334
9712,2012-02-14,1,1,2,15,7,138,145,147.33333333333334
9713,2012-02-14,1,1,2,16,15,251,266,178.33333333333334
9714,2012-02-14,1,1,2,17,19,504,523,311.3333333333333
9715,2012-02-14,1,1,2,18,8,398,406,398.3333333333333
9716,2012-02-14,1,1,2,19,11,270,281,403.3333333333333
9717,2012-02-14,1,1,2,20,6,178,184,290.3333333333333
9718,2012-02-14,1,1,2,21,4,105,109,191.33333333333334
9719,2012-02-14,1,1,2,22,5,72,77,123.33333333333333
9720,2012-02-14,1,1,2,23,2,55,57,81.0
9721,2012-02-15,1,1,2,0,0,22,22,52.0
9722,2012-02-15,1,1,2,1,0,5,5,28.0
9723,2012-02-15,1,1,2,2,0,4,4,10.333333333333334
9724,2012-02-15,1,1,2,3,0,3,3,4.0
9725,2012-02-15,1,1,2,4,0,1,1,2.6666666666666665
9726,2012-02-15,1,1,2,5,0,25,25,9.666666666666666
9727,2012-02-15,1,1,2,6,3,92,95,40.333333333333336
9728,2012-02-15,1,1,2,7,3,318,321,147.0
9729,2012-02-15,1,1,2,8,7,508,515,310.3333333333333
9730,2012-02-15,1,1,2,9,5,226,231,355.6666666666667
9731,2012-02-15,1,1,2,10,12,108,120,288.6666666666667
9732,2012-02-15,1,1,2,11,13,125,138,163.0
9733,2012-02-15,1,1,2,12,11,152,163,140.33333333333334
9734,2012-02-15,1,1,2,13,11,159,170,157.0
9735,2012-02-15,1,1,2,14,6,128,134,155.66666666666666
9736,2012-02-15,1,1,2,15,7,164,171,158.33333333333334
9737,2012-02-15,1,1,2,16,9,222,231,178.66666666666666
9738,2012-02-15,1,1,2,17,17,470,487,296.3333333333333
9739,2012-02-15,1,1,2,18,9,459,468,395.3333333333333
9740,2012-02-15,1,1,2,19,9,302,311,422.0
9741,2012-02-15,1,1,2,20,4,207,211,330.0
9742,2012-02-15,1,1,2,21,8,170,178,233.33333333333334
9743,2012-02-15,1,1,2,22,3,104,107,165.33333333333334
9744,2012-02-15,1,1,2,23,4,54,58,114.33333333333333
9745,2012-02-16,1,1,2,0,1,22,23,62.666666666666664
9746,2012-02-16,1,1,2,1,0,5,5,28.666666666666668
9747,2012-02-16,1,1,2,2,1,6,7,11.666666666666666
9748,2012-02-16,1,1,2,3,0,1,1,4.333333333333333
9749,2012-02-16,1,1,2,4,0,3,3,3.6666666666666665
9750,2012-02-16,1,1,2,5,0,20,20,8.0
9751,2012-02-16,1,1,2,6,4,83,87,36.666666666666664
9752,2012-02-16,1,1,2,7,3,285,288,131.66666666666666
9753,2012-02-16,1,1,2,8,9,489,498,291.0
9754,2012-02-16,1,1,2,9,3,199,202,329.3333333333333
9755,2012-02-16,1,1,2,10,2,42,44,248.0
9756,2012-02-16,1,1,2,11,2,69,71,105.66666666666667
9757,2012-02-16,1,1,2,12,1,44,45,53.333333333333336
9758,2012-02-16,1,1,2,13,2,62,64,60.0
9759,2012-02-16,1,1,2,14,1,30,31,46.666666666666664
9760,2012-02-16,1,1,2,15,3,50,53,49.333333333333336
9761,2012-02-16,1,1,2,16,8,110,118,67.33333333333333
9762,2012-02-16,1,1,2,17,8,281,289,153.33333333333334
9763,2012-02-16,1,1,2,18,8,345,353,253.33333333333334
9764,2012-02-16,1,1,2,19,4,254,258,300.0
9765,2012-02-16,1,1,2,20,5,211,216,275.6666666666667
9766,2012-02-16,1,1,2,21,3,142,145,206.33333333333334
9767,2012-02-16,1,1,2,22,3,108,111,157.33333333333334
9768,2012-02-16,1,1,2,23,3,70,73,109.66666666666667
9769,2012-02-17,1,1,2,0,2,32,34,72.66666666666667
9770,2012-02-17,1,1,2,1,2,16,18,41.666666666666664
9771,2012-02-17,1,1,2,2,1,11,12,21.333333333333332
9772,2012-02-17,1,1,2,3,0,1,1,10.333333333333334
9773,2012-02-17,1,1,2,4,0,1,1,4.666666666666667
9774,2012-02-17,1,1,2,5,0,16,16,6.0
9775,2012-02-17,1,1,2,6,1,70,71,29.333333333333332
9776,2012-02-17,1,1,2,7,4,222,226,104.33333333333333
9777,2012-02-17,1,1,2,8,4,516,520,272.3333333333333
9778,2012-02-17,1,1,2,9,8,275,283,343.0
9779,2012-02-17,1,1,2,10,13,103,116,306.3333333333333
9780,2012-02-17,1,1,2,11,9,133,142,180.33333333333334
9781,2012-02-17,1,1,2,12,21,177,198,152.0
9782,2012-02-17,1,1,2,13,34,171,205,181.66666666666666
9783,2012-02-17,1,1,2,14,33,137,170,191.0
9784,2012-02-17,1,1,2,15,41,180,221,198.66666666666666
9785,2012-02-17,1,1,2,16,56,251,307,232.66666666666666
9786,2012-02-17,1,1,2,17,36,429,465,331.0
9787,2012-02-17,1,1,2,18,15,362,377,383.0
9788,2012-02-17,1,1,2,19,16,266,282,374.6666666666667
9789,2012-02-17,1,1,2,20,13,158,171,276.6666666666667
9790,2012-02-17,1,1,2,21,15,114,129,194.0
9791,2012-02-17,1,1,2,22,15,92,107,135.66666666666666
9792,2012-02-17,1,1,2,23,10,72,82,106.0
9793,2012-02-18,1,1,2,0,5,81,86,91.66666666666667
9794,2012-02-18,1,1,2,1,7,38,45,71.0
9795,2012-02-18,1,1,2,2,6,39,45,58.666666666666664
9796,2012-02-18,1,1,2,3,3,15,18,36.0
9797,2012-02-18,1,1,2,4,3,4,7,23.333333333333332
9798,2012-02-18,1,1,2,5,0,1,1,8.666666666666666
9799,2012-02-18,1,1,2,6,1,8,9,5.666666666666667
9800,2012-02-18,1,1,2,7,8,33,41,17.0
9801,2012-02-18,1,1,2,8,10,92,102,50.666666666666664
9802,2012-02-18,1,1,2,9,22,116,138,93.66666666666667
9803,2012-02-18,1,1,2,10,48,157,205,148.33333333333334
9804,2012-02-18,1,1,2,11,102,184,286,209.66666666666666
9805,2012-02-18,1,1,2,12,128,241,369,286.6666666666667
9806,2012-02-18,1,1,2,13,165,219,384,346.3333333333333
9807,2012-02-18,1,1,2,14,183,244,427,393.3333333333333
9808,2012-02-18,1,1,2,15,229,270,499,436.6666666666667
9809,2012-02-18,1,1,2,16,186,218,404,443.3333333333333
9810,2012-02-18,1,1,2,17,142,222,364,422.3333333333333
9811,2012-02-18,1,1,2,18,70,176,246,338.0
9812,2012-02-18,1,1,2,19,38,150,188,266.0
9813,2012-02-18,1,1,2,20,25,123,148,194.0
9814,2012-02-18,1,1,2,21,25,89,114,150.0
9815,2012-02-18,1,1,2,22,17,101,118,126.66666666666667
9816,2012-02-18,1,1,2,23,12,62,74,102.0
9817,2012-02-19,1,1,2,0,9,65,74,88.66666666666667
9818,2012-02-19,1,1,2,1,10,62,72,73.33333333333333
9819,2012-02-19,1,1,2,2,3,45,48,64.66666666666667
9820,2012-02-19,1,1,2,3,3,12,15,45.0
9821,2012-02-19,1,1,2,4,0,3,3,22.0
9822,2012-02-19,1,1,2,5,1,1,2,6.666666666666667
9823,2012-02-19,1,1,2,6,0,5,5,3.3333333333333335
9824,2012-02-19,1,1,2,7,2,12,14,7.0
9825,2012-02-19,1,1,2,8,8,48,56,25.0
9826,2012-02-19,1,1,2,9,20,73,93,54.333333333333336
9827,2012-02-19,1,1,2,10,49,142,191,113.33333333333333
9828,2012-02-19,1,1,2,11,82,144,226,170.0
9829,2012-02-19,1,1,2,12,71,184,255,224.0
9830,2012-02-19,1,1,2,13,64,197,261,247.33333333333334
9831,2012-02-19,1,1,2,14,48,189,237,251.0
9832,2012-02-19,1,1,2,15,85,168,253,250.33333333333334
9833,2012-02-19,1,1,2,16,62,150,212,234.0
9834,2012-02-19,1,1,2,17,22,135,157,207.33333333333334
9835,2012-02-19,1,1,2,18,23,144,167,178.66666666666666
9836,2012-02-19,1,1,2,19,18,101,119,147.66666666666666
9837,2012-02-19,1,1,2,20,22,81,103,129.66666666666666
9838,2012-02-19,1,1,2,21,3,33,36,86.0
9839,2012-02-19,1,1,2,22,8,47,55,64.66666666666667
9840,2012-02-19,1,1,2,23,5,30,35,42.0
9841,2012-02-20,1,1,2,0,5,36,41,43.666666666666664
9842,2012-02-20,1,1,2,1,3,12,15,30.333333333333332
9843,2012-02-20,1,1,2,2,1,19,20,25.333333333333332
9844,2012-02-20,1,1,2,3,0,8,8,14.333333333333334
9845,2012-02-20,1,1,2,5,0,6,6,11.333333333333334
9846,2012-02-20,1,1,2,6,1,9,10,8.0
9847,2012-02-20,1,1,2,7,2,42,44,20.0
9848,2012-02-20,1,1,2,8,9,111,120,58.0
9849,2012-02-20,1,1,2,9,12,98,110,91.33333333333333
9850,2012-02-20,1,1,2,10,30,113,143,124.33333333333333
9851,2012-02-20,1,1,2,11,45,163,208,153.66666666666666
9852,2012-02-20,1,1,2,12,65,216,281,210.66666666666666
9853,2012-02-20,1,1,2,13,66,246,312,267.0
9854,2012-02-20,1,1,2,14,57,206,263,285.3333333333333
9855,2012-02-20,1,1,2,15,54,235,289,288.0
9856,2012-02-20,1,1,2,16,64,216,280,277.3333333333333
9857,2012-02-20,1,1,2,17,27,226,253,274.0
9858,2012-02-20,1,1,2,18,27,215,242,258.3333333333333
9859,2012-02-20,1,1,2,19,8,164,172,222.33333333333334
9860,2012-02-20,1,1,2,20,9,117,126,180.0
9861,2012-02-20,1,1,2,21,8,90,98,132.0
9862,2012-02-20,1,1,2,22,9,53,62,95.33333333333333
9863,2012-02-20,1,1,2,23,0,26,26,62.0
9864,2012-02-21,1,1,2,0,1,11,12,33.333333333333336
9865,2012-02-21,1,1,2,1,0,7,7,15.0
9866,2012-02-21,1,1,2,2,0,3,3,7.333333333333333
9867,2012-02-21,1,1,2,4,0,2,2,4.0
9868,2012-02-21,1,1,2,5,0,15,15,6.666666666666667
9869,2012-02-21,1,1,2,6,3,83,86,34.333333333333336
9870,2012-02-21,1,1,2,7,6,273,279,126.66666666666667
9871,2012-02-21,1,1,2,8,5,459,464,276.3333333333333
9872,2012-02-21,1,1,2,9,6,211,217,320.0
9873,2012-02-21,1,1,2,10,8,77,85,255.33333333333334
9874,2012-02-21,1,1,2,11,5,81,86,129.33333333333334
9875,2012-02-21,1,1,2,12,16,147,163,111.33333333333333
9876,2012-02-21,1,1,2,13,8,123,131,126.66666666666667
9877,2012-02-21,1,1,2,14,16,108,124,139.33333333333334
9878,2012-02-21,1,1,2,15,23,137,160,138.33333333333334
9879,2012-02-21,1,1,2,16,14,240,254,179.33333333333334
9880,2012-02-21,1,1,2,17,21,411,432,282.0
9881,2012-02-21,1,1,2,18,11,414,425,370.3333333333333
9882,2012-02-21,1,1,2,19,5,299,304,387.0
9883,2012-02-21,1,1,2,20,4,223,227,318.6666666666667
9884,2012-02-21,1,1,2,21,7,147,154,228.33333333333334
9885,2012-02-21,1,1,2,22,3,97,100,160.33333333333334
9886,2012-02-21,1,1,2,23,1,46,47,100.33333333333333
9887,2012-02-22,1,1,2,0,5,19,24,57.0
9888,2012-02-22,1,1,2,1,3,4,7,26.0
9889,2012-02-22,1,1,2,2,1,5,6,12.333333333333334
9890,2012-02-22,1,1,2,3,1,3,4,5.666666666666667
9891,2012-02-22,1,1,2,4,0,2,2,4.0
9892,2012-02-22,1,1,2,5,1,29,30,12.0
9893,2012-02-22,1,1,2,6,5,85,90,40.666666666666664
9894,2012-02-22,1,1,2,7,10,292,302,140.66666666666666
9895,2012-02-22,1,1,2,8,9,567,576,322.6666666666667
9896,2012-02-22,1,1,2,9,11,241,252,376.6666666666667
9897,2012-02-22,1,1,2,10,17,122,139,322.3333333333333
9898,2012-02-22,1,1,2,11,22,149,171,187.33333333333334
9899,2012-02-22,1,1,2,12,21,186,207,172.33333333333334
9900,2012-02-22,1,1,2,13,15,175,190,189.33333333333334
9901,2012-02-22,1,1,2,14,35,142,177,191.33333333333334
9902,2012-02-22,1,1,2,15,34,161,195,187.33333333333334
9903,2012-02-22,1,1,2,16,30,268,298,223.33333333333334
9904,2012-02-22,1,1,2,17,43,486,529,340.6666666666667
9905,2012-02-22,1,1,2,18,42,483,525,450.6666666666667
9906,2012-02-22,1,1,2,19,22,305,327,460.3333333333333
9907,2012-02-22,1,1,2,20,25,249,274,375.3333333333333
9908,2012-02-22,1,1,2,21,19,220,239,280.0
9909,2012-02-22,1,1,2,22,18,129,147,220.0
9910,2012-02-22,1,1,2,23,5,57,62,149.33333333333334
9911,2012-02-23,1,1,2,0,12,30,42,83.66666666666667
9912,2012-02-23,1,1,2,1,3,12,15,39.666666666666664
9913,2012-02-23,1,1,2,2,5,4,9,22.0
9914,2012-02-23,1,1,2,3,2,4,6,10.0
9915,2012-02-23,1,1,2,4,0,1,1,5.333333333333333
9916,2012-02-23,1,1,2,5,2,30,32,13.0
9917,2012-02-23,1,1,2,6,3,88,91,41.333333333333336
9918,2012-02-23,1,1,2,7,9,317,326,149.66666666666666
9919,2012-02-23,1,1,2,8,11,549,560,325.6666666666667
9920,2012-02-23,1,1,2,9,14,228,242,376.0
9921,2012-02-23,1,1,2,10,41,107,148,316.6666666666667
9922,2012-02-23,1,1,2,11,54,128,182,190.66666666666666
9923,2012-02-23,1,1,2,12,25,199,224,184.66666666666666
9924,2012-02-23,1,1,2,13,30,188,218,208.0
9925,2012-02-23,1,1,2,14,36,156,192,211.33333333333334
9926,2012-02-23,1,1,2,15,46,171,217,209.0
9927,2012-02-23,1,1,2,16,45,298,343,250.66666666666666
9928,2012-02-23,1,1,2,17,49,561,610,390.0
9929,2012-02-23,1,1,2,18,36,486,522,491.6666666666667
9930,2012-02-23,1,1,2,19,20,349,369,500.3333333333333
9931,2012-02-23,1,1,2,20,23,246,269,386.6666666666667
9932,2012-02-23,1,1,2,21,17,205,222,286.6666666666667
9933,2012-02-23,1,1,2,22,19,118,137,209.33333333333334
9934,2012-02-23,1,1,2,23,14,71,85,148.0
9935,2012-02-24,1,1,2,0,12,34,46,89.33333333333333
9936,2012-02-24,1,1,2,1,3,15,18,49.666666666666664
9937,2012-02-24,1,1,2,2,1,4,5,23.0
9938,2012-02-24,1,1,2,3,0,5,5,9.333333333333334
9939,2012-02-24,1,1,2,4,0,2,2,4.0
9940,2012-02-24,1,1,2,5,1,25,26,11.0
9941,2012-02-24,1,1,2,6,2,80,82,36.666666666666664
9942,2012-02-24,1,1,2,7,7,265,272,126.66666666666667
9943,2012-02-24,1,1,2,8,17,452,469,274.3333333333333
9944,2012-02-24,1,1,2,9,15,229,244,328.3333333333333
9945,2012-02-24,1,1,2,10,22,119,141,284.6666666666667
9946,2012-02-24,1,1,2,11,27,136,163,182.66666666666666
9947,2012-02-24,1,1,2,12,27,201,228,177.33333333333334
9948,2012-02-24,1,1,2,13,30,153,183,191.33333333333334
9949,2012-02-24,1,1,2,14,5,26,31,147.33333333333334
9950,2012-02-24,1,1,2,15,11,83,94,102.66666666666667
9951,2012-02-24,1,1,2,16,12,166,178,101.0
9952,2012-02-24,1,1,2,17,14,242,256,176.0
9953,2012-02-24,1,1,2,18,11,289,300,244.66666666666666
9954,2012-02-24,1,1,2,19,6,227,233,263.0
9955,2012-02-24,1,1,2,20,8,159,167,233.33333333333334
9956,2012-02-24,1,1,2,21,1,151,152,184.0
9957,2012-02-24,1,1,2,22,4,102,106,141.66666666666666
9958,2012-02-24,1,1,2,23,10,76,86,114.66666666666667
9959,2012-02-25,1,1,2,0,5,56,61,84.33333333333333
9960,2012-02-25,1,1,2,1,4,42,46,64.33333333333333
9961,2012-02-25,1,1,2,2,1,37,38,48.333333333333336
9962,2012-02-25,1,1,2,3,0,7,7,30.333333333333332
9963,2012-02-25,1,1,2,4,0,2,2,15.666666666666666
9964,2012-02-25,1,1,2,5,0,3,3,4.0
9965,2012-02-25,1,1,2,6,1,12,13,6.0
9966,2012-02-25,1,1,2,7,3,20,23,13.0
9967,2012-02-25,1,1,2,8,3,90,93,43.0
9968,2012-02-25,1,1,2,9,15,107,122,79.33333333333333
9969,2012-02-25,1,1,2,10,24,159,183,132.66666666666666
9970,2012-02-25,1,1,2,11,23,187,210,171.66666666666666
9971,2012-02-25,1,1,2,12,41,217,258,217.0
9972,2012-02-25,1,1,2,13,48,178,226,231.33333333333334
9973,2012-02-25,1,1,2,14,35,181,216,233.33333333333334
9974,2012-02-25,1,1,2,15,21,211,232,224.66666666666666
9975,2012-02-25,1,1,2,16,32,163,195,214.33333333333334
9976,2012-02-25,1,1,2,17,16,143,159,195.33333333333334
9977,2012-02-25,1,1,2,18,7,126,133,162.33333333333334
9978,2012-02-25,1,1,2,19,12,137,149,147.0
9979,2012-02-25,1,1,2,20,10,95,105,129.0
9980,2012-02-25,1,1,2,21,5,80,85,113.0
9981,2012-02-25,1,1,2,22,4,78,82,90.66666666666667
9982,2012-02-25,1,1,2,23,7,84,91,86.0
9983,2012-02-26,1,1,2,0,7,63,70,81.0
9984,2012-02-26,1,1,2,1,5,50,55,72.0
9985,2012-02-26,1,1,2,2,5,37,42,55.666666666666664
9986,2012-02-26,1,1,2,3,0,21,21,39.333333333333336
9987,2012-02-26,1,1,2,4,1,5,6,23.0
9988,2012-02-26,1,1,2,5,0,5,5,10.666666666666666
9989,2012-02-26,1,1,2,6,0,2,2,4.333333333333333
9990,2012-02-26,1,1,2,7,2,20,22,9.666666666666666
9991,2012-02-26,1,1,2,8,2,57,59,27.666666666666668
9992,2012-02-26,1,1,2,9,11,76,87,56.0
9993,2012-02-26,1,1,2,10,27,161,188,111.33333333333333
9994,2012-02-26,1,1,2,11,43,184,227,167.33333333333334
9995,2012-02-26,1,1,2,12,49,256,305,240.0
9996,2012-02-26,1,1,2,13,58,267,325,285.6666666666667
9997,2012-02-26,1,1,2,14,68,263,331,320.3333333333333
9998,2012-02-26,1,1,2,15,72,281,353,336.3333333333333
9999,2012-02-26,1,1,2,16,64,275,339,341.0
10000,2012-02-26,1,1,2,17,46,241,287,326.3333333333333
10001,2012-02-26,1,1,2,18,17,199,216,280.6666666666667
10002,2012-02-26,1,1,2,19,13,130,143,215.33333333333334
10003,2012-02-26,1,1,2,20,9,79,88,149.0
10004,2012-02-26,1,1,2,21,8,75,83,104.66666666666667
10005,2012-02-26,1,1,2,22,3,68,71,80.66666666666667
10006,2012-02-26,1,1,2,23,5,59,64,72.66666666666667
10007,2012-02-27,1,1,2,0,2,27,29,54.666666666666664
10008,2012-02-27,1,1,2,1,0,6,6,33.0
10009,2012-02-27,1,1,2,2,0,4,4,13.0
10010,2012-02-27,1,1,2,3,0,2,2,4.0
10011,2012-02-27,1,1,2,4,0,1,1,2.3333333333333335
10012,2012-02-27,1,1,2,5,0,16,16,6.333333333333333
10013,2012-02-27,1,1,2,6,1,89,90,35.666666666666664
10014,2012-02-27,1,1,2,7,2,278,280,128.66666666666666
10015,2012-02-27,1,1,2,8,14,514,528,299.3333333333333
10016,2012-02-27,1,1,2,9,11,219,230,346.0
10017,2012-02-27,1,1,2,10,16,88,104,287.3333333333333
10018,2012-02-27,1,1,2,11,11,92,103,145.66666666666666
10019,2012-02-27,1,1,2,12,13,164,177,128.0
10020,2012-02-27,1,1,2,13,23,159,182,154.0
10021,2012-02-27,1,1,2,14,24,134,158,172.33333333333334
10022,2012-02-27,1,1,2,15,24,150,174,171.33333333333334
10023,2012-02-27,1,1,2,16,20,266,286,206.0
10024,2012-02-27,1,1,2,17,26,503,529,329.6666666666667
10025,2012-02-27,1,1,2,18,10,517,527,447.3333333333333
10026,2012-02-27,1,1,2,19,16,318,334,463.3333333333333
10027,2012-02-27,1,1,2,20,11,208,219,360.0
10028,2012-02-27,1,1,2,21,14,181,195,249.33333333333334
10029,2012-02-27,1,1,2,22,9,83,92,168.66666666666666
10030,2012-02-27,1,1,2,23,6,50,56,114.33333333333333
10031,2012-02-28,1,1,2,0,0,10,10,52.666666666666664
10032,2012-02-28,1,1,2,1,0,6,6,24.0
10033,2012-02-28,1,1,2,2,1,2,3,6.333333333333333
10034,2012-02-28,1,1,2,3,0,6,6,5.0
10035,2012-02-28,1,1,2,4,0,2,2,3.6666666666666665
10036,2012-02-28,1,1,2,5,1,20,21,9.666666666666666
10037,2012-02-28,1,1,2,6,1,100,101,41.333333333333336
10038,2012-02-28,1,1,2,7,12,313,325,149.0
10039,2012-02-28,1,1,2,8,16,543,559,328.3333333333333
10040,2012-02-28,1,1,2,9,7,225,232,372.0
10041,2012-02-28,1,1,2,10,14,118,132,307.6666666666667
10042,2012-02-28,1,1,2,11,8,155,163,175.66666666666666
10043,2012-02-28,1,1,2,12,19,164,183,159.33333333333334
10044,2012-02-28,1,1,2,13,16,174,190,178.66666666666666
10045,2012-02-28,1,1,2,14,13,121,134,169.0
10046,2012-02-28,1,1,2,15,17,149,166,163.33333333333334
10047,2012-02-28,1,1,2,16,17,270,287,195.66666666666666
10048,2012-02-28,1,1,2,17,33,497,530,327.6666666666667
10049,2012-02-28,1,1,2,18,17,432,449,422.0
10050,2012-02-28,1,1,2,19,15,291,306,428.3333333333333
10051,2012-02-28,1,1,2,20,2,202,204,319.6666666666667
10052,2012-02-28,1,1,2,21,10,178,188,232.66666666666666
10053,2012-02-28,1,1,2,22,6,95,101,164.33333333333334
10054,2012-02-28,1,1,2,23,4,61,65,118.0
10055,2012-02-29,1,1,2,0,2,30,32,66.0
10056,2012-02-29,1,1,2,1,0,6,6,34.333333333333336
10057,2012-02-29,1,1,2,2,0,4,4,14.0
10058,2012-02-29,1,1,2,3,0,2,2,4.0
10059,2012-02-29,1,1,2,5,0,29,29,11.666666666666666
10060,2012-02-29,1,1,2,6,4,100,104,45.0
10061,2012-02-29,1,1,2,7,11,242,253,128.66666666666666
10062,2012-02-29,1,1,2,8,2,114,116,157.66666666666666
10063,2012-02-29,1,1,2,9,5,33,38,135.66666666666666
10064,2012-02-29,1,1,2,10,0,10,10,54.666666666666664
10065,2012-02-29,1,1,2,11,1,9,10,19.333333333333332
10066,2012-02-29,1,1,2,12,1,69,70,30.0
10067,2012-02-29,1,1,2,13,4,72,76,52.0
10068,2012-02-29,1,1,2,14,2,54,56,67.33333333333333
10069,2012-02-29,1,1,2,15,3,87,90,74.0
10070,2012-02-29,1,1,2,16,5,162,167,104.33333333333333
10071,2012-02-29,1,1,2,17,7,246,253,170.0
10072,2012-02-29,1,1,2,18,11,181,192,204.0
10073,2012-02-29,1,1,2,19,0,102,102,182.33333333333334
10074,2012-02-29,1,1,2,20,2,95,97,130.33333333333334
10075,2012-02-29,1,1,2,21,0,39,39,79.33333333333333
10076,2012-02-29,1,1,2,22,2,53,55,63.666666666666664
10077,2012-02-29,1,1,2,23,3,30,33,42.333333333333336
10078,2012-03-01,1,1,3,0,1,10,11,33.0
10079,2012-03-01,1,1,3,1,0,12,12,18.666666666666668
10080,2012-03-01,1,1,3,2,0,6,6,9.666666666666666
10081,2012-03-01,1,1,3,3,0,3,3,7.0
10082,2012-03-01,1,1,3,4,0,5,5,4.666666666666667
10083,2012-03-01,1,1,3,5,0,18,18,8.666666666666666
10084,2012-03-01,1,1,3,6,2,107,109,44.0
10085,2012-03-01,1,1,3,7,8,296,304,143.66666666666666
10086,2012-03-01,1,1,3,8,15,579,594,335.6666666666667
10087,2012-03-01,1,1,3,9,5,281,286,394.6666666666667
10088,2012-03-01,1,1,3,10,11,122,133,337.6666666666667
10089,2012-03-01,1,1,3,11,19,149,168,195.66666666666666
10090,2012-03-01,1,1,3,12,16,204,220,173.66666666666666
10091,2012-03-01,1,1,3,13,24,187,211,199.66666666666666
10092,2012-03-01,1,1,3,14,37,174,211,214.0
10093,2012-03-01,1,1,3,15,31,192,223,215.0
10094,2012-03-01,1,1,3,16,38,323,361,265.0
10095,2012-03-01,1,1,3,17,49,551,600,394.6666666666667
10096,2012-03-01,1,1,3,18,27,498,525,495.3333333333333
10097,2012-03-01,1,1,3,19,11,317,328,484.3333333333333
10098,2012-03-01,1,1,3,20,12,242,254,369.0
10099,2012-03-01,1,1,3,21,7,190,197,259.6666666666667
10100,2012-03-01,1,1,3,22,3,123,126,192.33333333333334
10101,2012-03-01,1,1,3,23,9,76,85,136.0
10102,2012-03-02,1,1,3,0,1,45,46,85.66666666666667
10103,2012-03-02,1,1,3,1,2,18,20,50.333333333333336
10104,2012-03-02,1,1,3,2,2,4,6,24.0
10105,2012-03-02,1,1,3,3,0,3,3,9.666666666666666
10106,2012-03-02,1,1,3,4,0,2,2,3.6666666666666665
10107,2012-03-02,1,1,3,5,0,24,24,9.666666666666666
10108,2012-03-02,1,1,3,6,4,88,92,39.333333333333336
10109,2012-03-02,1,1,3,7,4,258,262,126.0
10110,2012-03-02,1,1,3,8,16,533,549,301.0
10111,2012-03-02,1,1,3,9,15,299,314,375.0
10112,2012-03-02,1,1,3,10,14,118,132,331.6666666666667
10113,2012-03-02,1,1,3,11,40,154,194,213.33333333333334
10114,2012-03-02,1,1,3,12,40,194,234,186.66666666666666
10115,2012-03-02,1,1,3,13,31,191,222,216.66666666666666
10116,2012-03-02,1,1,3,14,29,176,205,220.33333333333334
10117,2012-03-02,1,1,3,15,5,73,78,168.33333333333334
10118,2012-03-02,1,1,3,16,1,49,50,111.0
10119,2012-03-02,1,1,3,17,5,123,128,85.33333333333333
10120,2012-03-02,1,1,3,18,6,154,160,112.66666666666667
10121,2012-03-02,1,1,3,19,12,162,174,154.0
10122,2012-03-02,1,1,3,20,7,93,100,144.66666666666666
10123,2012-03-02,1,1,3,21,2,99,101,125.0
10124,2012-03-02,1,1,3,22,6,69,75,92.0
10125,2012-03-02,1,1,3,23,4,19,23,66.33333333333333
10126,2012-03-03,1,1,3,0,1,21,22,40.0
10127,2012-03-03,1,1,3,1,0,44,44,29.666666666666668
10128,2012-03-03,1,1,3,2,4,34,38,34.666666666666664
10129,2012-03-03,1,1,3,3,1,20,21,34.333333333333336
10130,2012-03-03,1,1,3,4,0,2,2,20.333333333333332
10131,2012-03-03,1,1,3,5,1,1,2,8.333333333333334
10132,2012-03-03,1,1,3,6,1,6,7,3.6666666666666665
10133,2012-03-03,1,1,3,7,2,14,16,8.333333333333334
10134,2012-03-03,1,1,3,8,2,46,48,23.666666666666668
10135,2012-03-03,1,1,3,9,7,87,94,52.666666666666664
10136,2012-03-03,1,1,3,10,31,137,168,103.33333333333333
10137,2012-03-03,1,1,3,11,33,181,214,158.66666666666666
10138,2012-03-03,1,1,3,12,47,252,299,227.0
10139,2012-03-03,1,1,3,13,87,252,339,284.0
10140,2012-03-03,1,1,3,14,151,279,430,356.0
10141,2012-03-03,1,1,3,15,145,254,399,389.3333333333333
10142,2012-03-03,1,1,3,16,167,300,467,432.0
10143,2012-03-03,1,1,3,17,106,279,385,417.0
10144,2012-03-03,1,1,3,18,53,250,303,385.0
10145,2012-03-03,1,1,3,19,34,191,225,304.3333333333333
10146,2012-03-03,1,1,3,20,28,121,149,225.66666666666666
10147,2012-03-03,1,1,3,21,24,130,154,176.0
10148,2012-03-03,1,1,3,22,19,115,134,145.66666666666666
10149,2012-03-03,1,1,3,23,12,94,106,131.33333333333334
10150,2012-03-04,1,1,3,0,5,67,72,104.0
10151,2012-03-04,1,1,3,1,16,60,76,84.66666666666667
10152,2012-03-04,1,1,3,2,14,66,80,76.0
10153,2012-03-04,1,1,3,3,5,21,26,60.666666666666664
10154,2012-03-04,1,1,3,4,3,11,14,40.0
10155,2012-03-04,1,1,3,5,0,5,5,15.0
10156,2012-03-04,1,1,3,6,0,5,5,8.0
10157,2012-03-04,1,1,3,7,2,21,23,11.0
10158,2012-03-04,1,1,3,8,12,54,66,31.333333333333332
10159,2012-03-04,1,1,3,9,14,104,118,69.0
10160,2012-03-04,1,1,3,10,31,161,192,125.33333333333333
10161,2012-03-04,1,1,3,11,64,192,256,188.66666666666666
10162,2012-03-04,1,1,3,12,71,256,327,258.3333333333333
10163,2012-03-04,1,1,3,13,108,256,364,315.6666666666667
10164,2012-03-04,1,1,3,14,106,226,332,341.0
10165,2012-03-04,1,1,3,15,82,252,334,343.3333333333333
10166,2012-03-04,1,1,3,16,68,231,299,321.6666666666667
10167,2012-03-04,1,1,3,17,49,214,263,298.6666666666667
10168,2012-03-04,1,1,3,18,20,164,184,248.66666666666666
10169,2012-03-04,1,1,3,19,12,120,132,193.0
10170,2012-03-04,1,1,3,20,8,80,88,134.66666666666666
10171,2012-03-04,1,1,3,21,9,70,79,99.66666666666667
10172,2012-03-04,1,1,3,22,9,53,62,76.33333333333333
10173,2012-03-04,1,1,3,23,2,24,26,55.666666666666664
10174,2012-03-05,1,1,3,0,2,15,17,35.0
10175,2012-03-05,1,1,3,1,3,3,6,16.333333333333332
10176,2012-03-05,1,1,3,2,1,3,4,9.0
10177,2012-03-05,1,1,3,3,0,1,1,3.6666666666666665
10178,2012-03-05,1,1,3,4,0,1,1,2.0
10179,2012-03-05,1,1,3,5,1,17,18,6.666666666666667
10180,2012-03-05,1,1,3,6,2,89,91,36.666666666666664
10181,2012-03-05,1,1,3,7,7,253,260,123.0
10182,2012-03-05,1,1,3,8,13,415,428,259.6666666666667
10183,2012-03-05,1,1,3,9,11,186,197,295.0
10184,2012-03-05,1,1,3,10,12,74,86,237.0
10185,2012-03-05,1,1,3,11,17,86,103,128.66666666666666
10186,2012-03-05,1,1,3,12,15,122,137,108.66666666666667
10187,2012-03-05,1,1,3,13,11,109,120,120.0
10188,2012-03-05,1,1,3,14,13,115,128,128.33333333333334
10189,2012-03-05,1,1,3,15,20,110,130,126.0
10190,2012-03-05,1,1,3,16,30,180,210,156.0
10191,2012-03-05,1,1,3,17,11,376,387,242.33333333333334
10192,2012-03-05,1,1,3,18,12,363,375,324.0
10193,2012-03-05,1,1,3,19,6,220,226,329.3333333333333
10194,2012-03-05,1,1,3,20,8,171,179,260.0
10195,2012-03-05,1,1,3,21,4,116,120,175.0
10196,2012-03-05,1,1,3,22,2,76,78,125.66666666666667
10197,2012-03-05,1,1,3,23,2,29,31,76.33333333333333
10198,2012-03-06,1,1,3,0,0,8,8,39.0
10199,2012-03-06,1,1,3,1,0,6,6,15.0
10200,2012-03-06,1,1,3,2,0,4,4,6.0
10201,2012-03-06,1,1,3,3,0,1,1,3.6666666666666665
10202,2012-03-06,1,1,3,4,0,3,3,2.6666666666666665
10203,2012-03-06,1,1,3,5,0,25,25,9.666666666666666
10204,2012-03-06,1,1,3,6,3,99,102,43.333333333333336
10205,2012-03-06,1,1,3,7,5,270,275,134.0
10206,2012-03-06,1,1,3,8,14,487,501,292.6666666666667
10207,2012-03-06,1,1,3,9,11,222,233,336.3333333333333
10208,2012-03-06,1,1,3,10,16,113,129,287.6666666666667
10209,2012-03-06,1,1,3,11,20,110,130,164.0
10210,2012-03-06,1,1,3,12,9,129,138,132.33333333333334
10211,2012-03-06,1,1,3,13,16,148,164,144.0
10212,2012-03-06,1,1,3,14,20,116,136,146.0
10213,2012-03-06,1,1,3,15,24,142,166,155.33333333333334
10214,2012-03-06,1,1,3,16,22,228,250,184.0
10215,2012-03-06,1,1,3,17,21,425,446,287.3333333333333
10216,2012-03-06,1,1,3,18,15,442,457,384.3333333333333
10217,2012-03-06,1,1,3,19,9,278,287,396.6666666666667
10218,2012-03-06,1,1,3,20,3,184,187,310.3333333333333
10219,2012-03-06,1,1,3,21,5,143,148,207.33333333333334
10220,2012-03-06,1,1,3,22,5,101,106,147.0
10221,2012-03-06,1,1,3,23,3,51,54,102.66666666666667
10222,2012-03-07,1,1,3,0,3,12,15,58.333333333333336
10223,2012-03-07,1,1,3,1,1,4,5,24.666666666666668
10224,2012-03-07,1,1,3,2,0,4,4,8.0
10225,2012-03-07,1,1,3,3,1,2,3,4.0
10226,2012-03-07,1,1,3,4,0,3,3,3.3333333333333335
10227,2012-03-07,1,1,3,5,0,18,18,8.0
10228,2012-03-07,1,1,3,6,4,104,108,43.0
10229,2012-03-07,1,1,3,7,12,332,344,156.66666666666666
10230,2012-03-07,1,1,3,8,12,554,566,339.3333333333333
10231,2012-03-07,1,1,3,9,12,252,264,391.3333333333333
10232,2012-03-07,1,1,3,10,20,127,147,325.6666666666667
10233,2012-03-07,1,1,3,11,33,128,161,190.66666666666666
10234,2012-03-07,1,1,3,12,40,175,215,174.33333333333334
10235,2012-03-07,1,1,3,13,26,179,205,193.66666666666666
10236,2012-03-07,1,1,3,14,38,137,175,198.33333333333334
10237,2012-03-07,1,1,3,15,44,165,209,196.33333333333334
10238,2012-03-07,1,1,3,16,34,254,288,224.0
10239,2012-03-07,1,1,3,17,58,554,612,369.6666666666667
10240,2012-03-07,1,1,3,18,35,509,544,481.3333333333333
10241,2012-03-07,1,1,3,19,16,345,361,505.6666666666667
10242,2012-03-07,1,1,3,20,18,242,260,388.3333333333333
10243,2012-03-07,1,1,3,21,11,177,188,269.6666666666667
10244,2012-03-07,1,1,3,22,10,149,159,202.33333333333334
10245,2012-03-07,1,1,3,23,4,58,62,136.33333333333334
10246,2012-03-08,1,1,3,0,11,35,46,89.0
10247,2012-03-08,1,1,3,1,4,17,21,43.0
10248,2012-03-08,1,1,3,2,6,5,11,26.0
10249,2012-03-08,1,1,3,3,0,3,3,11.666666666666666
10250,2012-03-08,1,1,3,4,0,2,2,5.333333333333333
10251,2012-03-08,1,1,3,5,1,28,29,11.333333333333334
10252,2012-03-08,1,1,3,6,4,105,109,46.666666666666664
10253,2012-03-08,1,1,3,7,8,326,334,157.33333333333334
10254,2012-03-08,1,1,3,8,12,573,585,342.6666666666667
10255,2012-03-08,1,1,3,9,19,282,301,406.6666666666667
10256,2012-03-08,1,1,3,10,19,119,138,341.3333333333333
10257,2012-03-08,1,1,3,11,48,156,204,214.33333333333334
10258,2012-03-08,1,1,3,12,27,224,251,197.66666666666666
10259,2012-03-08,1,1,3,13,35,198,233,229.33333333333334
10260,2012-03-08,1,1,3,14,48,155,203,229.0
10261,2012-03-08,1,1,3,15,24,161,185,207.0
10262,2012-03-08,1,1,3,16,37,305,342,243.33333333333334
10263,2012-03-08,1,1,3,17,52,545,597,374.6666666666667
10264,2012-03-08,1,1,3,18,45,545,590,509.6666666666667
10265,2012-03-08,1,1,3,19,21,395,416,534.3333333333334
10266,2012-03-08,1,1,3,20,20,282,302,436.0
10267,2012-03-08,1,1,3,21,27,206,233,317.0
10268,2012-03-08,1,1,3,22,12,141,153,229.33333333333334
10269,2012-03-08,1,1,3,23,6,88,94,160.0
10270,2012-03-09,1,1,3,0,3,51,54,100.33333333333333
10271,2012-03-09,1,1,3,1,4,22,26,58.0
10272,2012-03-09,1,1,3,2,2,9,11,30.333333333333332
10273,2012-03-09,1,1,3,3,0,7,7,14.666666666666666
10274,2012-03-09,1,1,3,4,0,1,1,6.333333333333333
10275,2012-03-09,1,1,3,5,2,27,29,12.333333333333334
10276,2012-03-09,1,1,3,6,2,83,85,38.333333333333336
10277,2012-03-09,1,1,3,7,6,262,268,127.33333333333333
10278,2012-03-09,1,1,3,8,17,484,501,284.6666666666667
10279,2012-03-09,1,1,3,9,17,267,284,351.0
10280,2012-03-09,1,1,3,10,14,145,159,314.6666666666667
10281,2012-03-09,1,1,3,11,17,170,187,210.0
10282,2012-03-09,1,1,3,12,27,174,201,182.33333333333334
10283,2012-03-09,1,1,3,13,49,175,224,204.0
10284,2012-03-09,1,1,3,14,49,129,178,201.0
10285,2012-03-09,1,1,3,15,50,188,238,213.33333333333334
10286,2012-03-09,1,1,3,16,51,292,343,253.0
10287,2012-03-09,1,1,3,17,68,498,566,382.3333333333333
10288,2012-03-09,1,1,3,18,30,440,470,459.6666666666667
10289,2012-03-09,1,1,3,19,12,232,244,426.6666666666667
10290,2012-03-09,1,1,3,20,3,156,159,291.0
10291,2012-03-09,1,1,3,21,8,133,141,181.33333333333334
10292,2012-03-09,1,1,3,22,7,100,107,135.66666666666666
10293,2012-03-09,1,1,3,23,9,77,86,111.33333333333333
10294,2012-03-10,1,1,3,0,9,68,77,90.0
10295,2012-03-10,1,1,3,1,1,50,51,71.33333333333333
10296,2012-03-10,1,1,3,2,12,30,42,56.666666666666664
10297,2012-03-10,1,1,3,3,0,16,16,36.333333333333336
10298,2012-03-10,1,1,3,4,1,3,4,20.666666666666668
10299,2012-03-10,1,1,3,5,3,7,10,10.0
10300,2012-03-10,1,1,3,6,1,11,12,8.666666666666666
10301,2012-03-10,1,1,3,7,4,36,40,20.666666666666668
10302,2012-03-10,1,1,3,8,15,96,111,54.333333333333336
10303,2012-03-10,1,1,3,9,21,127,148,99.66666666666667
10304,2012-03-10,1,1,3,10,47,176,223,160.66666666666666
10305,2012-03-10,1,1,3,11,56,218,274,215.0
10306,2012-03-10,1,1,3,12,88,241,329,275.3333333333333
10307,2012-03-10,1,1,3,13,89,268,357,320.0
10308,2012-03-10,1,1,3,14,117,262,379,355.0
10309,2012-03-10,1,1,3,15,132,274,406,380.6666666666667
10310,2012-03-10,1,1,3,16,115,275,390,391.6666666666667
10311,2012-03-10,1,1,3,17,104,250,354,383.3333333333333
10312,2012-03-10,1,1,3,18,67,230,297,347.0
10313,2012-03-10,1,1,3,19,25,159,184,278.3333333333333
10314,2012-03-10,1,1,3,20,20,101,121,200.66666666666666
10315,2012-03-10,1,1,3,21,16,94,110,138.33333333333334
10316,2012-03-10,1,1,3,22,19,81,100,110.33333333333333
10317,2012-03-10,1,1,3,23,6,77,83,97.66666666666667
10318,2012-03-11,1,1,3,0,7,62,69,84.0
10319,2012-03-11,1,1,3,1,4,57,61,71.0
10320,2012-03-11,1,1,3,3,15,51,66,65.33333333333333
10321,2012-03-11,1,1,3,4,7,15,22,49.666666666666664
10322,2012-03-11,1,1,3,5,2,5,7,31.666666666666668
10323,2012-03-11,1,1,3,6,2,8,10,13.0
10324,2012-03-11,1,1,3,7,2,15,17,11.333333333333334
10325,2012-03-11,1,1,3,8,4,68,72,33.0
10326,2012-03-11,1,1,3,9,20,70,90,59.666666666666664
10327,2012-03-11,1,1,3,10,71,147,218,126.66666666666667
10328,2012-03-11,1,1,3,11,90,209,299,202.33333333333334
10329,2012-03-11,1,1,3,12,146,264,410,309.0
10330,2012-03-11,1,1,3,13,176,288,464,391.0
10331,2012-03-11,1,1,3,14,212,289,501,458.3333333333333
10332,2012-03-11,1,1,3,15,201,286,487,484.0
10333,2012-03-11,1,1,3,16,208,301,509,499.0
10334,2012-03-11,1,1,3,17,199,299,498,498.0
10335,2012-03-11,1,1,3,18,133,256,389,465.3333333333333
10336,2012-03-11,1,1,3,19,55,203,258,381.6666666666667
10337,2012-03-11,1,1,3,20,42,129,171,272.6666666666667
10338,2012-03-11,1,1,3,21,37,110,147,192.0
10339,2012-03-11,1,1,3,22,13,81,94,137.33333333333334
10340,2012-03-11,1,1,3,23,12,40,52,97.66666666666667
10341,2012-03-12,1,1,3,0,4,20,24,56.666666666666664
10342,2012-03-12,1,1,3,1,1,9,10,28.666666666666668
10343,2012-03-12,1,1,3,2,4,5,9,14.333333333333334
10344,2012-03-12,1,1,3,3,0,2,2,7.0
10345,2012-03-12,1,1,3,4,0,3,3,4.666666666666667
10346,2012-03-12,1,1,3,5,1,15,16,7.0
10347,2012-03-12,1,1,3,6,2,86,88,35.666666666666664
10348,2012-03-12,1,1,3,7,9,259,268,124.0
10349,2012-03-12,1,1,3,8,17,547,564,306.6666666666667
10350,2012-03-12,1,1,3,9,21,260,281,371.0
10351,2012-03-12,1,1,3,10,39,98,137,327.3333333333333
10352,2012-03-12,1,1,3,11,39,111,150,189.33333333333334
10353,2012-03-12,1,1,3,12,59,162,221,169.33333333333334
10354,2012-03-12,1,1,3,13,74,176,250,207.0
10355,2012-03-12,1,1,3,14,76,145,221,230.66666666666666
10356,2012-03-12,1,1,3,15,74,159,233,234.66666666666666
10357,2012-03-12,1,1,3,16,77,255,332,262.0
10358,2012-03-12,1,1,3,17,87,557,644,403.0
10359,2012-03-12,1,1,3,18,89,623,712,562.6666666666666
10360,2012-03-12,1,1,3,19,67,379,446,600.6666666666666
10361,2012-03-12,1,1,3,20,49,237,286,481.3333333333333
10362,2012-03-12,1,1,3,21,22,183,205,312.3333333333333
10363,2012-03-12,1,1,3,22,17,116,133,208.0
10364,2012-03-12,1,1,3,23,10,53,63,133.66666666666666
10365,2012-03-13,1,1,3,0,5,21,26,74.0
10366,2012-03-13,1,1,3,1,2,14,16,35.0
10367,2012-03-13,1,1,3,2,0,1,1,14.333333333333334
10368,2012-03-13,1,1,3,3,0,2,2,6.333333333333333
10369,2012-03-13,1,1,3,4,0,1,1,1.3333333333333333
10370,2012-03-13,1,1,3,5,0,24,24,9.0
10371,2012-03-13,1,1,3,6,5,108,113,46.0
10372,2012-03-13,1,1,3,7,16,292,308,148.33333333333334
10373,2012-03-13,1,1,3,8,22,571,593,338.0
10374,2012-03-13,1,1,3,9,18,324,342,414.3333333333333
10375,2012-03-13,1,1,3,10,28,115,143,359.3333333333333
10376,2012-03-13,1,1,3,11,64,155,219,234.66666666666666
10377,2012-03-13,1,1,3,12,47,197,244,202.0
10378,2012-03-13,1,1,3,13,53,180,233,232.0
10379,2012-03-13,1,1,3,14,52,160,212,229.66666666666666
10380,2012-03-13,1,1,3,15,68,196,264,236.33333333333334
10381,2012-03-13,1,1,3,16,53,312,365,280.3333333333333
10382,2012-03-13,1,1,3,17,62,614,676,435.0
10383,2012-03-13,1,1,3,18,96,638,734,591.6666666666666
10384,2012-03-13,1,1,3,19,50,429,479,629.6666666666666
10385,2012-03-13,1,1,3,20,45,306,351,521.3333333333334
10386,2012-03-13,1,1,3,21,44,200,244,358.0
10387,2012-03-13,1,1,3,22,24,146,170,255.0
10388,2012-03-13,1,1,3,23,8,79,87,167.0
10389,2012-03-14,1,1,3,0,5,34,39,98.66666666666667
10390,2012-03-14,1,1,3,1,2,25,27,51.0
10391,2012-03-14,1,1,3,2,0,2,2,22.666666666666668
10392,2012-03-14,1,1,3,3,1,3,4,11.0
10393,2012-03-14,1,1,3,4,1,4,5,3.6666666666666665
10394,2012-03-14,1,1,3,5,2,25,27,12.0
10395,2012-03-14,1,1,3,6,1,120,121,51.0
10396,2012-03-14,1,1,3,7,20,348,368,172.0
10397,2012-03-14,1,1,3,8,34,628,662,383.6666666666667
10398,2012-03-14,1,1,3,9,26,325,351,460.3333333333333
10399,2012-03-14,1,1,3,10,38,150,188,400.3333333333333
10400,2012-03-14,1,1,3,11,65,155,220,253.0
10401,2012-03-14,1,1,3,12,55,212,267,225.0
10402,2012-03-14,1,1,3,13,57,197,254,247.0
10403,2012-03-14,1,1,3,14,61,163,224,248.33333333333334
10404,2012-03-14,1,1,3,15,86,197,283,253.66666666666666
10405,2012-03-14,1,1,3,16,78,278,356,287.6666666666667
10406,2012-03-14,1,1,3,17,140,642,782,473.6666666666667
10407,2012-03-14,1,1,3,18,102,647,749,629.0
10408,2012-03-14,1,1,3,19,70,402,472,667.6666666666666
10409,2012-03-14,1,1,3,20,44,286,330,517.0
10410,2012-03-14,1,1,3,21,47,241,288,363.3333333333333
10411,2012-03-14,1,1,3,22,43,159,202,273.3333333333333
10412,2012-03-14,1,1,3,23,19,72,91,193.66666666666666
10413,2012-03-15,1,1,3,0,14,46,60,117.66666666666667
10414,2012-03-15,1,1,3,1,15,8,23,58.0
10415,2012-03-15,1,1,3,2,14,5,19,34.0
10416,2012-03-15,1,1,3,3,0,7,7,16.333333333333332
10417,2012-03-15,1,1,3,4,11,3,14,13.333333333333334
10418,2012-03-15,1,1,3,5,2,24,26,15.666666666666666
10419,2012-03-15,1,1,3,6,4,113,117,52.333333333333336
10420,2012-03-15,1,1,3,7,14,367,381,174.66666666666666
10421,2012-03-15,1,1,3,8,21,602,623,373.6666666666667
10422,2012-03-15,1,1,3,9,30,285,315,439.6666666666667
10423,2012-03-15,1,1,3,10,34,130,164,367.3333333333333
10424,2012-03-15,1,1,3,11,60,151,211,230.0
10425,2012-03-15,1,1,3,12,59,206,265,213.33333333333334
10426,2012-03-15,1,1,3,13,62,211,273,249.66666666666666
10427,2012-03-15,1,1,3,14,81,177,258,265.3333333333333
10428,2012-03-15,1,1,3,15,100,187,287,272.6666666666667
10429,2012-03-15,1,1,3,16,95,331,426,323.6666666666667
10430,2012-03-15,1,1,3,17,79,634,713,475.3333333333333
10431,2012-03-15,1,1,3,18,98,648,746,628.3333333333334
10432,2012-03-15,1,1,3,19,72,353,425,628.0
10433,2012-03-15,1,1,3,20,60,270,330,500.3333333333333
10434,2012-03-15,1,1,3,21,36,207,243,332.6666666666667
10435,2012-03-15,1,1,3,22,32,137,169,247.33333333333334
10436,2012-03-15,1,1,3,23,12,85,97,169.66666666666666
10437,2012-03-16,1,1,3,0,8,49,57,107.66666666666667
10438,2012-03-16,1,1,3,1,4,22,26,60.0
10439,2012-03-16,1,1,3,2,0,4,4,29.0
10440,2012-03-16,1,1,3,3,0,3,3,11.0
10441,2012-03-16,1,1,3,4,0,3,3,3.3333333333333335
10442,2012-03-16,1,1,3,5,2,30,32,12.666666666666666
10443,2012-03-16,1,1,3,6,3,96,99,44.666666666666664
10444,2012-03-16,1,1,3,7,13,265,278,136.33333333333334
10445,2012-03-16,1,1,3,8,28,534,562,313.0
10446,2012-03-16,1,1,3,9,35,277,312,384.0
10447,2012-03-16,1,1,3,10,44,136,180,351.3333333333333
10448,2012-03-16,1,1,3,11,40,167,207,233.0
10449,2012-03-16,1,1,3,12,72,222,294,227.0
10450,2012-03-16,1,1,3,13,52,208,260,253.66666666666666
10451,2012-03-16,1,1,3,14,56,146,202,252.0
10452,2012-03-16,1,1,3,15,19,88,107,189.66666666666666
10453,2012-03-16,1,1,3,16,18,111,129,146.0
10454,2012-03-16,1,1,3,17,23,235,258,164.66666666666666
10455,2012-03-16,1,1,3,18,31,377,408,265.0
10456,2012-03-16,1,1,3,19,23,273,296,320.6666666666667
10457,2012-03-16,1,1,3,20,31,204,235,313.0
10458,2012-03-16,1,1,3,21,8,144,152,227.66666666666666
10459,2012-03-16,1,1,3,22,16,132,148,178.33333333333334
10460,2012-03-16,1,1,3,23,22,104,126,142.0
10461,2012-03-17,1,1,3,0,13,87,100,124.66666666666667
10462,2012-03-17,1,1,3,1,12,57,69,98.33333333333333
10463,2012-03-17,1,1,3,2,10,32,42,70.33333333333333
10464,2012-03-17,1,1,3,3,2,24,26,45.666666666666664
10465,2012-03-17,1,1,3,4,0,2,2,23.333333333333332
10466,2012-03-17,1,1,3,5,5,3,8,12.0
10467,2012-03-17,1,1,3,6,1,29,30,13.333333333333334
10468,2012-03-17,1,1,3,7,29,57,86,41.333333333333336
10469,2012-03-17,1,1,3,8,63,155,218,111.33333333333333
10470,2012-03-17,1,1,3,9,104,217,321,208.33333333333334
10471,2012-03-17,1,1,3,10,140,303,443,327.3333333333333
10472,2012-03-17,1,1,3,11,226,359,585,449.6666666666667
10473,2012-03-17,1,1,3,12,286,365,651,559.6666666666666
10474,2012-03-17,1,1,3,13,286,400,686,640.6666666666666
10475,2012-03-17,1,1,3,14,352,338,690,675.6666666666666
10476,2012-03-17,1,1,3,15,357,322,679,685.0
10477,2012-03-17,1,1,3,16,367,318,685,684.6666666666666
10478,2012-03-17,1,1,3,17,291,357,648,670.6666666666666
10479,2012-03-17,1,1,3,18,221,339,560,631.0
10480,2012-03-17,1,1,3,19,155,262,417,541.6666666666666
10481,2012-03-17,1,1,3,20,89,182,271,416.0
10482,2012-03-17,1,1,3,21,54,169,223,303.6666666666667
10483,2012-03-17,1,1,3,22,58,153,211,235.0
10484,2012-03-17,1,1,3,23,34,151,185,206.33333333333334
10485,2012-03-18,1,1,3,0,27,80,107,167.66666666666666
10486,2012-03-18,1,1,3,1,25,88,113,135.0
10487,2012-03-18,1,1,3,2,15,41,56,92.0
10488,2012-03-18,1,1,3,3,3,15,18,62.333333333333336
10489,2012-03-18,1,1,3,4,6,8,14,29.333333333333332
10490,2012-03-18,1,1,3,5,0,6,6,12.666666666666666
10491,2012-03-18,1,1,3,6,2,9,11,10.333333333333334
10492,2012-03-18,1,1,3,7,17,25,42,19.666666666666668
10493,2012-03-18,1,1,3,8,25,71,96,49.666666666666664
10494,2012-03-18,1,1,3,9,65,113,178,105.33333333333333
10495,2012-03-18,1,1,3,10,139,212,351,208.33333333333334
10496,2012-03-18,1,1,3,11,129,239,368,299.0
10497,2012-03-18,1,1,3,12,222,281,503,407.3333333333333
10498,2012-03-18,1,1,3,13,198,346,544,471.6666666666667
10499,2012-03-18,1,1,3,14,218,303,521,522.6666666666666
10500,2012-03-18,1,1,3,15,240,314,554,539.6666666666666
10501,2012-03-18,1,1,3,16,229,312,541,538.6666666666666
10502,2012-03-18,1,1,3,17,233,308,541,545.3333333333334
10503,2012-03-18,1,1,3,18,165,294,459,513.6666666666666
10504,2012-03-18,1,1,3,19,118,234,352,450.6666666666667
10505,2012-03-18,1,1,3,20,59,139,198,336.3333333333333
10506,2012-03-18,1,1,3,21,44,129,173,241.0
10507,2012-03-18,1,1,3,22,21,79,100,157.0
10508,2012-03-18,1,1,3,23,7,39,46,106.33333333333333
10509,2012-03-19,1,1,3,0,4,19,23,56.333333333333336
10510,2012-03-19,1,1,3,1,0,15,15,28.0
10511,2012-03-19,1,1,3,2,1,7,8,15.333333333333334
10512,2012-03-19,1,1,3,3,0,2,2,8.333333333333334
10513,2012-03-19,1,1,3,4,0,3,3,4.333333333333333
10514,2012-03-19,1,1,3,5,0,31,31,12.0
10515,2012-03-19,1,1,3,6,2,118,120,51.333333333333336
10516,2012-03-19,1,1,3,7,25,329,354,168.33333333333334
10517,2012-03-19,1,1,3,8,16,563,579,351.0
10518,2012-03-19,1,1,3,9,55,276,331,421.3333333333333
10519,2012-03-19,1,1,3,10,56,128,184,364.6666666666667
10520,2012-03-19,1,1,3,11,56,145,201,238.66666666666666
10521,2012-03-19,1,1,3,12,71,211,282,222.33333333333334
10522,2012-03-19,1,1,3,13,69,194,263,248.66666666666666
10523,2012-03-19,1,1,3,14,60,200,260,268.3333333333333
10524,2012-03-19,1,1,3,15,97,189,286,269.6666666666667
10525,2012-03-19,1,1,3,16,65,320,385,310.3333333333333
10526,2012-03-19,1,1,3,17,106,615,721,464.0
10527,2012-03-19,1,1,3,18,120,681,801,635.6666666666666
10528,2012-03-19,1,1,3,19,86,463,549,690.3333333333334
10529,2012-03-19,1,1,3,20,34,296,330,560.0
10530,2012-03-19,1,1,3,21,33,190,223,367.3333333333333
10531,2012-03-19,1,1,3,22,17,131,148,233.66666666666666
10532,2012-03-19,1,1,3,23,9,45,54,141.66666666666666
10533,2012-03-20,1,1,3,0,5,24,29,77.0
10534,2012-03-20,1,1,3,1,6,9,15,32.666666666666664
10535,2012-03-20,1,1,3,2,2,8,10,18.0
10536,2012-03-20,1,1,3,3,0,3,3,9.333333333333334
10537,2012-03-20,1,1,3,4,0,6,6,6.333333333333333
10538,2012-03-20,1,1,3,5,0,20,20,9.666666666666666
10539,2012-03-20,1,1,3,6,6,94,100,42.0
10540,2012-03-20,1,1,3,7,3,167,170,96.66666666666667
10541,2012-03-20,1,1,3,8,28,488,516,262.0
10542,2012-03-20,1,1,3,9,41,284,325,337.0
10543,2012-03-20,1,1,3,10,44,119,163,334.6666666666667
10544,2012-03-20,1,1,3,11,74,156,230,239.33333333333334
10545,2012-03-20,1,1,3,12,56,205,261,218.0
10546,2012-03-20,1,1,3,13,77,207,284,258.3333333333333
10547,2012-03-20,1,1,3,14,66,182,248,264.3333333333333
10548,2012-03-20,1,1,3,15,67,177,244,258.6666666666667
10549,2012-03-20,1,1,3,16,99,332,431,307.6666666666667
10550,2012-03-20,1,1,3,17,108,642,750,475.0
10551,2012-03-20,1,1,3,18,136,665,801,660.6666666666666
10552,2012-03-20,1,1,3,19,75,480,555,702.0
10553,2012-03-20,1,1,3,20,78,299,377,577.6666666666666
10554,2012-03-20,1,1,3,21,38,239,277,403.0
10555,2012-03-20,1,1,3,22,32,156,188,280.6666666666667
10556,2012-03-20,1,1,3,23,10,80,90,185.0
10557,2012-03-21,2,1,3,0,4,29,33,103.66666666666667
10558,2012-03-21,2,1,3,1,4,22,26,49.666666666666664
10559,2012-03-21,2,1,3,2,2,8,10,23.0
10560,2012-03-21,2,1,3,3,1,7,8,14.666666666666666
10561,2012-03-21,2,1,3,4,0,4,4,7.333333333333333
10562,2012-03-21,2,1,3,5,4,35,39,17.0
10563,2012-03-21,2,1,3,6,10,139,149,64.0
10564,2012-03-21,2,1,3,7,34,338,372,186.66666666666666
10565,2012-03-21,2,1,3,8,33,502,535,352.0
10566,2012-03-21,2,1,3,9,38,255,293,400.0
10567,2012-03-21,2,1,3,10,30,124,154,327.3333333333333
10568,2012-03-21,2,1,3,11,38,154,192,213.0
10569,2012-03-21,2,1,3,12,58,171,229,191.66666666666666
10570,2012-03-21,2,1,3,13,81,222,303,241.33333333333334
10571,2012-03-21,2,1,3,14,74,151,225,252.33333333333334
10572,2012-03-21,2,1,3,15,68,175,243,257.0
10573,2012-03-21,2,1,3,16,91,287,378,282.0
10574,2012-03-21,2,1,3,17,113,616,729,450.0
10575,2012-03-21,2,1,3,18,152,627,779,628.6666666666666
10576,2012-03-21,2,1,3,19,86,496,582,696.6666666666666
10577,2012-03-21,2,1,3,20,76,298,374,578.3333333333334
10578,2012-03-21,2,1,3,21,47,204,251,402.3333333333333
10579,2012-03-21,2,1,3,22,41,156,197,274.0
10580,2012-03-21,2,1,3,23,37,88,125,191.0
10581,2012-03-22,2,1,3,0,9,32,41,121.0
10582,2012-03-22,2,1,3,1,14,16,30,65.33333333333333
10583,2012-03-22,2,1,3,2,1,5,6,25.666666666666668
10584,2012-03-22,2,1,3,3,0,7,7,14.333333333333334
10585,2012-03-22,2,1,3,4,0,6,6,6.333333333333333
10586,2012-03-22,2,1,3,5,2,32,34,15.666666666666666
10587,2012-03-22,2,1,3,6,10,126,136,58.666666666666664
10588,2012-03-22,2,1,3,7,29,332,361,177.0
10589,2012-03-22,2,1,3,8,51,598,649,382.0
10590,2012-03-22,2,1,3,9,41,277,318,442.6666666666667
10591,2012-03-22,2,1,3,10,32,110,142,369.6666666666667
10592,2012-03-22,2,1,3,11,53,166,219,226.33333333333334
10593,2012-03-22,2,1,3,12,48,224,272,211.0
10594,2012-03-22,2,1,3,13,83,215,298,263.0
10595,2012-03-22,2,1,3,14,96,161,257,275.6666666666667
10596,2012-03-22,2,1,3,15,102,202,304,286.3333333333333
10597,2012-03-22,2,1,3,16,125,300,425,328.6666666666667
10598,2012-03-22,2,1,3,17,154,656,810,513.0
10599,2012-03-22,2,1,3,18,147,654,801,678.6666666666666
10600,2012-03-22,2,1,3,19,117,469,586,732.3333333333334
10601,2012-03-22,2,1,3,20,64,360,424,603.6666666666666
10602,2012-03-22,2,1,3,21,66,308,374,461.3333333333333
10603,2012-03-22,2,1,3,22,56,164,220,339.3333333333333
10604,2012-03-22,2,1,3,23,34,117,151,248.33333333333334
10605,2012-03-23,2,1,3,0,30,65,95,155.33333333333334
10606,2012-03-23,2,1,3,1,18,32,50,98.66666666666667
10607,2012-03-23,2,1,3,2,12,20,32,59.0
10608,2012-03-23,2,1,3,3,4,6,10,30.666666666666668
10609,2012-03-23,2,1,3,4,0,3,3,15.0
10610,2012-03-23,2,1,3,5,5,29,34,15.666666666666666
10611,2012-03-23,2,1,3,6,6,110,116,51.0
10612,2012-03-23,2,1,3,7,28,318,346,165.33333333333334
10613,2012-03-23,2,1,3,8,47,615,662,374.6666666666667
10614,2012-03-23,2,1,3,9,75,305,380,462.6666666666667
10615,2012-03-23,2,1,3,10,125,150,275,439.0
10616,2012-03-23,2,1,3,11,131,187,318,324.3333333333333
10617,2012-03-23,2,1,3,12,199,272,471,354.6666666666667
10618,2012-03-23,2,1,3,13,172,256,428,405.6666666666667
10619,2012-03-23,2,1,3,14,208,224,432,443.6666666666667
10620,2012-03-23,2,1,3,15,191,281,472,444.0
10621,2012-03-23,2,1,3,16,219,370,589,497.6666666666667
10622,2012-03-23,2,1,3,17,264,693,957,672.6666666666666
10623,2012-03-23,2,1,3,18,237,593,830,792.0
10624,2012-03-23,2,1,3,19,213,473,686,824.3333333333334
10625,2012-03-23,2,1,3,20,117,328,445,653.6666666666666
10626,2012-03-23,2,1,3,21,64,220,284,471.6666666666667
10627,2012-03-23,2,1,3,22,53,218,271,333.3333333333333
10628,2012-03-23,2,1,3,23,51,125,176,243.66666666666666
10629,2012-03-24,2,1,3,0,45,111,156,201.0
10630,2012-03-24,2,1,3,1,20,108,128,153.33333333333334
10631,2012-03-24,2,1,3,2,14,55,69,117.66666666666667
10632,2012-03-24,2,1,3,3,10,22,32,76.33333333333333
10633,2012-03-24,2,1,3,4,1,6,7,36.0
10634,2012-03-24,2,1,3,5,0,4,4,14.333333333333334
10635,2012-03-24,2,1,3,6,4,24,28,13.0
10636,2012-03-24,2,1,3,7,25,45,70,34.0
10637,2012-03-24,2,1,3,8,41,113,154,84.0
10638,2012-03-24,2,1,3,9,96,153,249,157.66666666666666
10639,2012-03-24,2,1,3,10,148,197,345,249.33333333333334
10640,2012-03-24,2,1,3,11,98,175,273,289.0
10641,2012-03-24,2,1,3,12,61,122,183,267.0
10642,2012-03-24,2,1,3,13,62,134,196,217.33333333333334
10643,2012-03-24,2,1,3,14,63,160,223,200.66666666666666
10644,2012-03-24,2,1,3,15,118,172,290,236.33333333333334
10645,2012-03-24,2,1,3,16,49,128,177,230.0
10646,2012-03-24,2,1,3,17,47,68,115,194.0
10647,2012-03-24,2,1,3,18,27,110,137,143.0
10648,2012-03-24,2,1,3,19,28,105,133,128.33333333333334
10649,2012-03-24,2,1,3,20,31,80,111,127.0
10650,2012-03-24,2,1,3,21,16,88,104,116.0
10651,2012-03-24,2,1,3,22,12,71,83,99.33333333333333
10652,2012-03-24,2,1,3,23,17,88,105,97.33333333333333
10653,2012-03-25,2,1,3,0,18,62,80,89.33333333333333
10654,2012-03-25,2,1,3,1,24,65,89,91.33333333333333
10655,2012-03-25,2,1,3,2,6,29,35,68.0
10656,2012-03-25,2,1,3,3,8,10,18,47.333333333333336
10657,2012-03-25,2,1,3,4,1,7,8,20.333333333333332
10658,2012-03-25,2,1,3,5,0,6,6,10.666666666666666
10659,2012-03-25,2,1,3,6,5,13,18,10.666666666666666
10660,2012-03-25,2,1,3,7,14,25,39,21.0
10661,2012-03-25,2,1,3,8,21,68,89,48.666666666666664
10662,2012-03-25,2,1,3,9,26,92,118,82.0
10663,2012-03-25,2,1,3,10,78,172,250,152.33333333333334
10664,2012-03-25,2,1,3,11,106,217,323,230.33333333333334
10665,2012-03-25,2,1,3,12,122,238,360,311.0
10666,2012-03-25,2,1,3,13,110,257,367,350.0
10667,2012-03-25,2,1,3,14,123,291,414,380.3333333333333
10668,2012-03-25,2,1,3,15,139,282,421,400.6666666666667
10669,2012-03-25,2,1,3,16,153,339,492,442.3333333333333
10670,2012-03-25,2,1,3,17,146,273,419,444.0
10671,2012-03-25,2,1,3,18,202,289,491,467.3333333333333
10672,2012-03-25,2,1,3,19,114,261,375,428.3333333333333
10673,2012-03-25,2,1,3,20,63,196,259,375.0
10674,2012-03-25,2,1,3,21,25,124,149,261.0
10675,2012-03-25,2,1,3,22,19,92,111,173.0
10676,2012-03-25,2,1,3,23,9,56,65,108.33333333333333
10677,2012-03-26,2,1,3,0,10,23,33,69.66666666666667
10678,2012-03-26,2,1,3,1,18,10,28,42.0
10679,2012-03-26,2,1,3,2,14,6,20,27.0
10680,2012-03-26,2,1,3,3,0,1,1,16.333333333333332
10681,2012-03-26,2,1,3,4,0,4,4,8.333333333333334
10682,2012-03-26,2,1,3,5,0,36,36,13.666666666666666
10683,2012-03-26,2,1,3,6,7,110,117,52.333333333333336
10684,2012-03-26,2,1,3,7,15,355,370,174.33333333333334
10685,2012-03-26,2,1,3,8,32,625,657,381.3333333333333
10686,2012-03-26,2,1,3,9,37,245,282,436.3333333333333
10687,2012-03-26,2,1,3,10,55,98,153,364.0
10688,2012-03-26,2,1,3,11,47,131,178,204.33333333333334
10689,2012-03-26,2,1,3,12,63,216,279,203.33333333333334
10690,2012-03-26,2,1,3,13,79,222,301,252.66666666666666
10691,2012-03-26,2,1,3,14,58,159,217,265.6666666666667
10692,2012-03-26,2,1,3,15,66,157,223,247.0
10693,2012-03-26,2,1,3,16,60,245,305,248.33333333333334
10694,2012-03-26,2,1,3,17,65,599,664,397.3333333333333
10695,2012-03-26,2,1,3,18,90,594,684,551.0
10696,2012-03-26,2,1,3,19,41,417,458,602.0
10697,2012-03-26,2,1,3,20,12,209,221,454.3333333333333
10698,2012-03-26,2,1,3,21,11,175,186,288.3333333333333
10699,2012-03-26,2,1,3,22,13,80,93,166.66666666666666
10700,2012-03-26,2,1,3,23,2,46,48,109.0
10701,2012-03-27,2,1,3,0,1,9,10,50.333333333333336
10702,2012-03-27,2,1,3,1,1,4,5,21.0
10703,2012-03-27,2,1,3,2,1,6,7,7.333333333333333
10704,2012-03-27,2,1,3,3,0,4,4,5.333333333333333
10705,2012-03-27,2,1,3,4,0,3,3,4.666666666666667
10706,2012-03-27,2,1,3,5,1,16,17,8.0
10707,2012-03-27,2,1,3,6,5,96,101,40.333333333333336
10708,2012-03-27,2,1,3,7,9,277,286,134.66666666666666
10709,2012-03-27,2,1,3,8,14,567,581,322.6666666666667
10710,2012-03-27,2,1,3,9,8,259,267,378.0
10711,2012-03-27,2,1,3,10,20,118,138,328.6666666666667
10712,2012-03-27,2,1,3,11,34,141,175,193.33333333333334
10713,2012-03-27,2,1,3,12,34,186,220,177.66666666666666
10714,2012-03-27,2,1,3,13,46,165,211,202.0
10715,2012-03-27,2,1,3,14,37,147,184,205.0
10716,2012-03-27,2,1,3,15,42,158,200,198.33333333333334
10717,2012-03-27,2,1,3,16,38,267,305,229.66666666666666
10718,2012-03-27,2,1,3,17,72,542,614,373.0
10719,2012-03-27,2,1,3,18,67,577,644,521.0
10720,2012-03-27,2,1,3,19,40,377,417,558.3333333333334
10721,2012-03-27,2,1,3,20,28,266,294,451.6666666666667
10722,2012-03-27,2,1,3,21,21,200,221,310.6666666666667
10723,2012-03-27,2,1,3,22,7,127,134,216.33333333333334
10724,2012-03-27,2,1,3,23,5,59,64,139.66666666666666
10725,2012-03-28,2,1,3,0,1,29,30,76.0
10726,2012-03-28,2,1,3,1,0,8,8,34.0
10727,2012-03-28,2,1,3,2,0,3,3,13.666666666666666
10728,2012-03-28,2,1,3,3,1,4,5,5.333333333333333
10729,2012-03-28,2,1,3,4,1,0,1,3.0
10730,2012-03-28,2,1,3,5,2,38,40,15.333333333333334
10731,2012-03-28,2,1,3,6,4,111,115,52.0
10732,2012-03-28,2,1,3,7,10,348,358,171.0
10733,2012-03-28,2,1,3,8,19,639,658,377.0
10734,2012-03-28,2,1,3,9,16,298,314,443.3333333333333
10735,2012-03-28,2,1,3,10,33,140,173,381.6666666666667
10736,2012-03-28,2,1,3,11,54,168,222,236.33333333333334
10737,2012-03-28,2,1,3,12,50,218,268,221.0
10738,2012-03-28,2,1,3,13,60,213,273,254.33333333333334
10739,2012-03-28,2,1,3,14,52,169,221,254.0
10740,2012-03-28,2,1,3,15,47,152,199,231.0
10741,2012-03-28,2,1,3,16,51,170,221,213.66666666666666
10742,2012-03-28,2,1,3,17,72,532,604,341.3333333333333
10743,2012-03-28,2,1,3,18,61,580,641,488.6666666666667
10744,2012-03-28,2,1,3,19,41,415,456,567.0
10745,2012-03-28,2,1,3,20,38,324,362,486.3333333333333
10746,2012-03-28,2,1,3,21,28,233,261,359.6666666666667
10747,2012-03-28,2,1,3,22,21,151,172,265.0
10748,2012-03-28,2,1,3,23,12,81,93,175.33333333333334
10749,2012-03-29,2,1,3,0,10,38,48,104.33333333333333
10750,2012-03-29,2,1,3,1,15,18,33,58.0
10751,2012-03-29,2,1,3,2,0,6,6,29.0
10752,2012-03-29,2,1,3,3,1,4,5,14.666666666666666
10753,2012-03-29,2,1,3,4,1,8,9,6.666666666666667
10754,2012-03-29,2,1,3,5,2,30,32,15.333333333333334
10755,2012-03-29,2,1,3,6,3,114,117,52.666666666666664
10756,2012-03-29,2,1,3,7,14,353,367,172.0
10757,2012-03-29,2,1,3,8,26,628,654,379.3333333333333
10758,2012-03-29,2,1,3,9,22,299,321,447.3333333333333
10759,2012-03-29,2,1,3,10,42,124,166,380.3333333333333
10760,2012-03-29,2,1,3,11,54,166,220,235.66666666666666
10761,2012-03-29,2,1,3,12,64,228,292,226.0
10762,2012-03-29,2,1,3,13,50,223,273,261.6666666666667
10763,2012-03-29,2,1,3,14,63,175,238,267.6666666666667
10764,2012-03-29,2,1,3,15,109,198,307,272.6666666666667
10765,2012-03-29,2,1,3,16,67,321,388,311.0
10766,2012-03-29,2,1,3,17,83,620,703,466.0
10767,2012-03-29,2,1,3,18,83,598,681,590.6666666666666
10768,2012-03-29,2,1,3,19,47,421,468,617.3333333333334
10769,2012-03-29,2,1,3,20,34,301,335,494.6666666666667
10770,2012-03-29,2,1,3,21,10,214,224,342.3333333333333
10771,2012-03-29,2,1,3,22,17,135,152,237.0
10772,2012-03-29,2,1,3,23,17,77,94,156.66666666666666
10773,2012-03-30,2,1,3,0,10,49,59,101.66666666666667
10774,2012-03-30,2,1,3,1,6,21,27,60.0
10775,2012-03-30,2,1,3,2,1,6,7,31.0
10776,2012-03-30,2,1,3,3,0,7,7,13.666666666666666
10777,2012-03-30,2,1,3,4,1,1,2,5.333333333333333
10778,2012-03-30,2,1,3,5,0,26,26,11.666666666666666
10779,2012-03-30,2,1,3,6,5,81,86,38.0
10780,2012-03-30,2,1,3,7,9,280,289,133.66666666666666
10781,2012-03-30,2,1,3,8,38,555,593,322.6666666666667
10782,2012-03-30,2,1,3,9,29,292,321,401.0
10783,2012-03-30,2,1,3,10,50,137,187,367.0
10784,2012-03-30,2,1,3,11,48,153,201,236.33333333333334
10785,2012-03-30,2,1,3,12,62,208,270,219.33333333333334
10786,2012-03-30,2,1,3,13,44,198,242,237.66666666666666
10787,2012-03-30,2,1,3,14,56,173,229,247.0
10788,2012-03-30,2,1,3,15,73,207,280,250.33333333333334
10789,2012-03-30,2,1,3,16,75,292,367,292.0
10790,2012-03-30,2,1,3,17,93,513,606,417.6666666666667
10791,2012-03-30,2,1,3,18,68,492,560,511.0
10792,2012-03-30,2,1,3,19,42,353,395,520.3333333333334
10793,2012-03-30,2,1,3,20,17,192,209,388.0
10794,2012-03-30,2,1,3,21,30,190,220,274.6666666666667
10795,2012-03-30,2,1,3,22,23,130,153,194.0
10796,2012-03-30,2,1,3,23,16,107,123,165.33333333333334
10797,2012-03-31,2,1,3,0,12,80,92,122.66666666666667
10798,2012-03-31,2,1,3,1,17,65,82,99.0
10799,2012-03-31,2,1,3,2,14,55,69,81.0
10800,2012-03-31,2,1,3,3,10,21,31,60.666666666666664
10801,2012-03-31,2,1,3,4,4,4,8,36.0
10802,2012-03-31,2,1,3,5,0,5,5,14.666666666666666
10803,2012-03-31,2,1,3,6,7,16,23,12.0
10804,2012-03-31,2,1,3,7,5,39,44,24.0
10805,2012-03-31,2,1,3,8,19,126,145,70.66666666666667
10806,2012-03-31,2,1,3,9,62,161,223,137.33333333333334
10807,2012-03-31,2,1,3,10,108,205,313,227.0
10808,2012-03-31,2,1,3,11,184,279,463,333.0
10809,2012-03-31,2,1,3,12,263,358,621,465.6666666666667
10810,2012-03-31,2,1,3,13,265,373,638,574.0
10811,2012-03-31,2,1,3,14,240,311,551,603.3333333333334
10812,2012-03-31,2,1,3,15,275,330,605,598.0
10813,2012-03-31,2,1,3,16,243,292,535,563.6666666666666
10814,2012-03-31,2,1,3,17,238,305,543,561.0
10815,2012-03-31,2,1,3,18,102,239,341,473.0
10816,2012-03-31,2,1,3,19,93,191,284,389.3333333333333
10817,2012-03-31,2,1,3,20,52,156,208,277.6666666666667
10818,2012-03-31,2,1,3,21,36,107,143,211.66666666666666
10819,2012-03-31,2,1,3,22,40,116,156,169.0
10820,2012-03-31,2,1,3,23,12,100,112,137.0
10821,2012-04-01,2,1,4,0,8,59,67,111.66666666666667
10822,2012-04-01,2,1,4,1,13,49,62,80.33333333333333
10823,2012-04-01,2,1,4,2,20,61,81,70.0
10824,2012-04-01,2,1,4,3,4,21,25,56.0
10825,2012-04-01,2,1,4,4,3,9,12,39.333333333333336
10826,2012-04-01,2,1,4,5,8,10,18,18.333333333333332
10827,2012-04-01,2,1,4,6,9,88,97,42.333333333333336
10828,2012-04-01,2,1,4,7,29,55,84,66.33333333333333
10829,2012-04-01,2,1,4,8,37,88,125,102.0
10830,2012-04-01,2,1,4,9,102,173,275,161.33333333333334
10831,2012-04-01,2,1,4,10,132,228,360,253.33333333333334
10832,2012-04-01,2,1,4,11,180,271,451,362.0
10833,2012-04-01,2,1,4,12,187,258,445,418.6666666666667
10834,2012-04-01,2,1,4,13,190,274,464,453.3333333333333
10835,2012-04-01,2,1,4,14,283,278,561,490.0
10836,2012-04-01,2,1,4,15,295,278,573,532.6666666666666
10837,2012-04-01,2,1,4,16,236,275,511,548.3333333333334
10838,2012-04-01,2,1,4,17,232,323,555,546.3333333333334
10839,2012-04-01,2,1,4,18,153,279,432,499.3333333333333
10840,2012-04-01,2,1,4,19,110,236,346,444.3333333333333
10841,2012-04-01,2,1,4,20,66,166,232,336.6666666666667
10842,2012-04-01,2,1,4,21,33,101,134,237.33333333333334
10843,2012-04-01,2,1,4,22,7,61,68,144.66666666666666
10844,2012-04-01,2,1,4,23,10,53,63,88.33333333333333
10845,2012-04-02,2,1,4,0,6,11,17,49.333333333333336
10846,2012-04-02,2,1,4,1,0,5,5,28.333333333333332
10847,2012-04-02,2,1,4,2,2,3,5,9.0
10848,2012-04-02,2,1,4,4,2,2,4,4.666666666666667
10849,2012-04-02,2,1,4,5,2,22,24,11.0
10850,2012-04-02,2,1,4,6,6,104,110,46.0
10851,2012-04-02,2,1,4,7,12,294,306,146.66666666666666
10852,2012-04-02,2,1,4,8,36,553,589,335.0
10853,2012-04-02,2,1,4,9,52,265,317,404.0
10854,2012-04-02,2,1,4,10,85,119,204,370.0
10855,2012-04-02,2,1,4,11,81,128,209,243.33333333333334
10856,2012-04-02,2,1,4,12,100,181,281,231.33333333333334
10857,2012-04-02,2,1,4,13,97,184,281,257.0
10858,2012-04-02,2,1,4,14,127,141,268,276.6666666666667
10859,2012-04-02,2,1,4,15,132,192,324,291.0
10860,2012-04-02,2,1,4,16,104,291,395,329.0
10861,2012-04-02,2,1,4,17,128,601,729,482.6666666666667
10862,2012-04-02,2,1,4,18,75,543,618,580.6666666666666
10863,2012-04-02,2,1,4,19,66,428,494,613.6666666666666
10864,2012-04-02,2,1,4,20,48,281,329,480.3333333333333
10865,2012-04-02,2,1,4,21,24,214,238,353.6666666666667
10866,2012-04-02,2,1,4,22,17,106,123,230.0
10867,2012-04-02,2,1,4,23,6,60,66,142.33333333333334
10868,2012-04-03,2,1,4,0,1,32,33,74.0
10869,2012-04-03,2,1,4,1,0,11,11,36.666666666666664
10870,2012-04-03,2,1,4,2,0,5,5,16.333333333333332
10871,2012-04-03,2,1,4,3,0,3,3,6.333333333333333
10872,2012-04-03,2,1,4,4,0,1,1,3.0
10873,2012-04-03,2,1,4,5,2,25,27,10.333333333333334
10874,2012-04-03,2,1,4,6,2,98,100,42.666666666666664
10875,2012-04-03,2,1,4,7,14,327,341,156.0
10876,2012-04-03,2,1,4,8,27,577,604,348.3333333333333
10877,2012-04-03,2,1,4,9,54,354,408,451.0
10878,2012-04-03,2,1,4,10,77,142,219,410.3333333333333
10879,2012-04-03,2,1,4,11,91,167,258,295.0
10880,2012-04-03,2,1,4,12,101,230,331,269.3333333333333
10881,2012-04-03,2,1,4,13,120,225,345,311.3333333333333
10882,2012-04-03,2,1,4,14,120,191,311,329.0
10883,2012-04-03,2,1,4,15,109,207,316,324.0
10884,2012-04-03,2,1,4,16,145,340,485,370.6666666666667
10885,2012-04-03,2,1,4,17,123,634,757,519.3333333333334
10886,2012-04-03,2,1,4,18,139,661,800,680.6666666666666
10887,2012-04-03,2,1,4,19,98,460,558,705.0
10888,2012-04-03,2,1,4,20,54,325,379,579.0
10889,2012-04-03,2,1,4,21,33,210,243,393.3333333333333
10890,2012-04-03,2,1,4,22,25,133,158,260.0
10891,2012-04-03,2,1,4,23,13,66,79,160.0
10892,2012-04-04,2,1,4,0,18,23,41,92.66666666666667
10893,2012-04-04,2,1,4,1,0,11,11,43.666666666666664
10894,2012-04-04,2,1,4,2,0,5,5,19.0
10895,2012-04-04,2,1,4,3,0,3,3,6.333333333333333
10896,2012-04-04,2,1,4,4,0,1,1,3.0
10897,2012-04-04,2,1,4,5,0,27,27,10.333333333333334
10898,2012-04-04,2,1,4,6,6,120,126,51.333333333333336
10899,2012-04-04,2,1,4,7,12,354,366,173.0
10900,2012-04-04,2,1,4,8,31,653,684,392.0
10901,2012-04-04,2,1,4,9,47,316,363,471.0
10902,2012-04-04,2,1,4,10,68,99,167,404.6666666666667
10903,2012-04-04,2,1,4,11,61,152,213,247.66666666666666
10904,2012-04-04,2,1,4,12,73,210,283,221.0
10905,2012-04-04,2,1,4,13,70,181,251,249.0
10906,2012-04-04,2,1,4,14,82,176,258,264.0
10907,2012-04-04,2,1,4,15,86,182,268,259.0
10908,2012-04-04,2,1,4,16,86,304,390,305.3333333333333
10909,2012-04-04,2,1,4,17,99,645,744,467.3333333333333
10910,2012-04-04,2,1,4,18,113,646,759,631.0
10911,2012-04-04,2,1,4,19,75,419,494,665.6666666666666
10912,2012-04-04,2,1,4,20,39,333,372,541.6666666666666
10913,2012-04-04,2,1,4,21,43,255,298,388.0
10914,2012-04-04,2,1,4,22,30,151,181,283.6666666666667
10915,2012-04-04,2,1,4,23,19,112,131,203.33333333333334
10916,2012-04-05,2,1,4,0,12,33,45,119.0
10917,2012-04-05,2,1,4,1,4,9,13,63.0
10918,2012-04-05,2,1,4,2,7,11,18,25.333333333333332
10919,2012-04-05,2,1,4,3,0,5,5,12.0
10920,2012-04-05,2,1,4,4,0,1,1,8.0
10921,2012-04-05,2,1,4,5,1,28,29,11.666666666666666
10922,2012-04-05,2,1,4,6,8,118,126,52.0
10923,2012-04-05,2,1,4,7,15,339,354,169.66666666666666
10924,2012-04-05,2,1,4,8,28,610,638,372.6666666666667
10925,2012-04-05,2,1,4,9,61,290,351,447.6666666666667
10926,2012-04-05,2,1,4,10,88,158,246,411.6666666666667
10927,2012-04-05,2,1,4,11,109,159,268,288.3333333333333
10928,2012-04-05,2,1,4,12,66,210,276,263.3333333333333
10929,2012-04-05,2,1,4,13,89,202,291,278.3333333333333
10930,2012-04-05,2,1,4,14,143,144,287,284.6666666666667
10931,2012-04-05,2,1,4,15,98,171,269,282.3333333333333
10932,2012-04-05,2,1,4,16,84,318,402,319.3333333333333
10933,2012-04-05,2,1,4,17,145,677,822,497.6666666666667
10934,2012-04-05,2,1,4,18,80,618,698,640.6666666666666
10935,2012-04-05,2,1,4,19,64,423,487,669.0
10936,2012-04-05,2,1,4,20,33,279,312,499.0
10937,2012-04-05,2,1,4,21,25,209,234,344.3333333333333
10938,2012-04-05,2,1,4,22,20,129,149,231.66666666666666
10939,2012-04-05,2,1,4,23,12,124,136,173.0
10940,2012-04-06,2,1,4,0,12,49,61,115.33333333333333
10941,2012-04-06,2,1,4,1,10,28,38,78.33333333333333
10942,2012-04-06,2,1,4,2,6,5,11,36.666666666666664
10943,2012-04-06,2,1,4,3,3,5,8,19.0
10944,2012-04-06,2,1,4,4,2,3,5,8.0
10945,2012-04-06,2,1,4,5,0,23,23,12.0
10946,2012-04-06,2,1,4,6,0,80,80,36.0
10947,2012-04-06,2,1,4,7,15,231,246,116.33333333333333
10948,2012-04-06,2,1,4,8,19,489,508,278.0
10949,2012-04-06,2,1,4,9,58,318,376,376.6666666666667
10950,2012-04-06,2,1,4,10,81,157,238,374.0
10951,2012-04-06,2,1,4,11,112,179,291,301.6666666666667
10952,2012-04-06,2,1,4,12,113,224,337,288.6666666666667
10953,2012-04-06,2,1,4,13,173,238,411,346.3333333333333
10954,2012-04-06,2,1,4,14,240,250,490,412.6666666666667
10955,2012-04-06,2,1,4,15,218,319,537,479.3333333333333
10956,2012-04-06,2,1,4,16,184,352,536,521.0
10957,2012-04-06,2,1,4,17,172,483,655,576.0
10958,2012-04-06,2,1,4,18,104,380,484,558.3333333333334
10959,2012-04-06,2,1,4,19,115,297,412,517.0
10960,2012-04-06,2,1,4,20,61,191,252,382.6666666666667
10961,2012-04-06,2,1,4,21,54,136,190,284.6666666666667
10962,2012-04-06,2,1,4,22,34,124,158,200.0
10963,2012-04-06,2,1,4,23,21,92,113,153.66666666666666
10964,2012-04-07,2,1,4,0,9,85,94,121.66666666666667
10965,2012-04-07,2,1,4,1,9,60,69,92.0
10966,2012-04-07,2,1,4,2,11,25,36,66.33333333333333
10967,2012-04-07,2,1,4,3,7,21,28,44.333333333333336
10968,2012-04-07,2,1,4,4,3,4,7,23.666666666666668
10969,2012-04-07,2,1,4,5,0,2,2,12.333333333333334
10970,2012-04-07,2,1,4,6,1,18,19,9.333333333333334
10971,2012-04-07,2,1,4,7,14,40,54,25.0
10972,2012-04-07,2,1,4,8,29,94,123,65.33333333333333
10973,2012-04-07,2,1,4,9,103,173,276,151.0
10974,2012-04-07,2,1,4,10,187,176,363,254.0
10975,2012-04-07,2,1,4,11,251,244,495,378.0
10976,2012-04-07,2,1,4,12,320,270,590,482.6666666666667
10977,2012-04-07,2,1,4,13,355,288,643,576.0
10978,2012-04-07,2,1,4,14,326,252,578,603.6666666666666
10979,2012-04-07,2,1,4,15,321,305,626,615.6666666666666
10980,2012-04-07,2,1,4,16,354,261,615,606.3333333333334
10981,2012-04-07,2,1,4,17,299,268,567,602.6666666666666
10982,2012-04-07,2,1,4,18,227,290,517,566.3333333333334
10983,2012-04-07,2,1,4,19,170,243,413,499.0
10984,2012-04-07,2,1,4,20,73,135,208,379.3333333333333
10985,2012-04-07,2,1,4,21,75,159,234,285.0
10986,2012-04-07,2,1,4,22,76,106,182,208.0
10987,2012-04-07,2,1,4,23,32,86,118,178.0
10988,2012-04-08,2,1,4,0,21,64,85,128.33333333333334
10989,2012-04-08,2,1,4,1,14,50,64,89.0
10990,2012-04-08,2,1,4,2,7,25,32,60.333333333333336
10991,2012-04-08,2,1,4,3,8,18,26,40.666666666666664
10992,2012-04-08,2,1,4,4,0,7,7,21.666666666666668
10993,2012-04-08,2,1,4,5,4,8,12,15.0
10994,2012-04-08,2,1,4,6,7,21,28,15.666666666666666
10995,2012-04-08,2,1,4,7,12,25,37,25.666666666666668
10996,2012-04-08,2,1,4,8,19,65,84,49.666666666666664
10997,2012-04-08,2,1,4,9,71,108,179,100.0
10998,2012-04-08,2,1,4,10,113,186,299,187.33333333333334
10999,2012-04-08,2,1,4,11,195,209,404,294.0
11000,2012-04-08,2,1,4,12,198,259,457,386.6666666666667
11001,2012-04-08,2,1,4,13,229,254,483,448.0
11002,2012-04-08,2,1,4,14,254,249,503,481.0
11003,2012-04-08,2,1,4,15,260,226,486,490.6666666666667
11004,2012-04-08,2,1,4,16,232,244,476,488.3333333333333
11005,2012-04-08,2,1,4,17,185,226,411,457.6666666666667
11006,2012-04-08,2,1,4,18,151,159,310,399.0
11007,2012-04-08,2,1,4,19,89,187,276,332.3333333333333
11008,2012-04-08,2,1,4,20,65,146,211,265.6666666666667
11009,2012-04-08,2,1,4,21,53,77,130,205.66666666666666
11010,2012-04-08,2,1,4,22,33,85,118,153.0
11011,2012-04-08,2,1,4,23,10,41,51,99.66666666666667
11012,2012-04-09,2,1,4,0,8,29,37,68.66666666666667
11013,2012-04-09,2,1,4,1,4,12,16,34.666666666666664
11014,2012-04-09,2,1,4,2,2,4,6,19.666666666666668
11015,2012-04-09,2,1,4,3,0,3,3,8.333333333333334
11016,2012-04-09,2,1,4,4,2,3,5,4.666666666666667
11017,2012-04-09,2,1,4,5,2,30,32,13.333333333333334
11018,2012-04-09,2,1,4,6,3,108,111,49.333333333333336
11019,2012-04-09,2,1,4,7,11,320,331,158.0
11020,2012-04-09,2,1,4,8,22,595,617,353.0
11021,2012-04-09,2,1,4,9,50,236,286,411.3333333333333
11022,2012-04-09,2,1,4,10,65,113,178,360.3333333333333
11023,2012-04-09,2,1,4,11,96,127,223,229.0
11024,2012-04-09,2,1,4,12,94,186,280,227.0
11025,2012-04-09,2,1,4,13,108,173,281,261.3333333333333
11026,2012-04-09,2,1,4,14,66,152,218,259.6666666666667
11027,2012-04-09,2,1,4,15,82,173,255,251.33333333333334
11028,2012-04-09,2,1,4,16,81,310,391,288.0
11029,2012-04-09,2,1,4,17,67,565,632,426.0
11030,2012-04-09,2,1,4,18,60,586,646,556.3333333333334
11031,2012-04-09,2,1,4,19,35,386,421,566.3333333333334
11032,2012-04-09,2,1,4,20,21,255,276,447.6666666666667
11033,2012-04-09,2,1,4,21,14,151,165,287.3333333333333
11034,2012-04-09,2,1,4,22,6,102,108,183.0
11035,2012-04-09,2,1,4,23,6,61,67,113.33333333333333
11036,2012-04-10,2,1,4,0,3,23,26,67.0
11037,2012-04-10,2,1,4,1,0,9,9,34.0
11038,2012-04-10,2,1,4,2,0,2,2,12.333333333333334
11039,2012-04-10,2,1,4,3,0,2,2,4.333333333333333
11040,2012-04-10,2,1,4,4,0,2,2,2.0
11041,2012-04-10,2,1,4,5,0,24,24,9.333333333333334
11042,2012-04-10,2,1,4,6,3,100,103,43.0
11043,2012-04-10,2,1,4,7,16,368,384,170.33333333333334
11044,2012-04-10,2,1,4,8,22,670,692,393.0
11045,2012-04-10,2,1,4,9,16,303,319,465.0
11046,2012-04-10,2,1,4,10,49,132,181,397.3333333333333
11047,2012-04-10,2,1,4,11,78,161,239,246.33333333333334
11048,2012-04-10,2,1,4,12,75,184,259,226.33333333333334
11049,2012-04-10,2,1,4,13,81,202,283,260.3333333333333
11050,2012-04-10,2,1,4,14,75,149,224,255.33333333333334
11051,2012-04-10,2,1,4,15,46,157,203,236.66666666666666
11052,2012-04-10,2,1,4,16,66,296,362,263.0
11053,2012-04-10,2,1,4,17,88,656,744,436.3333333333333
11054,2012-04-10,2,1,4,18,78,626,704,603.3333333333334
11055,2012-04-10,2,1,4,19,51,428,479,642.3333333333334
11056,2012-04-10,2,1,4,20,34,248,282,488.3333333333333
11057,2012-04-10,2,1,4,21,15,191,206,322.3333333333333
11058,2012-04-10,2,1,4,22,9,118,127,205.0
11059,2012-04-10,2,1,4,23,14,48,62,131.66666666666666
11060,2012-04-11,2,1,4,0,8,22,30,73.0
11061,2012-04-11,2,1,4,1,3,9,12,34.666666666666664
11062,2012-04-11,2,1,4,2,0,2,2,14.666666666666666
11063,2012-04-11,2,1,4,3,0,2,2,5.333333333333333
11064,2012-04-11,2,1,4,5,1,26,27,10.333333333333334
11065,2012-04-11,2,1,4,6,3,103,106,45.0
11066,2012-04-11,2,1,4,7,18,303,321,151.33333333333334
11067,2012-04-11,2,1,4,8,14,581,595,340.6666666666667
11068,2012-04-11,2,1,4,9,20,282,302,406.0
11069,2012-04-11,2,1,4,10,26,127,153,350.0
11070,2012-04-11,2,1,4,11,38,142,180,211.66666666666666
11071,2012-04-11,2,1,4,12,35,147,182,171.66666666666666
11072,2012-04-11,2,1,4,13,16,147,163,175.0
11073,2012-04-11,2,1,4,14,34,101,135,160.0
11074,2012-04-11,2,1,4,15,50,152,202,166.66666666666666
11075,2012-04-11,2,1,4,16,51,256,307,214.66666666666666
11076,2012-04-11,2,1,4,17,52,527,579,362.6666666666667
11077,2012-04-11,2,1,4,18,39,546,585,490.3333333333333
11078,2012-04-11,2,1,4,19,28,356,384,516.0
11079,2012-04-11,2,1,4,20,22,213,235,401.3333333333333
11080,2012-04-11,2,1,4,21,11,154,165,261.3333333333333
11081,2012-04-11,2,1,4,22,4,130,134,178.0
11082,2012-04-11,2,1,4,23,9,52,61,120.0
11083,2012-04-12,2,1,4,0,1,22,23,72.66666666666667
11084,2012-04-12,2,1,4,1,2,7,9,31.0
11085,2012-04-12,2,1,4,2,0,4,4,12.0
11086,2012-04-12,2,1,4,3,2,3,5,6.0
11087,2012-04-12,2,1,4,4,0,1,1,3.3333333333333335
11088,2012-04-12,2,1,4,5,0,21,21,9.0
11089,2012-04-12,2,1,4,6,2,94,96,39.333333333333336
11090,2012-04-12,2,1,4,7,12,294,306,141.0
11091,2012-04-12,2,1,4,8,20,604,624,342.0
11092,2012-04-12,2,1,4,9,16,271,287,405.6666666666667
11093,2012-04-12,2,1,4,10,38,103,141,350.6666666666667
11094,2012-04-12,2,1,4,11,50,174,224,217.33333333333334
11095,2012-04-12,2,1,4,12,60,199,259,208.0
11096,2012-04-12,2,1,4,13,55,148,203,228.66666666666666
11097,2012-04-12,2,1,4,14,74,150,224,228.66666666666666
11098,2012-04-12,2,1,4,15,42,169,211,212.66666666666666
11099,2012-04-12,2,1,4,16,54,299,353,262.6666666666667
11100,2012-04-12,2,1,4,17,60,596,656,406.6666666666667
11101,2012-04-12,2,1,4,18,63,547,610,539.6666666666666
11102,2012-04-12,2,1,4,19,50,383,433,566.3333333333334
11103,2012-04-12,2,1,4,20,26,254,280,441.0
11104,2012-04-12,2,1,4,21,13,174,187,300.0
11105,2012-04-12,2,1,4,22,15,143,158,208.33333333333334
11106,2012-04-12,2,1,4,23,8,86,94,146.33333333333334
11107,2012-04-13,2,1,4,0,14,41,55,102.33333333333333
11108,2012-04-13,2,1,4,1,2,28,30,59.666666666666664
11109,2012-04-13,2,1,4,2,6,5,11,32.0
11110,2012-04-13,2,1,4,3,3,8,11,17.333333333333332
11111,2012-04-13,2,1,4,4,1,4,5,9.0
11112,2012-04-13,2,1,4,5,2,19,21,12.333333333333334
11113,2012-04-13,2,1,4,6,0,84,84,36.666666666666664
11114,2012-04-13,2,1,4,7,13,283,296,133.66666666666666
11115,2012-04-13,2,1,4,8,24,539,563,314.3333333333333
11116,2012-04-13,2,1,4,9,36,294,330,396.3333333333333
11117,2012-04-13,2,1,4,10,59,133,192,361.6666666666667
11118,2012-04-13,2,1,4,11,75,158,233,251.66666666666666
11119,2012-04-13,2,1,4,12,104,218,322,249.0
11120,2012-04-13,2,1,4,13,112,246,358,304.3333333333333
11121,2012-04-13,2,1,4,14,125,223,348,342.6666666666667
11122,2012-04-13,2,1,4,15,115,237,352,352.6666666666667
11123,2012-04-13,2,1,4,16,113,350,463,387.6666666666667
11124,2012-04-13,2,1,4,17,117,621,738,517.6666666666666
11125,2012-04-13,2,1,4,18,107,564,671,624.0
11126,2012-04-13,2,1,4,19,75,352,427,612.0
11127,2012-04-13,2,1,4,20,44,242,286,461.3333333333333
11128,2012-04-13,2,1,4,21,36,153,189,300.6666666666667
11129,2012-04-13,2,1,4,22,34,181,215,230.0
11130,2012-04-13,2,1,4,23,35,163,198,200.66666666666666
11131,2012-04-14,2,1,4,0,11,85,96,169.66666666666666
11132,2012-04-14,2,1,4,1,10,60,70,121.33333333333333
11133,2012-04-14,2,1,4,2,3,53,56,74.0
11134,2012-04-14,2,1,4,3,6,26,32,52.666666666666664
11135,2012-04-14,2,1,4,4,5,9,14,34.0
11136,2012-04-14,2,1,4,5,2,5,7,17.666666666666668
11137,2012-04-14,2,1,4,6,2,19,21,14.0
11138,2012-04-14,2,1,4,7,8,56,64,30.666666666666668
11139,2012-04-14,2,1,4,8,24,136,160,81.66666666666667
11140,2012-04-14,2,1,4,9,59,206,265,163.0
11141,2012-04-14,2,1,4,10,139,267,406,277.0
11142,2012-04-14,2,1,4,11,207,357,564,411.6666666666667
11143,2012-04-14,2,1,4,12,274,404,678,549.3333333333334
11144,2012-04-14,2,1,4,13,308,370,678,640.0
11145,2012-04-14,2,1,4,14,288,372,660,672.0
11146,2012-04-14,2,1,4,15,311,347,658,665.3333333333334
11147,2012-04-14,2,1,4,16,253,329,582,633.3333333333334
11148,2012-04-14,2,1,4,17,251,309,560,600.0
11149,2012-04-14,2,1,4,18,197,284,481,541.0
11150,2012-04-14,2,1,4,19,163,296,459,500.0
11151,2012-04-14,2,1,4,20,112,209,321,420.3333333333333
11152,2012-04-14,2,1,4,21,53,167,220,333.3333333333333
11153,2012-04-14,2,1,4,22,64,148,212,251.0
11154,2012-04-14,2,1,4,23,45,151,196,209.33333333333334
11155,2012-04-15,2,1,4,0,30,94,124,177.33333333333334
11156,2012-04-15,2,1,4,1,17,89,106,142.0
11157,2012-04-15,2,1,4,2,20,54,74,101.33333333333333
11158,2012-04-15,2,1,4,3,18,27,45,75.0
11159,2012-04-15,2,1,4,4,2,10,12,43.666666666666664
11160,2012-04-15,2,1,4,5,4,6,10,22.333333333333332
11161,2012-04-15,2,1,4,6,5,11,16,12.666666666666666
11162,2012-04-15,2,1,4,7,16,30,46,24.0
11163,2012-04-15,2,1,4,8,33,64,97,53.0
11164,2012-04-15,2,1,4,9,97,154,251,131.33333333333334
11165,2012-04-15,2,1,4,10,186,235,421,256.3333333333333
11166,2012-04-15,2,1,4,11,227,301,528,400.0
11167,2012-04-15,2,1,4,12,275,360,635,528.0
11168,2012-04-15,2,1,4,13,298,383,681,614.6666666666666
11169,2012-04-15,2,1,4,14,282,346,628,648.0
11170,2012-04-15,2,1,4,15,266,351,617,642.0
11171,2012-04-15,2,1,4,16,286,330,616,620.3333333333334
11172,2012-04-15,2,1,4,17,262,361,623,618.6666666666666
11173,2012-04-15,2,1,4,18,184,295,479,572.6666666666666
11174,2012-04-15,2,1,4,19,114,265,379,493.6666666666667
11175,2012-04-15,2,1,4,20,86,205,291,383.0
11176,2012-04-15,2,1,4,21,76,153,229,299.6666666666667
11177,2012-04-15,2,1,4,22,37,97,134,218.0
11178,2012-04-15,2,1,4,23,25,65,90,151.0
11179,2012-04-16,2,1,4,0,15,26,41,88.33333333333333
11180,2012-04-16,2,1,4,1,7,21,28,53.0
11181,2012-04-16,2,1,4,2,5,9,14,27.666666666666668
11182,2012-04-16,2,1,4,3,3,5,8,16.666666666666668
11183,2012-04-16,2,1,4,4,0,6,6,9.333333333333334
11184,2012-04-16,2,1,4,5,4,34,38,17.333333333333332
11185,2012-04-16,2,1,4,6,10,123,133,59.0
11186,2012-04-16,2,1,4,7,20,367,387,186.0
11187,2012-04-16,2,1,4,8,48,549,597,372.3333333333333
11188,2012-04-16,2,1,4,9,59,238,297,427.0
11189,2012-04-16,2,1,4,10,75,149,224,372.6666666666667
11190,2012-04-16,2,1,4,11,115,136,251,257.3333333333333
11191,2012-04-16,2,1,4,12,75,196,271,248.66666666666666
11192,2012-04-16,2,1,4,13,79,184,263,261.6666666666667
11193,2012-04-16,2,1,4,14,105,183,288,274.0
11194,2012-04-16,2,1,4,15,81,194,275,275.3333333333333
11195,2012-04-16,2,1,4,16,92,266,358,307.0
11196,2012-04-16,2,1,4,17,111,601,712,448.3333333333333
11197,2012-04-16,2,1,4,18,87,589,676,582.0
11198,2012-04-16,2,1,4,19,61,461,522,636.6666666666666
11199,2012-04-16,2,1,4,20,48,327,375,524.3333333333334
11200,2012-04-16,2,1,4,21,39,232,271,389.3333333333333
11201,2012-04-16,2,1,4,22,35,179,214,286.6666666666667
11202,2012-04-16,2,1,4,23,24,97,121,202.0
11203,2012-04-17,2,1,4,0,10,33,43,126.0
11204,2012-04-17,2,1,4,1,6,5,11,58.333333333333336
11205,2012-04-17,2,1,4,2,1,3,4,19.333333333333332
11206,2012-04-17,2,1,4,3,0,6,6,7.0
11207,2012-04-17,2,1,4,4,3,6,9,6.333333333333333
11208,2012-04-17,2,1,4,5,1,29,30,15.0
11209,2012-04-17,2,1,4,6,8,136,144,61.0
11210,2012-04-17,2,1,4,7,18,443,461,211.66666666666666
11211,2012-04-17,2,1,4,8,42,631,673,426.0
11212,2012-04-17,2,1,4,9,71,329,400,511.3333333333333
11213,2012-04-17,2,1,4,10,52,165,217,430.0
11214,2012-04-17,2,1,4,11,65,174,239,285.3333333333333
11215,2012-04-17,2,1,4,12,65,179,244,233.33333333333334
11216,2012-04-17,2,1,4,13,52,187,239,240.66666666666666
11217,2012-04-17,2,1,4,14,59,198,257,246.66666666666666
11218,2012-04-17,2,1,4,15,91,217,308,268.0
11219,2012-04-17,2,1,4,16,50,320,370,311.6666666666667
11220,2012-04-17,2,1,4,17,108,673,781,486.3333333333333
11221,2012-04-17,2,1,4,18,105,670,775,642.0
11222,2012-04-17,2,1,4,19,73,464,537,697.6666666666666
11223,2012-04-17,2,1,4,20,44,358,402,571.3333333333334
11224,2012-04-17,2,1,4,21,37,260,297,412.0
11225,2012-04-17,2,1,4,22,18,144,162,287.0
11226,2012-04-17,2,1,4,23,10,72,82,180.33333333333334
11227,2012-04-18,2,1,4,0,3,35,38,94.0
11228,2012-04-18,2,1,4,1,1,13,14,44.666666666666664
11229,2012-04-18,2,1,4,2,1,8,9,20.333333333333332
11230,2012-04-18,2,1,4,3,0,6,6,9.666666666666666
11231,2012-04-18,2,1,4,4,0,7,7,7.333333333333333
11232,2012-04-18,2,1,4,5,0,34,34,15.666666666666666
11233,2012-04-18,2,1,4,6,6,128,134,58.333333333333336
11234,2012-04-18,2,1,4,7,10,408,418,195.33333333333334
11235,2012-04-18,2,1,4,8,25,551,576,376.0
11236,2012-04-18,2,1,4,9,20,245,265,419.6666666666667
11237,2012-04-18,2,1,4,10,31,116,147,329.3333333333333
11238,2012-04-18,2,1,4,11,14,105,119,177.0
11239,2012-04-18,2,1,4,12,15,95,110,125.33333333333333
11240,2012-04-18,2,1,4,13,13,51,64,97.66666666666667
11241,2012-04-18,2,1,4,14,8,43,51,75.0
11242,2012-04-18,2,1,4,15,10,88,98,71.0
11243,2012-04-18,2,1,4,16,36,199,235,128.0
11244,2012-04-18,2,1,4,17,46,442,488,273.6666666666667
11245,2012-04-18,2,1,4,18,27,478,505,409.3333333333333
11246,2012-04-18,2,1,4,19,26,342,368,453.6666666666667
11247,2012-04-18,2,1,4,20,8,252,260,377.6666666666667
11248,2012-04-18,2,1,4,21,24,165,189,272.3333333333333
11249,2012-04-18,2,1,4,22,9,153,162,203.66666666666666
11250,2012-04-18,2,1,4,23,14,56,70,140.33333333333334
11251,2012-04-19,2,1,4,0,5,20,25,85.66666666666667
11252,2012-04-19,2,1,4,1,2,11,13,36.0
11253,2012-04-19,2,1,4,2,2,4,6,14.666666666666666
11254,2012-04-19,2,1,4,3,1,3,4,7.666666666666667
11255,2012-04-19,2,1,4,4,0,4,4,4.666666666666667
11256,2012-04-19,2,1,4,5,0,30,30,12.666666666666666
11257,2012-04-19,2,1,4,6,4,116,120,51.333333333333336
11258,2012-04-19,2,1,4,7,15,391,406,185.33333333333334
11259,2012-04-19,2,1,4,8,26,651,677,401.0
11260,2012-04-19,2,1,4,9,31,270,301,461.3333333333333
11261,2012-04-19,2,1,4,10,46,143,189,389.0
11262,2012-04-19,2,1,4,11,46,183,229,239.66666666666666
11263,2012-04-19,2,1,4,12,51,213,264,227.33333333333334
11264,2012-04-19,2,1,4,13,52,186,238,243.66666666666666
11265,2012-04-19,2,1,4,14,54,183,237,246.33333333333334
11266,2012-04-19,2,1,4,15,66,196,262,245.66666666666666
11267,2012-04-19,2,1,4,16,63,324,387,295.3333333333333
11268,2012-04-19,2,1,4,17,85,663,748,465.6666666666667
11269,2012-04-19,2,1,4,18,99,677,776,637.0
11270,2012-04-19,2,1,4,19,70,516,586,703.3333333333334
11271,2012-04-19,2,1,4,20,52,352,404,588.6666666666666
11272,2012-04-19,2,1,4,21,27,240,267,419.0
11273,2012-04-19,2,1,4,22,29,219,248,306.3333333333333
11274,2012-04-19,2,1,4,23,20,124,144,219.66666666666666
11275,2012-04-20,2,1,4,0,5,59,64,152.0
11276,2012-04-20,2,1,4,1,3,22,25,77.66666666666667
11277,2012-04-20,2,1,4,2,3,18,21,36.666666666666664
11278,2012-04-20,2,1,4,3,1,9,10,18.666666666666668
11279,2012-04-20,2,1,4,4,0,3,3,11.333333333333334
11280,2012-04-20,2,1,4,5,1,24,25,12.666666666666666
11281,2012-04-20,2,1,4,6,8,105,113,47.0
11282,2012-04-20,2,1,4,7,9,350,359,165.66666666666666
11283,2012-04-20,2,1,4,8,32,668,700,390.6666666666667
11284,2012-04-20,2,1,4,9,30,329,359,472.6666666666667
11285,2012-04-20,2,1,4,10,67,170,237,432.0
11286,2012-04-20,2,1,4,11,64,190,254,283.3333333333333
11287,2012-04-20,2,1,4,12,102,260,362,284.3333333333333
11288,2012-04-20,2,1,4,13,105,276,381,332.3333333333333
11289,2012-04-20,2,1,4,14,156,238,394,379.0
11290,2012-04-20,2,1,4,15,145,262,407,394.0
11291,2012-04-20,2,1,4,16,151,429,580,460.3333333333333
11292,2012-04-20,2,1,4,17,122,697,819,602.0
11293,2012-04-20,2,1,4,18,110,558,668,689.0
11294,2012-04-20,2,1,4,19,82,410,492,659.6666666666666
11295,2012-04-20,2,1,4,20,52,289,341,500.3333333333333
11296,2012-04-20,2,1,4,21,35,252,287,373.3333333333333
11297,2012-04-20,2,1,4,22,26,176,202,276.6666666666667
11298,2012-04-20,2,1,4,23,31,156,187,225.33333333333334
11299,2012-04-21,2,1,4,0,31,111,142,177.0
11300,2012-04-21,2,1,4,1,24,64,88,139.0
11301,2012-04-21,2,1,4,2,12,69,81,103.66666666666667
11302,2012-04-21,2,1,4,3,4,25,29,66.0
11303,2012-04-21,2,1,4,4,0,9,9,39.666666666666664
11304,2012-04-21,2,1,4,5,0,1,1,13.0
11305,2012-04-21,2,1,4,6,10,21,31,13.666666666666666
11306,2012-04-21,2,1,4,7,21,55,76,36.0
11307,2012-04-21,2,1,4,8,52,149,201,102.66666666666667
11308,2012-04-21,2,1,4,9,115,216,331,202.66666666666666
11309,2012-04-21,2,1,4,10,183,299,482,338.0
11310,2012-04-21,2,1,4,11,260,348,608,473.6666666666667
11311,2012-04-21,2,1,4,12,262,378,640,576.6666666666666
11312,2012-04-21,2,1,4,13,291,358,649,632.3333333333334
11313,2012-04-21,2,1,4,14,278,331,609,632.6666666666666
11314,2012-04-21,2,1,4,15,267,361,628,628.6666666666666
11315,2012-04-21,2,1,4,16,267,372,639,625.3333333333334
11316,2012-04-21,2,1,4,17,259,309,568,611.6666666666666
11317,2012-04-21,2,1,4,18,133,283,416,541.0
11318,2012-04-21,2,1,4,19,9,45,54,346.0
11319,2012-04-21,2,1,4,20,5,34,39,169.66666666666666
11320,2012-04-21,2,1,4,21,20,82,102,65.0
11321,2012-04-21,2,1,4,22,20,90,110,83.66666666666667
11322,2012-04-21,2,1,4,23,18,73,91,101.0
11323,2012-04-22,2,1,4,0,32,85,117,106.0
11324,2012-04-22,2,1,4,1,10,63,73,93.66666666666667
11325,2012-04-22,2,1,4,2,7,49,56,82.0
11326,2012-04-22,2,1,4,3,7,33,40,56.333333333333336
11327,2012-04-22,2,1,4,4,0,7,7,34.333333333333336
11328,2012-04-22,2,1,4,5,0,6,6,17.666666666666668
11329,2012-04-22,2,1,4,6,6,6,12,8.333333333333334
11330,2012-04-22,2,1,4,7,2,22,24,14.0
11331,2012-04-22,2,1,4,8,8,43,51,29.0
11332,2012-04-22,2,1,4,9,8,71,79,51.333333333333336
11333,2012-04-22,2,1,4,10,11,57,68,66.0
11334,2012-04-22,2,1,4,11,7,70,77,74.66666666666667
11335,2012-04-22,2,1,4,12,5,56,61,68.66666666666667
11336,2012-04-22,2,1,4,13,5,47,52,63.333333333333336
11337,2012-04-22,2,1,4,14,3,50,53,55.333333333333336
11338,2012-04-22,2,1,4,15,0,38,38,47.666666666666664
11339,2012-04-22,2,1,4,16,4,32,36,42.333333333333336
11340,2012-04-22,2,1,4,17,2,25,27,33.666666666666664
11341,2012-04-22,2,1,4,18,1,38,39,34.0
11342,2012-04-22,2,1,4,19,1,34,35,33.666666666666664
11343,2012-04-22,2,1,4,20,1,34,35,36.333333333333336
11344,2012-04-22,2,1,4,21,0,11,11,27.0
11345,2012-04-22,2,1,4,22,0,13,13,19.666666666666668
11346,2012-04-22,2,1,4,23,0,17,17,13.666666666666666
11347,2012-04-23,2,1,4,0,0,6,6,12.0
11348,2012-04-23,2,1,4,1,1,1,2,8.333333333333334
11349,2012-04-23,2,1,4,2,1,3,4,4.0
11350,2012-04-23,2,1,4,3,0,1,1,2.3333333333333335
11351,2012-04-23,2,1,4,4,0,3,3,2.6666666666666665
11352,2012-04-23,2,1,4,5,0,14,14,6.0
11353,2012-04-23,2,1,4,6,2,43,45,20.666666666666668
11354,2012-04-23,2,1,4,7,1,206,207,88.66666666666667
11355,2012-04-23,2,1,4,8,11,471,482,244.66666666666666
11356,2012-04-23,2,1,4,9,17,255,272,320.3333333333333
11357,2012-04-23,2,1,4,10,12,88,100,284.6666666666667
11358,2012-04-23,2,1,4,11,10,91,101,157.66666666666666
11359,2012-04-23,2,1,4,12,12,117,129,110.0
11360,2012-04-23,2,1,4,13,9,98,107,112.33333333333333
11361,2012-04-23,2,1,4,14,12,102,114,116.66666666666667
11362,2012-04-23,2,1,4,15,11,101,112,111.0
11363,2012-04-23,2,1,4,16,10,93,103,109.66666666666667
11364,2012-04-23,2,1,4,17,13,219,232,149.0
11365,2012-04-23,2,1,4,18,10,369,379,238.0
11366,2012-04-23,2,1,4,19,11,287,298,303.0
11367,2012-04-23,2,1,4,20,17,186,203,293.3333333333333
11368,2012-04-23,2,1,4,21,7,145,152,217.66666666666666
11369,2012-04-23,2,1,4,22,18,71,89,148.0
11370,2012-04-23,2,1,4,23,10,49,59,100.0
11371,2012-04-24,2,1,4,0,0,13,13,53.666666666666664
11372,2012-04-24,2,1,4,1,1,6,7,26.333333333333332
11373,2012-04-24,2,1,4,2,0,3,3,7.666666666666667
11374,2012-04-24,2,1,4,3,0,2,2,4.0
11375,2012-04-24,2,1,4,4,0,3,3,2.6666666666666665
11376,2012-04-24,2,1,4,5,0,22,22,9.0
11377,2012-04-24,2,1,4,6,3,117,120,48.333333333333336
11378,2012-04-24,2,1,4,7,3,387,390,177.33333333333334
11379,2012-04-24,2,1,4,8,12,599,611,373.6666666666667
11380,2012-04-24,2,1,4,9,6,302,308,436.3333333333333
11381,2012-04-24,2,1,4,10,33,129,162,360.3333333333333
11382,2012-04-24,2,1,4,11,27,157,184,218.0
11383,2012-04-24,2,1,4,12,36,188,224,190.0
11384,2012-04-24,2,1,4,13,35,189,224,210.66666666666666
11385,2012-04-24,2,1,4,14,50,166,216,221.33333333333334
11386,2012-04-24,2,1,4,15,60,176,236,225.33333333333334
11387,2012-04-24,2,1,4,16,54,308,362,271.3333333333333
11388,2012-04-24,2,1,4,17,72,619,691,429.6666666666667
11389,2012-04-24,2,1,4,18,52,580,632,561.6666666666666
11390,2012-04-24,2,1,4,19,33,449,482,601.6666666666666
11391,2012-04-24,2,1,4,20,16,269,285,466.3333333333333
11392,2012-04-24,2,1,4,21,13,213,226,331.0
11393,2012-04-24,2,1,4,22,8,149,157,222.66666666666666
11394,2012-04-24,2,1,4,23,4,69,73,152.0
11395,2012-04-25,2,1,4,0,13,23,36,88.66666666666667
11396,2012-04-25,2,1,4,1,8,17,25,44.666666666666664
11397,2012-04-25,2,1,4,2,1,6,7,22.666666666666668
11398,2012-04-25,2,1,4,3,0,3,3,11.666666666666666
11399,2012-04-25,2,1,4,4,0,6,6,5.333333333333333
11400,2012-04-25,2,1,4,5,0,24,24,11.0
11401,2012-04-25,2,1,4,6,3,103,106,45.333333333333336
11402,2012-04-25,2,1,4,7,13,376,389,173.0
11403,2012-04-25,2,1,4,8,20,634,654,383.0
11404,2012-04-25,2,1,4,9,33,288,321,454.6666666666667
11405,2012-04-25,2,1,4,10,44,138,182,385.6666666666667
11406,2012-04-25,2,1,4,11,42,177,219,240.66666666666666
11407,2012-04-25,2,1,4,12,49,220,269,223.33333333333334
11408,2012-04-25,2,1,4,13,35,193,228,238.66666666666666
11409,2012-04-25,2,1,4,14,47,176,223,240.0
11410,2012-04-25,2,1,4,15,47,182,229,226.66666666666666
11411,2012-04-25,2,1,4,16,49,327,376,276.0
11412,2012-04-25,2,1,4,17,68,664,732,445.6666666666667
11413,2012-04-25,2,1,4,18,60,649,709,605.6666666666666
11414,2012-04-25,2,1,4,19,42,501,543,661.3333333333334
11415,2012-04-25,2,1,4,20,22,358,380,544.0
11416,2012-04-25,2,1,4,21,27,212,239,387.3333333333333
11417,2012-04-25,2,1,4,22,22,170,192,270.3333333333333
11418,2012-04-25,2,1,4,23,10,94,104,178.33333333333334
11419,2012-04-26,2,1,4,0,1,42,43,113.0
11420,2012-04-26,2,1,4,1,1,22,23,56.666666666666664
11421,2012-04-26,2,1,4,2,3,10,13,26.333333333333332
11422,2012-04-26,2,1,4,3,1,5,6,14.0
11423,2012-04-26,2,1,4,4,1,2,3,7.333333333333333
11424,2012-04-26,2,1,4,5,0,17,17,8.666666666666666
11425,2012-04-26,2,1,4,6,5,122,127,49.0
11426,2012-04-26,2,1,4,7,3,222,225,123.0
11427,2012-04-26,2,1,4,8,4,358,362,238.0
11428,2012-04-26,2,1,4,9,12,189,201,262.6666666666667
11429,2012-04-26,2,1,4,10,14,125,139,234.0
11430,2012-04-26,2,1,4,11,16,135,151,163.66666666666666
11431,2012-04-26,2,1,4,12,24,180,204,164.66666666666666
11432,2012-04-26,2,1,4,13,19,178,197,184.0
11433,2012-04-26,2,1,4,14,37,132,169,190.0
11434,2012-04-26,2,1,4,15,39,165,204,190.0
11435,2012-04-26,2,1,4,16,37,281,318,230.33333333333334
11436,2012-04-26,2,1,4,17,49,565,614,378.6666666666667
11437,2012-04-26,2,1,4,18,75,589,664,532.0
11438,2012-04-26,2,1,4,19,57,407,464,580.6666666666666
11439,2012-04-26,2,1,4,20,23,314,337,488.3333333333333
11440,2012-04-26,2,1,4,21,28,222,250,350.3333333333333
11441,2012-04-26,2,1,4,22,20,163,183,256.6666666666667
11442,2012-04-26,2,1,4,23,6,106,112,181.66666666666666
11443,2012-04-27,2,1,4,0,12,61,73,122.66666666666667
11444,2012-04-27,2,1,4,1,3,32,35,73.33333333333333
11445,2012-04-27,2,1,4,2,4,18,22,43.333333333333336
11446,2012-04-27,2,1,4,3,1,2,3,20.0
11447,2012-04-27,2,1,4,4,0,6,6,10.333333333333334
11448,2012-04-27,2,1,4,5,0,19,19,9.333333333333334
11449,2012-04-27,2,1,4,6,5,115,120,48.333333333333336
11450,2012-04-27,2,1,4,7,10,305,315,151.33333333333334
11451,2012-04-27,2,1,4,8,17,575,592,342.3333333333333
11452,2012-04-27,2,1,4,9,42,292,334,413.6666666666667
11453,2012-04-27,2,1,4,10,64,172,236,387.3333333333333
11454,2012-04-27,2,1,4,11,47,186,233,267.6666666666667
11455,2012-04-27,2,1,4,12,63,244,307,258.6666666666667
11456,2012-04-27,2,1,4,13,94,212,306,282.0
11457,2012-04-27,2,1,4,14,94,206,300,304.3333333333333
11458,2012-04-27,2,1,4,15,101,223,324,310.0
11459,2012-04-27,2,1,4,16,105,335,440,354.6666666666667
11460,2012-04-27,2,1,4,17,89,613,702,488.6666666666667
11461,2012-04-27,2,1,4,18,94,560,654,598.6666666666666
11462,2012-04-27,2,1,4,19,62,379,441,599.0
11463,2012-04-27,2,1,4,20,49,240,289,461.3333333333333
11464,2012-04-27,2,1,4,21,23,185,208,312.6666666666667
11465,2012-04-27,2,1,4,22,24,134,158,218.33333333333334
11466,2012-04-27,2,1,4,23,11,105,116,160.66666666666666
11467,2012-04-28,2,1,4,0,4,99,103,125.66666666666667
11468,2012-04-28,2,1,4,1,7,60,67,95.33333333333333
11469,2012-04-28,2,1,4,2,8,49,57,75.66666666666667
11470,2012-04-28,2,1,4,3,3,23,26,50.0
11471,2012-04-28,2,1,4,4,0,2,2,28.333333333333332
11472,2012-04-28,2,1,4,5,2,3,5,11.0
11473,2012-04-28,2,1,4,6,10,18,28,11.666666666666666
11474,2012-04-28,2,1,4,7,10,45,55,29.333333333333332
11475,2012-04-28,2,1,4,8,24,134,158,80.33333333333333
11476,2012-04-28,2,1,4,9,45,169,214,142.33333333333334
11477,2012-04-28,2,1,4,10,60,231,291,221.0
11478,2012-04-28,2,1,4,11,96,262,358,287.6666666666667
11479,2012-04-28,2,1,4,12,105,276,381,343.3333333333333
11480,2012-04-28,2,1,4,13,120,269,389,376.0
11481,2012-04-28,2,1,4,14,147,293,440,403.3333333333333
11482,2012-04-28,2,1,4,15,148,260,408,412.3333333333333
11483,2012-04-28,2,1,4,16,132,244,376,408.0
11484,2012-04-28,2,1,4,17,98,224,322,368.6666666666667
11485,2012-04-28,2,1,4,18,17,73,90,262.6666666666667
11486,2012-04-28,2,1,4,19,29,110,139,183.66666666666666
11487,2012-04-28,2,1,4,20,21,81,102,110.33333333333333
11488,2012-04-28,2,1,4,21,12,72,84,108.33333333333333
11489,2012-04-28,2,1,4,22,17,66,83,89.66666666666667
11490,2012-04-28,2,1,4,23,5,37,42,69.66666666666667
11491,2012-04-29,2,1,4,0,0,36,36,53.666666666666664
11492,2012-04-29,2,1,4,1,5,37,42,40.0
11493,2012-04-29,2,1,4,2,4,36,40,39.333333333333336
11494,2012-04-29,2,1,4,3,2,14,16,32.666666666666664
11495,2012-04-29,2,1,4,4,0,4,4,20.0
11496,2012-04-29,2,1,4,5,0,6,6,8.666666666666666
11497,2012-04-29,2,1,4,6,1,6,7,5.666666666666667
11498,2012-04-29,2,1,4,7,7,20,27,13.333333333333334
11499,2012-04-29,2,1,4,8,26,81,107,47.0
11500,2012-04-29,2,1,4,9,52,133,185,106.33333333333333
11501,2012-04-29,2,1,4,10,127,253,380,224.0
11502,2012-04-29,2,1,4,11,128,283,411,325.3333333333333
11503,2012-04-29,2,1,4,12,223,361,584,458.3333333333333
11504,2012-04-29,2,1,4,13,226,369,595,530.0
11505,2012-04-29,2,1,4,14,281,372,653,610.6666666666666
11506,2012-04-29,2,1,4,15,279,324,603,617.0
11507,2012-04-29,2,1,4,16,240,347,587,614.3333333333334
11508,2012-04-29,2,1,4,17,188,334,522,570.6666666666666
11509,2012-04-29,2,1,4,18,164,323,487,532.0
11510,2012-04-29,2,1,4,19,128,247,375,461.3333333333333
11511,2012-04-29,2,1,4,20,45,198,243,368.3333333333333
11512,2012-04-29,2,1,4,21,65,139,204,274.0
11513,2012-04-29,2,1,4,22,23,85,108,185.0
11514,2012-04-29,2,1,4,23,15,67,82,131.33333333333334
11515,2012-04-30,2,1,4,0,12,36,48,79.33333333333333
11516,2012-04-30,2,1,4,1,9,15,24,51.333333333333336
11517,2012-04-30,2,1,4,2,3,5,8,26.666666666666668
11518,2012-04-30,2,1,4,3,0,4,4,12.0
11519,2012-04-30,2,1,4,4,0,2,2,4.666666666666667
11520,2012-04-30,2,1,4,5,1,19,20,8.666666666666666
11521,2012-04-30,2,1,4,6,2,121,123,48.333333333333336
11522,2012-04-30,2,1,4,7,6,343,349,164.0
11523,2012-04-30,2,1,4,8,17,579,596,356.0
11524,2012-04-30,2,1,4,9,29,239,268,404.3333333333333
11525,2012-04-30,2,1,4,10,41,116,157,340.3333333333333
11526,2012-04-30,2,1,4,11,52,111,163,196.0
11527,2012-04-30,2,1,4,12,45,180,225,181.66666666666666
11528,2012-04-30,2,1,4,13,48,199,247,211.66666666666666
11529,2012-04-30,2,1,4,14,56,162,218,230.0
11530,2012-04-30,2,1,4,15,55,176,231,232.0
11531,2012-04-30,2,1,4,16,44,303,347,265.3333333333333
11532,2012-04-30,2,1,4,17,66,617,683,420.3333333333333
11533,2012-04-30,2,1,4,18,53,611,664,564.6666666666666
11534,2012-04-30,2,1,4,19,51,420,471,606.0
11535,2012-04-30,2,1,4,20,28,281,309,481.3333333333333
11536,2012-04-30,2,1,4,21,26,195,221,333.6666666666667
11537,2012-04-30,2,1,4,22,11,123,134,221.33333333333334
11538,2012-04-30,2,1,4,23,10,50,60,138.33333333333334
11539,2012-05-01,2,1,5,0,7,28,35,76.33333333333333
11540,2012-05-01,2,1,5,1,0,21,21,38.666666666666664
11541,2012-05-01,2,1,5,2,1,7,8,21.333333333333332
11542,2012-05-01,2,1,5,3,1,2,3,10.666666666666666
11543,2012-05-01,2,1,5,4,1,7,8,6.333333333333333
11544,2012-05-01,2,1,5,5,0,17,17,9.333333333333334
11545,2012-05-01,2,1,5,6,2,24,26,17.0
11546,2012-05-01,2,1,5,7,8,161,169,70.66666666666667
11547,2012-05-01,2,1,5,8,19,538,557,250.66666666666666
11548,2012-05-01,2,1,5,9,18,331,349,358.3333333333333
11549,2012-05-01,2,1,5,10,30,144,174,360.0
11550,2012-05-01,2,1,5,11,50,179,229,250.66666666666666
11551,2012-05-01,2,1,5,12,41,228,269,224.0
11552,2012-05-01,2,1,5,13,41,208,249,249.0
11553,2012-05-01,2,1,5,14,37,167,204,240.66666666666666
11554,2012-05-01,2,1,5,15,48,186,234,229.0
11555,2012-05-01,2,1,5,16,41,313,354,264.0
11556,2012-05-01,2,1,5,17,65,616,681,423.0
11557,2012-05-01,2,1,5,18,81,662,743,592.6666666666666
11558,2012-05-01,2,1,5,19,58,429,487,637.0
11559,2012-05-01,2,1,5,20,36,299,335,521.6666666666666
11560,2012-05-01,2,1,5,21,31,251,282,368.0
11561,2012-05-01,2,1,5,22,21,190,211,276.0
11562,2012-05-01,2,1,5,23,16,79,95,196.0
11563,2012-05-02,2,1,5,0,4,43,47,117.66666666666667
11564,2012-05-02,2,1,5,1,8,7,15,52.333333333333336
11565,2012-05-02,2,1,5,2,7,9,16,26.0
11566,2012-05-02,2,1,5,3,0,6,6,12.333333333333334
11567,2012-05-02,2,1,5,4,2,2,4,8.666666666666666
11568,2012-05-02,2,1,5,5,2,31,33,14.333333333333334
11569,2012-05-02,2,1,5,6,3,117,120,52.333333333333336
11570,2012-05-02,2,1,5,7,14,344,358,170.33333333333334
11571,2012-05-02,2,1,5,8,26,640,666,381.3333333333333
11572,2012-05-02,2,1,5,9,26,289,315,446.3333333333333
11573,2012-05-02,2,1,5,10,28,147,175,385.3333333333333
11574,2012-05-02,2,1,5,11,39,145,184,224.66666666666666
11575,2012-05-02,2,1,5,12,35,210,245,201.33333333333334
11576,2012-05-02,2,1,5,13,49,179,228,219.0
11577,2012-05-02,2,1,5,14,51,189,240,237.66666666666666
11578,2012-05-02,2,1,5,15,52,204,256,241.33333333333334
11579,2012-05-02,2,1,5,16,54,313,367,287.6666666666667
11580,2012-05-02,2,1,5,17,70,659,729,450.6666666666667
11581,2012-05-02,2,1,5,18,43,770,813,636.3333333333334
11582,2012-05-02,2,1,5,19,43,461,504,682.0
11583,2012-05-02,2,1,5,20,42,296,338,551.6666666666666
11584,2012-05-02,2,1,5,21,21,218,239,360.3333333333333
11585,2012-05-02,2,1,5,22,27,146,173,250.0
11586,2012-05-02,2,1,5,23,21,77,98,170.0
11587,2012-05-03,2,1,5,0,15,75,90,120.33333333333333
11588,2012-05-03,2,1,5,1,9,15,24,70.66666666666667
11589,2012-05-03,2,1,5,2,4,13,17,43.666666666666664
11590,2012-05-03,2,1,5,3,2,4,6,15.666666666666666
11591,2012-05-03,2,1,5,4,0,2,2,8.333333333333334
11592,2012-05-03,2,1,5,5,1,20,21,9.666666666666666
11593,2012-05-03,2,1,5,6,8,128,136,53.0
11594,2012-05-03,2,1,5,7,8,376,384,180.33333333333334
11595,2012-05-03,2,1,5,8,19,608,627,382.3333333333333
11596,2012-05-03,2,1,5,9,25,279,304,438.3333333333333
11597,2012-05-03,2,1,5,10,36,132,168,366.3333333333333
11598,2012-05-03,2,1,5,11,34,167,201,224.33333333333334
11599,2012-05-03,2,1,5,12,64,237,301,223.33333333333334
11600,2012-05-03,2,1,5,13,48,217,265,255.66666666666666
11601,2012-05-03,2,1,5,14,33,171,204,256.6666666666667
11602,2012-05-03,2,1,5,15,63,220,283,250.66666666666666
11603,2012-05-03,2,1,5,16,45,325,370,285.6666666666667
11604,2012-05-03,2,1,5,17,87,617,704,452.3333333333333
11605,2012-05-03,2,1,5,18,64,642,706,593.3333333333334
11606,2012-05-03,2,1,5,19,55,467,522,644.0
11607,2012-05-03,2,1,5,20,52,368,420,549.3333333333334
11608,2012-05-03,2,1,5,21,42,257,299,413.6666666666667
11609,2012-05-03,2,1,5,22,29,217,246,321.6666666666667
11610,2012-05-03,2,1,5,23,21,100,121,222.0
11611,2012-05-04,2,1,5,0,19,70,89,152.0
11612,2012-05-04,2,1,5,1,15,33,48,86.0
11613,2012-05-04,2,1,5,2,0,11,11,49.333333333333336
11614,2012-05-04,2,1,5,3,0,14,14,24.333333333333332
11615,2012-05-04,2,1,5,4,0,4,4,9.666666666666666
11616,2012-05-04,2,1,5,5,0,24,24,14.0
11617,2012-05-04,2,1,5,6,8,127,135,54.333333333333336
11618,2012-05-04,2,1,5,7,9,347,356,171.66666666666666
11619,2012-05-04,2,1,5,8,34,584,618,369.6666666666667
11620,2012-05-04,2,1,5,9,32,262,294,422.6666666666667
11621,2012-05-04,2,1,5,10,45,154,199,370.3333333333333
11622,2012-05-04,2,1,5,11,77,181,258,250.33333333333334
11623,2012-05-04,2,1,5,12,46,125,171,209.33333333333334
11624,2012-05-04,2,1,5,13,71,207,278,235.66666666666666
11625,2012-05-04,2,1,5,14,83,159,242,230.33333333333334
11626,2012-05-04,2,1,5,15,103,240,343,287.6666666666667
11627,2012-05-04,2,1,5,16,82,358,440,341.6666666666667
11628,2012-05-04,2,1,5,17,96,547,643,475.3333333333333
11629,2012-05-04,2,1,5,18,77,564,641,574.6666666666666
11630,2012-05-04,2,1,5,19,64,388,452,578.6666666666666
11631,2012-05-04,2,1,5,20,58,255,313,468.6666666666667
11632,2012-05-04,2,1,5,21,49,186,235,333.3333333333333
11633,2012-05-04,2,1,5,22,50,182,232,260.0
11634,2012-05-04,2,1,5,23,51,205,256,241.0
11635,2012-05-05,2,1,5,0,42,111,153,213.66666666666666
11636,2012-05-05,2,1,5,1,28,79,107,172.0
11637,2012-05-05,2,1,5,2,24,51,75,111.66666666666667
11638,2012-05-05,2,1,5,3,11,21,32,71.33333333333333
11639,2012-05-05,2,1,5,4,0,9,9,38.666666666666664
11640,2012-05-05,2,1,5,5,8,14,22,21.0
11641,2012-05-05,2,1,5,6,9,33,42,24.333333333333332
11642,2012-05-05,2,1,5,7,8,79,87,50.333333333333336
11643,2012-05-05,2,1,5,8,42,155,197,108.66666666666667
11644,2012-05-05,2,1,5,9,61,223,284,189.33333333333334
11645,2012-05-05,2,1,5,10,148,284,432,304.3333333333333
11646,2012-05-05,2,1,5,11,221,354,575,430.3333333333333
11647,2012-05-05,2,1,5,12,220,330,550,519.0
11648,2012-05-05,2,1,5,13,217,307,524,549.6666666666666
11649,2012-05-05,2,1,5,14,187,241,428,500.6666666666667
11650,2012-05-05,2,1,5,15,241,300,541,497.6666666666667
11651,2012-05-05,2,1,5,16,230,310,540,503.0
11652,2012-05-05,2,1,5,17,204,298,502,527.6666666666666
11653,2012-05-05,2,1,5,18,156,278,434,492.0
11654,2012-05-05,2,1,5,19,151,254,405,447.0
11655,2012-05-05,2,1,5,20,100,209,309,382.6666666666667
11656,2012-05-05,2,1,5,21,86,183,269,327.6666666666667
11657,2012-05-05,2,1,5,22,67,150,217,265.0
11658,2012-05-05,2,1,5,23,35,114,149,211.66666666666666
11659,2012-05-06,2,1,5,0,23,111,134,166.66666666666666
11660,2012-05-06,2,1,5,1,37,84,121,134.66666666666666
11661,2012-05-06,2,1,5,2,29,64,93,116.0
11662,2012-05-06,2,1,5,3,9,19,28,80.66666666666667
11663,2012-05-06,2,1,5,4,9,7,16,45.666666666666664
11664,2012-05-06,2,1,5,5,1,10,11,18.333333333333332
11665,2012-05-06,2,1,5,6,3,14,17,14.666666666666666
11666,2012-05-06,2,1,5,7,5,31,36,21.333333333333332
11667,2012-05-06,2,1,5,8,23,91,114,55.666666666666664
11668,2012-05-06,2,1,5,9,63,128,191,113.66666666666667
11669,2012-05-06,2,1,5,10,112,221,333,212.66666666666666
11670,2012-05-06,2,1,5,11,144,270,414,312.6666666666667
11671,2012-05-06,2,1,5,12,207,351,558,435.0
11672,2012-05-06,2,1,5,13,197,368,565,512.3333333333334
11673,2012-05-06,2,1,5,14,226,292,518,547.0
11674,2012-05-06,2,1,5,15,229,342,571,551.3333333333334
11675,2012-05-06,2,1,5,16,181,363,544,544.3333333333334
11676,2012-05-06,2,1,5,17,195,316,511,542.0
11677,2012-05-06,2,1,5,18,131,332,463,506.0
11678,2012-05-06,2,1,5,19,117,266,383,452.3333333333333
11679,2012-05-06,2,1,5,20,73,203,276,374.0
11680,2012-05-06,2,1,5,21,55,148,203,287.3333333333333
11681,2012-05-06,2,1,5,22,44,113,157,212.0
11682,2012-05-06,2,1,5,23,22,80,102,154.0
11683,2012-05-07,2,1,5,0,13,21,34,97.66666666666667
11684,2012-05-07,2,1,5,1,1,8,9,48.333333333333336
11685,2012-05-07,2,1,5,2,1,5,6,16.333333333333332
11686,2012-05-07,2,1,5,3,2,3,5,6.666666666666667
11687,2012-05-07,2,1,5,4,0,2,2,4.333333333333333
11688,2012-05-07,2,1,5,5,2,21,23,10.0
11689,2012-05-07,2,1,5,6,8,134,142,55.666666666666664
11690,2012-05-07,2,1,5,7,18,367,385,183.33333333333334
11691,2012-05-07,2,1,5,8,31,608,639,388.6666666666667
11692,2012-05-07,2,1,5,9,61,289,350,458.0
11693,2012-05-07,2,1,5,10,62,128,190,393.0
11694,2012-05-07,2,1,5,11,64,149,213,251.0
11695,2012-05-07,2,1,5,12,74,189,263,222.0
11696,2012-05-07,2,1,5,13,75,197,272,249.33333333333334
11697,2012-05-07,2,1,5,14,59,180,239,258.0
11698,2012-05-07,2,1,5,15,76,186,262,257.6666666666667
11699,2012-05-07,2,1,5,16,68,320,388,296.3333333333333
11700,2012-05-07,2,1,5,17,102,667,769,473.0
11701,2012-05-07,2,1,5,18,78,602,680,612.3333333333334
11702,2012-05-07,2,1,5,19,83,463,546,665.0
11703,2012-05-07,2,1,5,20,46,277,323,516.3333333333334
11704,2012-05-07,2,1,5,21,37,210,247,372.0
11705,2012-05-07,2,1,5,22,26,147,173,247.66666666666666
11706,2012-05-07,2,1,5,23,21,92,113,177.66666666666666
11707,2012-05-08,2,1,5,0,10,28,38,108.0
11708,2012-05-08,2,1,5,1,6,3,9,53.333333333333336
11709,2012-05-08,2,1,5,2,9,7,16,21.0
11710,2012-05-08,2,1,5,3,2,4,6,10.333333333333334
11711,2012-05-08,2,1,5,4,0,5,5,9.0
11712,2012-05-08,2,1,5,5,0,20,20,10.333333333333334
11713,2012-05-08,2,1,5,6,7,158,165,63.333333333333336
11714,2012-05-08,2,1,5,7,21,442,463,216.0
11715,2012-05-08,2,1,5,8,36,605,641,423.0
11716,2012-05-08,2,1,5,9,37,258,295,466.3333333333333
11717,2012-05-08,2,1,5,10,46,111,157,364.3333333333333
11718,2012-05-08,2,1,5,11,60,157,217,223.0
11719,2012-05-08,2,1,5,12,60,203,263,212.33333333333334
11720,2012-05-08,2,1,5,13,53,166,219,233.0
11721,2012-05-08,2,1,5,14,8,63,71,184.33333333333334
11722,2012-05-08,2,1,5,15,40,94,134,141.33333333333334
11723,2012-05-08,2,1,5,16,54,335,389,198.0
11724,2012-05-08,2,1,5,17,77,640,717,413.3333333333333
11725,2012-05-08,2,1,5,18,69,641,710,605.3333333333334
11726,2012-05-08,2,1,5,19,59,399,458,628.3333333333334
11727,2012-05-08,2,1,5,20,40,262,302,490.0
11728,2012-05-08,2,1,5,21,21,202,223,327.6666666666667
11729,2012-05-08,2,1,5,22,13,134,147,224.0
11730,2012-05-08,2,1,5,23,10,53,63,144.33333333333334
11731,2012-05-09,2,1,5,0,8,27,35,81.66666666666667
11732,2012-05-09,2,1,5,1,3,11,14,37.333333333333336
11733,2012-05-09,2,1,5,2,0,1,1,16.666666666666668
11734,2012-05-09,2,1,5,3,0,2,2,5.666666666666667
11735,2012-05-09,2,1,5,4,0,5,5,2.6666666666666665
11736,2012-05-09,2,1,5,5,1,27,28,11.666666666666666
11737,2012-05-09,2,1,5,6,5,121,126,53.0
11738,2012-05-09,2,1,5,7,17,401,418,190.66666666666666
11739,2012-05-09,2,1,5,8,28,594,622,388.6666666666667
11740,2012-05-09,2,1,5,9,40,285,325,455.0
11741,2012-05-09,2,1,5,10,40,113,153,366.6666666666667
11742,2012-05-09,2,1,5,11,45,156,201,226.33333333333334
11743,2012-05-09,2,1,5,12,58,222,280,211.33333333333334
11744,2012-05-09,2,1,5,13,50,216,266,249.0
11745,2012-05-09,2,1,5,14,68,175,243,263.0
11746,2012-05-09,2,1,5,15,68,191,259,256.0
11747,2012-05-09,2,1,5,16,68,289,357,286.3333333333333
11748,2012-05-09,2,1,5,17,76,629,705,440.3333333333333
11749,2012-05-09,2,1,5,18,23,349,372,478.0
11750,2012-05-09,2,1,5,19,2,96,98,391.6666666666667
11751,2012-05-09,2,1,5,20,3,48,51,173.66666666666666
11752,2012-05-09,2,1,5,21,4,30,34,61.0
11753,2012-05-09,2,1,5,22,5,62,67,50.666666666666664
11754,2012-05-09,2,1,5,23,8,47,55,52.0
11755,2012-05-10,2,1,5,0,2,31,33,51.666666666666664
11756,2012-05-10,2,1,5,1,2,9,11,33.0
11757,2012-05-10,2,1,5,2,0,3,3,15.666666666666666
11758,2012-05-10,2,1,5,3,0,3,3,5.666666666666667
11759,2012-05-10,2,1,5,4,0,2,2,2.6666666666666665
11760,2012-05-10,2,1,5,5,1,23,24,9.666666666666666
11761,2012-05-10,2,1,5,6,9,130,139,55.0
11762,2012-05-10,2,1,5,7,8,393,401,188.0
11763,2012-05-10,2,1,5,8,27,603,630,390.0
11764,2012-05-10,2,1,5,9,62,299,361,464.0
11765,2012-05-10,2,1,5,10,42,112,154,381.6666666666667
11766,2012-05-10,2,1,5,11,77,179,256,257.0
11767,2012-05-10,2,1,5,12,65,207,272,227.33333333333334
11768,2012-05-10,2,1,5,13,90,228,318,282.0
11769,2012-05-10,2,1,5,14,61,186,247,279.0
11770,2012-05-10,2,1,5,15,79,192,271,278.6666666666667
11771,2012-05-10,2,1,5,16,87,334,421,313.0
11772,2012-05-10,2,1,5,17,84,648,732,474.6666666666667
11773,2012-05-10,2,1,5,18,109,661,770,641.0
11774,2012-05-10,2,1,5,19,84,469,553,685.0
11775,2012-05-10,2,1,5,20,59,315,374,565.6666666666666
11776,2012-05-10,2,1,5,21,19,211,230,385.6666666666667
11777,2012-05-10,2,1,5,22,36,196,232,278.6666666666667
11778,2012-05-10,2,1,5,23,23,112,135,199.0
11779,2012-05-11,2,1,5,0,17,47,64,143.66666666666666
11780,2012-05-11,2,1,5,1,14,32,46,81.66666666666667
11781,2012-05-11,2,1,5,2,15,16,31,47.0
11782,2012-05-11,2,1,5,3,5,8,13,30.0
11783,2012-05-11,2,1,5,4,3,6,9,17.666666666666668
11784,2012-05-11,2,1,5,5,3,23,26,16.0
11785,2012-05-11,2,1,5,6,7,128,135,56.666666666666664
11786,2012-05-11,2,1,5,7,6,345,351,170.66666666666666
11787,2012-05-11,2,1,5,8,41,579,620,368.6666666666667
11788,2012-05-11,2,1,5,9,34,288,322,431.0
11789,2012-05-11,2,1,5,10,69,141,210,384.0
11790,2012-05-11,2,1,5,11,88,203,291,274.3333333333333
11791,2012-05-11,2,1,5,12,89,259,348,283.0
11792,2012-05-11,2,1,5,13,100,263,363,334.0
11793,2012-05-11,2,1,5,14,116,218,334,348.3333333333333
11794,2012-05-11,2,1,5,15,140,299,439,378.6666666666667
11795,2012-05-11,2,1,5,16,128,397,525,432.6666666666667
11796,2012-05-11,2,1,5,17,102,677,779,581.0
11797,2012-05-11,2,1,5,18,78,518,596,633.3333333333334
11798,2012-05-11,2,1,5,19,73,430,503,626.0
11799,2012-05-11,2,1,5,20,64,277,341,480.0
11800,2012-05-11,2,1,5,21,45,225,270,371.3333333333333
11801,2012-05-11,2,1,5,22,44,190,234,281.6666666666667
11802,2012-05-11,2,1,5,23,38,142,180,228.0
11803,2012-05-12,2,1,5,0,25,111,136,183.33333333333334
11804,2012-05-12,2,1,5,1,14,79,93,136.33333333333334
11805,2012-05-12,2,1,5,2,10,46,56,95.0
11806,2012-05-12,2,1,5,3,14,20,34,61.0
11807,2012-05-12,2,1,5,4,3,6,9,33.0
11808,2012-05-12,2,1,5,5,5,8,13,18.666666666666668
11809,2012-05-12,2,1,5,6,10,23,33,18.333333333333332
11810,2012-05-12,2,1,5,7,10,57,67,37.666666666666664
11811,2012-05-12,2,1,5,8,22,156,178,92.66666666666667
11812,2012-05-12,2,1,5,9,87,248,335,193.33333333333334
11813,2012-05-12,2,1,5,10,132,279,411,308.0
11814,2012-05-12,2,1,5,11,157,365,522,422.6666666666667
11815,2012-05-12,2,1,5,12,206,353,559,497.3333333333333
11816,2012-05-12,2,1,5,13,293,366,659,580.0
11817,2012-05-12,2,1,5,14,257,358,615,611.0
11818,2012-05-12,2,1,5,15,269,321,590,621.3333333333334
11819,2012-05-12,2,1,5,16,254,337,591,598.6666666666666
11820,2012-05-12,2,1,5,17,233,343,576,585.6666666666666
11821,2012-05-12,2,1,5,18,164,382,546,571.0
11822,2012-05-12,2,1,5,19,166,273,439,520.3333333333334
11823,2012-05-12,2,1,5,20,113,174,287,424.0
11824,2012-05-12,2,1,5,21,74,156,230,318.6666666666667
11825,2012-05-12,2,1,5,22,62,212,274,263.6666666666667
11826,2012-05-12,2,1,5,23,42,134,176,226.66666666666666
11827,2012-05-13,2,1,5,0,19,79,98,182.66666666666666
11828,2012-05-13,2,1,5,1,22,72,94,122.66666666666667
11829,2012-05-13,2,1,5,2,22,60,82,91.33333333333333
11830,2012-05-13,2,1,5,3,2,26,28,68.0
11831,2012-05-13,2,1,5,4,2,7,9,39.666666666666664
11832,2012-05-13,2,1,5,5,4,8,12,16.333333333333332
11833,2012-05-13,2,1,5,6,6,15,21,14.0
11834,2012-05-13,2,1,5,7,18,42,60,31.0
11835,2012-05-13,2,1,5,8,32,124,156,79.0
11836,2012-05-13,2,1,5,9,79,143,222,146.0
11837,2012-05-13,2,1,5,10,128,222,350,242.66666666666666
11838,2012-05-13,2,1,5,11,150,278,428,333.3333333333333
11839,2012-05-13,2,1,5,12,189,342,531,436.3333333333333
11840,2012-05-13,2,1,5,13,255,347,602,520.3333333333334
11841,2012-05-13,2,1,5,14,228,324,552,561.6666666666666
11842,2012-05-13,2,1,5,15,190,309,499,551.0
11843,2012-05-13,2,1,5,16,225,339,564,538.3333333333334
11844,2012-05-13,2,1,5,17,191,287,478,513.6666666666666
11845,2012-05-13,2,1,5,18,129,260,389,477.0
11846,2012-05-13,2,1,5,19,107,232,339,402.0
11847,2012-05-13,2,1,5,20,67,163,230,319.3333333333333
11848,2012-05-13,2,1,5,21,48,121,169,246.0
11849,2012-05-13,2,1,5,22,42,89,131,176.66666666666666
11850,2012-05-13,2,1,5,23,17,57,74,124.66666666666667
11851,2012-05-14,2,1,5,0,21,14,35,80.0
11852,2012-05-14,2,1,5,1,5,6,11,40.0
11853,2012-05-14,2,1,5,2,1,1,2,16.0
11854,2012-05-14,2,1,5,3,0,2,2,5.0
11855,2012-05-14,2,1,5,4,3,3,6,3.3333333333333335
11856,2012-05-14,2,1,5,5,1,25,26,11.333333333333334
11857,2012-05-14,2,1,5,6,3,62,65,32.333333333333336
11858,2012-05-14,2,1,5,7,3,72,75,55.333333333333336
11859,2012-05-14,2,1,5,8,1,155,156,98.66666666666667
11860,2012-05-14,2,1,5,9,5,105,110,113.66666666666667
11861,2012-05-14,2,1,5,10,6,53,59,108.33333333333333
11862,2012-05-14,2,1,5,11,12,67,79,82.66666666666667
11863,2012-05-14,2,1,5,12,53,132,185,107.66666666666667
11864,2012-05-14,2,1,5,13,33,143,176,146.66666666666666
11865,2012-05-14,2,1,5,14,43,128,171,177.33333333333334
11866,2012-05-14,2,1,5,15,40,156,196,181.0
11867,2012-05-14,2,1,5,16,20,91,111,159.33333333333334
11868,2012-05-14,2,1,5,17,25,204,229,178.66666666666666
11869,2012-05-14,2,1,5,18,17,283,300,213.33333333333334
11870,2012-05-14,2,1,5,19,10,294,304,277.6666666666667
11871,2012-05-14,2,1,5,20,11,178,189,264.3333333333333
11872,2012-05-14,2,1,5,21,7,145,152,215.0
11873,2012-05-14,2,1,5,22,11,118,129,156.66666666666666
11874,2012-05-14,2,1,5,23,11,64,75,118.66666666666667
11875,2012-05-15,2,1,5,0,7,25,32,78.66666666666667
11876,2012-05-15,2,1,5,1,5,14,19,42.0
11877,2012-05-15,2,1,5,2,1,3,4,18.333333333333332
11878,2012-05-15,2,1,5,3,1,5,6,9.666666666666666
11879,2012-05-15,2,1,5,4,1,4,5,5.0
11880,2012-05-15,2,1,5,5,0,8,8,6.333333333333333
11881,2012-05-15,2,1,5,6,2,22,24,12.333333333333334
11882,2012-05-15,2,1,5,7,1,91,92,41.333333333333336
11883,2012-05-15,2,1,5,8,8,401,409,175.0
11884,2012-05-15,2,1,5,9,28,327,355,285.3333333333333
11885,2012-05-15,2,1,5,10,27,144,171,311.6666666666667
11886,2012-05-15,2,1,5,11,38,186,224,250.0
11887,2012-05-15,2,1,5,12,44,220,264,219.66666666666666
11888,2012-05-15,2,1,5,13,35,204,239,242.33333333333334
11889,2012-05-15,2,1,5,14,39,145,184,229.0
11890,2012-05-15,2,1,5,15,51,205,256,226.33333333333334
11891,2012-05-15,2,1,5,16,74,300,374,271.3333333333333
11892,2012-05-15,2,1,5,17,75,603,678,436.0
11893,2012-05-15,2,1,5,18,68,665,733,595.0
11894,2012-05-15,2,1,5,19,57,455,512,641.0
11895,2012-05-15,2,1,5,20,30,233,263,502.6666666666667
11896,2012-05-15,2,1,5,21,11,98,109,294.6666666666667
11897,2012-05-15,2,1,5,22,9,74,83,151.66666666666666
11898,2012-05-15,2,1,5,23,13,58,71,87.66666666666667
11899,2012-05-16,2,1,5,0,12,27,39,64.33333333333333
11900,2012-05-16,2,1,5,1,7,14,21,43.666666666666664
11901,2012-05-16,2,1,5,2,5,14,19,26.333333333333332
11902,2012-05-16,2,1,5,3,1,5,6,15.333333333333334
11903,2012-05-16,2,1,5,4,1,3,4,9.666666666666666
11904,2012-05-16,2,1,5,5,4,34,38,16.0
11905,2012-05-16,2,1,5,6,8,150,158,66.66666666666667
11906,2012-05-16,2,1,5,7,14,426,440,212.0
11907,2012-05-16,2,1,5,8,33,617,650,416.0
11908,2012-05-16,2,1,5,9,33,314,347,479.0
11909,2012-05-16,2,1,5,10,43,149,192,396.3333333333333
11910,2012-05-16,2,1,5,11,55,212,267,268.6666666666667
11911,2012-05-16,2,1,5,12,59,271,330,263.0
11912,2012-05-16,2,1,5,13,77,273,350,315.6666666666667
11913,2012-05-16,2,1,5,14,42,221,263,314.3333333333333
11914,2012-05-16,2,1,5,15,52,222,274,295.6666666666667
11915,2012-05-16,2,1,5,16,70,376,446,327.6666666666667
11916,2012-05-16,2,1,5,17,104,769,873,531.0
11917,2012-05-16,2,1,5,18,97,749,846,721.6666666666666
11918,2012-05-16,2,1,5,19,91,499,590,769.6666666666666
11919,2012-05-16,2,1,5,20,61,398,459,631.6666666666666
11920,2012-05-16,2,1,5,21,63,330,393,480.6666666666667
11921,2012-05-16,2,1,5,22,33,253,286,379.3333333333333
11922,2012-05-16,2,1,5,23,26,107,133,270.6666666666667
11923,2012-05-17,2,1,5,0,30,49,79,166.0
11924,2012-05-17,2,1,5,1,12,16,28,80.0
11925,2012-05-17,2,1,5,2,8,8,16,41.0
11926,2012-05-17,2,1,5,3,0,3,3,15.666666666666666
11927,2012-05-17,2,1,5,4,3,13,16,11.666666666666666
11928,2012-05-17,2,1,5,5,1,34,35,18.0
11929,2012-05-17,2,1,5,6,10,149,159,70.0
11930,2012-05-17,2,1,5,7,25,449,474,222.66666666666666
11931,2012-05-17,2,1,5,8,29,605,634,422.3333333333333
11932,2012-05-17,2,1,5,9,57,289,346,484.6666666666667
11933,2012-05-17,2,1,5,10,43,162,205,395.0
11934,2012-05-17,2,1,5,11,77,202,279,276.6666666666667
11935,2012-05-17,2,1,5,12,72,276,348,277.3333333333333
11936,2012-05-17,2,1,5,13,86,241,327,318.0
11937,2012-05-17,2,1,5,14,68,202,270,315.0
11938,2012-05-17,2,1,5,15,83,233,316,304.3333333333333
11939,2012-05-17,2,1,5,16,86,344,430,338.6666666666667
11940,2012-05-17,2,1,5,17,133,719,852,532.6666666666666
11941,2012-05-17,2,1,5,18,134,734,868,716.6666666666666
11942,2012-05-17,2,1,5,19,86,451,537,752.3333333333334
11943,2012-05-17,2,1,5,20,83,363,446,617.0
11944,2012-05-17,2,1,5,21,45,254,299,427.3333333333333
11945,2012-05-17,2,1,5,22,42,209,251,332.0
11946,2012-05-17,2,1,5,23,29,137,166,238.66666666666666
11947,2012-05-18,2,1,5,0,13,57,70,162.33333333333334
11948,2012-05-18,2,1,5,1,16,33,49,95.0
11949,2012-05-18,2,1,5,2,12,9,21,46.666666666666664
11950,2012-05-18,2,1,5,3,6,8,14,28.0
11951,2012-05-18,2,1,5,4,0,11,11,15.333333333333334
11952,2012-05-18,2,1,5,5,1,33,34,19.666666666666668
11953,2012-05-18,2,1,5,6,14,168,182,75.66666666666667
11954,2012-05-18,2,1,5,7,40,475,515,243.66666666666666
11955,2012-05-18,2,1,5,8,49,696,745,480.6666666666667
11956,2012-05-18,2,1,5,9,57,304,361,540.3333333333334
11957,2012-05-18,2,1,5,10,74,181,255,453.6666666666667
11958,2012-05-18,2,1,5,11,109,225,334,316.6666666666667
11959,2012-05-18,2,1,5,12,108,252,360,316.3333333333333
11960,2012-05-18,2,1,5,13,98,297,395,363.0
11961,2012-05-18,2,1,5,14,108,242,350,368.3333333333333
11962,2012-05-18,2,1,5,15,131,260,391,378.6666666666667
11963,2012-05-18,2,1,5,16,151,417,568,436.3333333333333
11964,2012-05-18,2,1,5,17,124,688,812,590.3333333333334
11965,2012-05-18,2,1,5,18,99,570,669,683.0
11966,2012-05-18,2,1,5,19,91,392,483,654.6666666666666
11967,2012-05-18,2,1,5,20,73,264,337,496.3333333333333
11968,2012-05-18,2,1,5,21,49,209,258,359.3333333333333
11969,2012-05-18,2,1,5,22,57,194,251,282.0
11970,2012-05-18,2,1,5,23,41,133,174,227.66666666666666
11971,2012-05-19,2,1,5,0,30,118,148,191.0
11972,2012-05-19,2,1,5,1,20,84,104,142.0
11973,2012-05-19,2,1,5,2,13,56,69,107.0
11974,2012-05-19,2,1,5,3,10,23,33,68.66666666666667
11975,2012-05-19,2,1,5,4,6,8,14,38.666666666666664
11976,2012-05-19,2,1,5,5,1,11,12,19.666666666666668
11977,2012-05-19,2,1,5,6,12,38,50,25.333333333333332
11978,2012-05-19,2,1,5,7,28,67,95,52.333333333333336
11979,2012-05-19,2,1,5,8,33,162,195,113.33333333333333
11980,2012-05-19,2,1,5,9,79,213,292,194.0
11981,2012-05-19,2,1,5,10,177,275,452,313.0
11982,2012-05-19,2,1,5,11,235,351,586,443.3333333333333
11983,2012-05-19,2,1,5,12,276,366,642,560.0
11984,2012-05-19,2,1,5,13,332,372,704,644.0
11985,2012-05-19,2,1,5,14,361,369,730,692.0
11986,2012-05-19,2,1,5,15,356,316,672,702.0
11987,2012-05-19,2,1,5,16,331,311,642,681.3333333333334
11988,2012-05-19,2,1,5,17,279,347,626,646.6666666666666
11989,2012-05-19,2,1,5,18,254,391,645,637.6666666666666
11990,2012-05-19,2,1,5,19,203,229,432,567.6666666666666
11991,2012-05-19,2,1,5,20,118,197,315,464.0
11992,2012-05-19,2,1,5,21,81,178,259,335.3333333333333
11993,2012-05-19,2,1,5,22,104,234,338,304.0
11994,2012-05-19,2,1,5,23,71,168,239,278.6666666666667
11995,2012-05-20,2,1,5,0,42,128,170,249.0
11996,2012-05-20,2,1,5,1,28,102,130,179.66666666666666
11997,2012-05-20,2,1,5,2,36,62,98,132.66666666666666
11998,2012-05-20,2,1,5,3,26,40,66,98.0
11999,2012-05-20,2,1,5,4,2,14,16,60.0
12000,2012-05-20,2,1,5,5,1,7,8,30.0
12001,2012-05-20,2,1,5,6,4,21,25,16.333333333333332
12002,2012-05-20,2,1,5,7,35,55,90,41.0
12003,2012-05-20,2,1,5,8,51,120,171,95.33333333333333
12004,2012-05-20,2,1,5,9,129,184,313,191.33333333333334
12005,2012-05-20,2,1,5,10,174,258,432,305.3333333333333
12006,2012-05-20,2,1,5,11,258,323,581,442.0
12007,2012-05-20,2,1,5,12,247,390,637,550.0
12008,2012-05-20,2,1,5,13,244,363,607,608.3333333333334
12009,2012-05-20,2,1,5,14,236,307,543,595.6666666666666
12010,2012-05-20,2,1,5,15,246,256,502,550.6666666666666
12011,2012-05-20,2,1,5,16,238,339,577,540.6666666666666
12012,2012-05-20,2,1,5,17,209,340,549,542.6666666666666
12013,2012-05-20,2,1,5,18,146,328,474,533.3333333333334
12014,2012-05-20,2,1,5,19,142,260,402,475.0
12015,2012-05-20,2,1,5,20,83,191,274,383.3333333333333
12016,2012-05-20,2,1,5,21,51,182,233,303.0
12017,2012-05-20,2,1,5,22,44,101,145,217.33333333333334
12018,2012-05-20,2,1,5,23,32,54,86,154.66666666666666
12019,2012-05-21,2,1,5,0,12,28,40,90.33333333333333
12020,2012-05-21,2,1,5,1,4,11,15,47.0
12021,2012-05-21,2,1,5,2,2,9,11,22.0
12022,2012-05-21,2,1,5,3,0,2,2,9.333333333333334
12023,2012-05-21,2,1,5,4,2,5,7,6.666666666666667
12024,2012-05-21,2,1,5,5,1,14,15,8.0
12025,2012-05-21,2,1,5,6,3,76,79,33.666666666666664
12026,2012-05-21,2,1,5,7,7,146,153,82.33333333333333
12027,2012-05-21,2,1,5,8,12,258,270,167.33333333333334
12028,2012-05-21,2,1,5,9,14,172,186,203.0
12029,2012-05-21,2,1,5,10,28,71,99,185.0
12030,2012-05-21,2,1,5,11,24,82,106,130.33333333333334
12031,2012-05-21,2,1,5,12,46,124,170,125.0
12032,2012-05-21,2,1,5,13,49,135,184,153.33333333333334
12033,2012-05-21,2,1,5,14,45,135,180,178.0
12034,2012-05-21,2,1,5,15,67,158,225,196.33333333333334
12035,2012-05-21,2,1,5,16,46,269,315,240.0
12036,2012-05-21,2,1,5,17,40,468,508,349.3333333333333
12037,2012-05-21,2,1,5,18,52,478,530,451.0
12038,2012-05-21,2,1,5,19,57,391,448,495.3333333333333
12039,2012-05-21,2,1,5,20,44,292,336,438.0
12040,2012-05-21,2,1,5,21,31,210,241,341.6666666666667
12041,2012-05-21,2,1,5,22,26,116,142,239.66666666666666
12042,2012-05-21,2,1,5,23,18,79,97,160.0
12043,2012-05-22,2,1,5,0,10,26,36,91.66666666666667
12044,2012-05-22,2,1,5,1,11,16,27,53.333333333333336
12045,2012-05-22,2,1,5,2,1,10,11,24.666666666666668
12046,2012-05-22,2,1,5,3,0,5,5,14.333333333333334
12047,2012-05-22,2,1,5,4,0,7,7,7.666666666666667
12048,2012-05-22,2,1,5,5,0,17,17,9.666666666666666
12049,2012-05-22,2,1,5,6,8,129,137,53.666666666666664
12050,2012-05-22,2,1,5,7,9,315,324,159.33333333333334
12051,2012-05-22,2,1,5,8,20,570,590,350.3333333333333
12052,2012-05-22,2,1,5,9,46,287,333,415.6666666666667
12053,2012-05-22,2,1,5,10,52,148,200,374.3333333333333
12054,2012-05-22,2,1,5,11,39,150,189,240.66666666666666
12055,2012-05-22,2,1,5,12,76,178,254,214.33333333333334
12056,2012-05-22,2,1,5,13,48,195,243,228.66666666666666
12057,2012-05-22,2,1,5,14,73,149,222,239.66666666666666
12058,2012-05-22,2,1,5,15,54,191,245,236.66666666666666
12059,2012-05-22,2,1,5,16,70,316,386,284.3333333333333
12060,2012-05-22,2,1,5,17,69,716,785,472.0
12061,2012-05-22,2,1,5,18,76,709,785,652.0
12062,2012-05-22,2,1,5,19,44,320,364,644.6666666666666
12063,2012-05-22,2,1,5,20,54,319,373,507.3333333333333
12064,2012-05-22,2,1,5,21,28,233,261,332.6666666666667
12065,2012-05-22,2,1,5,22,17,157,174,269.3333333333333
12066,2012-05-22,2,1,5,23,14,91,105,180.0
12067,2012-05-23,2,1,5,0,19,28,47,108.66666666666667
12068,2012-05-23,2,1,5,1,23,9,32,61.333333333333336
12069,2012-05-23,2,1,5,2,2,10,12,30.333333333333332
12070,2012-05-23,2,1,5,3,0,5,5,16.333333333333332
12071,2012-05-23,2,1,5,4,0,3,3,6.666666666666667
12072,2012-05-23,2,1,5,5,6,29,35,14.333333333333334
12073,2012-05-23,2,1,5,6,6,154,160,66.0
12074,2012-05-23,2,1,5,7,16,452,468,221.0
12075,2012-05-23,2,1,5,8,38,681,719,449.0
12076,2012-05-23,2,1,5,9,39,258,297,494.6666666666667
12077,2012-05-23,2,1,5,10,52,139,191,402.3333333333333
12078,2012-05-23,2,1,5,11,46,151,197,228.33333333333334
12079,2012-05-23,2,1,5,12,42,206,248,212.0
12080,2012-05-23,2,1,5,13,69,201,270,238.33333333333334
12081,2012-05-23,2,1,5,14,67,181,248,255.33333333333334
12082,2012-05-23,2,1,5,15,65,192,257,258.3333333333333
12083,2012-05-23,2,1,5,16,62,216,278,261.0
12084,2012-05-23,2,1,5,17,45,240,285,273.3333333333333
12085,2012-05-23,2,1,5,18,31,296,327,296.6666666666667
12086,2012-05-23,2,1,5,19,40,336,376,329.3333333333333
12087,2012-05-23,2,1,5,20,28,267,295,332.6666666666667
12088,2012-05-23,2,1,5,21,24,221,245,305.3333333333333
12089,2012-05-23,2,1,5,22,23,136,159,233.0
12090,2012-05-23,2,1,5,23,23,83,106,170.0
12091,2012-05-24,2,1,5,0,7,49,56,107.0
12092,2012-05-24,2,1,5,1,9,21,30,64.0
12093,2012-05-24,2,1,5,2,1,15,16,34.0
12094,2012-05-24,2,1,5,3,1,3,4,16.666666666666668
12095,2012-05-24,2,1,5,4,0,5,5,8.333333333333334
12096,2012-05-24,2,1,5,5,1,29,30,13.0
12097,2012-05-24,2,1,5,6,10,146,156,63.666666666666664
12098,2012-05-24,2,1,5,7,22,393,415,200.33333333333334
12099,2012-05-24,2,1,5,8,33,659,692,421.0
12100,2012-05-24,2,1,5,9,34,267,301,469.3333333333333
12101,2012-05-24,2,1,5,10,47,138,185,392.6666666666667
12102,2012-05-24,2,1,5,11,61,160,221,235.66666666666666
12103,2012-05-24,2,1,5,12,76,213,289,231.66666666666666
12104,2012-05-24,2,1,5,13,69,233,302,270.6666666666667
12105,2012-05-24,2,1,5,14,72,180,252,281.0
12106,2012-05-24,2,1,5,15,69,222,291,281.6666666666667
12107,2012-05-24,2,1,5,16,61,329,390,311.0
12108,2012-05-24,2,1,5,17,120,678,798,493.0
12109,2012-05-24,2,1,5,18,118,634,752,646.6666666666666
12110,2012-05-24,2,1,5,19,76,416,492,680.6666666666666
12111,2012-05-24,2,1,5,20,55,343,398,547.3333333333334
12112,2012-05-24,2,1,5,21,48,237,285,391.6666666666667
12113,2012-05-24,2,1,5,22,33,210,243,308.6666666666667
12114,2012-05-24,2,1,5,23,36,131,167,231.66666666666666
12115,2012-05-25,2,1,5,0,10,63,73,161.0
12116,2012-05-25,2,1,5,1,8,34,42,94.0
12117,2012-05-25,2,1,5,2,7,16,23,46.0
12118,2012-05-25,2,1,5,3,8,6,14,26.333333333333332
12119,2012-05-25,2,1,5,4,3,6,9,15.333333333333334
12120,2012-05-25,2,1,5,5,2,28,30,17.666666666666668
12121,2012-05-25,2,1,5,6,5,108,113,50.666666666666664
12122,2012-05-25,2,1,5,7,7,352,359,167.33333333333334
12123,2012-05-25,2,1,5,8,32,551,583,351.6666666666667
12124,2012-05-25,2,1,5,9,52,288,340,427.3333333333333
12125,2012-05-25,2,1,5,10,69,163,232,385.0
12126,2012-05-25,2,1,5,11,90,193,283,285.0
12127,2012-05-25,2,1,5,12,84,237,321,278.6666666666667
12128,2012-05-25,2,1,5,13,86,247,333,312.3333333333333
12129,2012-05-25,2,1,5,14,104,263,367,340.3333333333333
12130,2012-05-25,2,1,5,15,106,360,466,388.6666666666667
12131,2012-05-25,2,1,5,16,137,447,584,472.3333333333333
12132,2012-05-25,2,1,5,17,124,529,653,567.6666666666666
12133,2012-05-25,2,1,5,18,131,391,522,586.3333333333334
12134,2012-05-25,2,1,5,19,111,293,404,526.3333333333334
12135,2012-05-25,2,1,5,20,80,270,350,425.3333333333333
12136,2012-05-25,2,1,5,21,62,193,255,336.3333333333333
12137,2012-05-25,2,1,5,22,65,147,212,272.3333333333333
12138,2012-05-25,2,1,5,23,34,132,166,211.0
12139,2012-05-26,2,1,5,0,18,98,116,164.66666666666666
12140,2012-05-26,2,1,5,1,18,64,82,121.33333333333333
12141,2012-05-26,2,1,5,2,9,55,64,87.33333333333333
12142,2012-05-26,2,1,5,3,9,22,31,59.0
12143,2012-05-26,2,1,5,4,0,2,2,32.333333333333336
12144,2012-05-26,2,1,5,5,0,10,10,14.333333333333334
12145,2012-05-26,2,1,5,6,6,25,31,14.333333333333334
12146,2012-05-26,2,1,5,7,10,44,54,31.666666666666668
12147,2012-05-26,2,1,5,8,38,103,141,75.33333333333333
12148,2012-05-26,2,1,5,9,97,192,289,161.33333333333334
12149,2012-05-26,2,1,5,10,181,256,437,289.0
12150,2012-05-26,2,1,5,11,208,312,520,415.3333333333333
12151,2012-05-26,2,1,5,12,236,293,529,495.3333333333333
12152,2012-05-26,2,1,5,13,265,274,539,529.3333333333334
12153,2012-05-26,2,1,5,14,307,257,564,544.0
12154,2012-05-26,2,1,5,15,274,239,513,538.6666666666666
12155,2012-05-26,2,1,5,16,261,243,504,527.0
12156,2012-05-26,2,1,5,17,235,227,462,493.0
12157,2012-05-26,2,1,5,18,199,216,415,460.3333333333333
12158,2012-05-26,2,1,5,19,159,214,373,416.6666666666667
12159,2012-05-26,2,1,5,20,103,152,255,347.6666666666667
12160,2012-05-26,2,1,5,21,100,151,251,293.0
12161,2012-05-26,2,1,5,22,86,118,204,236.66666666666666
12162,2012-05-26,2,1,5,23,36,114,150,201.66666666666666
12163,2012-05-27,2,1,5,0,48,89,137,163.66666666666666
12164,2012-05-27,2,1,5,1,17,61,78,121.66666666666667
12165,2012-05-27,2,1,5,2,16,45,61,92.0
12166,2012-05-27,2,1,5,3,11,25,36,58.333333333333336
12167,2012-05-27,2,1,5,4,4,7,11,36.0
12168,2012-05-27,2,1,5,5,2,5,7,18.0
12169,2012-05-27,2,1,5,6,8,14,22,13.333333333333334
12170,2012-05-27,2,1,5,7,22,30,52,27.0
12171,2012-05-27,2,1,5,8,69,82,151,75.0
12172,2012-05-27,2,1,5,9,130,140,270,157.66666666666666
12173,2012-05-27,2,1,5,10,209,215,424,281.6666666666667
12174,2012-05-27,2,1,5,11,268,251,519,404.3333333333333
12175,2012-05-27,2,1,5,12,301,269,570,504.3333333333333
12176,2012-05-27,2,1,5,13,270,228,498,529.0
12177,2012-05-27,2,1,5,14,317,230,547,538.3333333333334
12178,2012-05-27,2,1,5,15,290,245,535,526.6666666666666
12179,2012-05-27,2,1,5,16,258,243,501,527.6666666666666
12180,2012-05-27,2,1,5,17,275,247,522,519.3333333333334
12181,2012-05-27,2,1,5,18,266,252,518,513.6666666666666
12182,2012-05-27,2,1,5,19,230,212,442,494.0
12183,2012-05-27,2,1,5,20,168,224,392,450.6666666666667
12184,2012-05-27,2,1,5,21,64,79,143,325.6666666666667
12185,2012-05-27,2,1,5,22,9,50,59,198.0
12186,2012-05-27,2,1,5,23,31,65,96,99.33333333333333
12187,2012-05-28,2,1,5,0,21,44,65,73.33333333333333
12188,2012-05-28,2,1,5,1,14,45,59,73.33333333333333
12189,2012-05-28,2,1,5,2,20,28,48,57.333333333333336
12190,2012-05-28,2,1,5,3,6,12,18,41.666666666666664
12191,2012-05-28,2,1,5,4,2,4,6,24.0
12192,2012-05-28,2,1,5,5,4,5,9,11.0
12193,2012-05-28,2,1,5,6,6,14,20,11.666666666666666
12194,2012-05-28,2,1,5,7,24,43,67,32.0
12195,2012-05-28,2,1,5,8,62,93,155,80.66666666666667
12196,2012-05-28,2,1,5,9,121,142,263,161.66666666666666
12197,2012-05-28,2,1,5,10,189,175,364,260.6666666666667
12198,2012-05-28,2,1,5,11,254,222,476,367.6666666666667
12199,2012-05-28,2,1,5,12,233,292,525,455.0
12200,2012-05-28,2,1,5,13,272,284,556,519.0
12201,2012-05-28,2,1,5,14,238,227,465,515.3333333333334
12202,2012-05-28,2,1,5,15,181,279,460,493.6666666666667
12203,2012-05-28,2,1,5,16,223,278,501,475.3333333333333
12204,2012-05-28,2,1,5,17,158,247,405,455.3333333333333
12205,2012-05-28,2,1,5,18,132,251,383,429.6666666666667
12206,2012-05-28,2,1,5,19,148,247,395,394.3333333333333
12207,2012-05-28,2,1,5,20,114,203,317,365.0
12208,2012-05-28,2,1,5,21,66,181,247,319.6666666666667
12209,2012-05-28,2,1,5,22,47,110,157,240.33333333333334
12210,2012-05-28,2,1,5,23,22,60,82,162.0
12211,2012-05-29,2,1,5,0,12,33,45,94.66666666666667
12212,2012-05-29,2,1,5,1,1,13,14,47.0
12213,2012-05-29,2,1,5,2,0,8,8,22.333333333333332
12214,2012-05-29,2,1,5,3,1,2,3,8.333333333333334
12215,2012-05-29,2,1,5,4,0,5,5,5.333333333333333
12216,2012-05-29,2,1,5,5,1,32,33,13.666666666666666
12217,2012-05-29,2,1,5,6,9,145,154,64.0
12218,2012-05-29,2,1,5,7,19,431,450,212.33333333333334
12219,2012-05-29,2,1,5,8,46,588,634,412.6666666666667
12220,2012-05-29,2,1,5,9,26,231,257,447.0
12221,2012-05-29,2,1,5,10,67,116,183,358.0
12222,2012-05-29,2,1,5,11,50,147,197,212.33333333333334
12223,2012-05-29,2,1,5,12,56,181,237,205.66666666666666
12224,2012-05-29,2,1,5,13,63,176,239,224.33333333333334
12225,2012-05-29,2,1,5,14,80,158,238,238.0
12226,2012-05-29,2,1,5,15,71,185,256,244.33333333333334
12227,2012-05-29,2,1,5,16,73,320,393,295.6666666666667
12228,2012-05-29,2,1,5,17,107,674,781,476.6666666666667
12229,2012-05-29,2,1,5,18,78,632,710,628.0
12230,2012-05-29,2,1,5,19,69,457,526,672.3333333333334
12231,2012-05-29,2,1,5,20,36,168,204,480.0
12232,2012-05-29,2,1,5,21,3,68,71,267.0
12233,2012-05-29,2,1,5,22,2,53,55,110.0
12234,2012-05-29,2,1,5,23,10,40,50,58.666666666666664
12235,2012-05-30,2,1,5,0,4,32,36,47.0
12236,2012-05-30,2,1,5,1,0,4,4,30.0
12237,2012-05-30,2,1,5,2,1,4,5,15.0
12238,2012-05-30,2,1,5,3,0,5,5,4.666666666666667
12239,2012-05-30,2,1,5,4,0,6,6,5.333333333333333
12240,2012-05-30,2,1,5,5,1,40,41,17.333333333333332
12241,2012-05-30,2,1,5,6,5,139,144,63.666666666666664
12242,2012-05-30,2,1,5,7,14,469,483,222.66666666666666
12243,2012-05-30,2,1,5,8,29,642,671,432.6666666666667
12244,2012-05-30,2,1,5,9,23,282,305,486.3333333333333
12245,2012-05-30,2,1,5,10,39,138,177,384.3333333333333
12246,2012-05-30,2,1,5,11,53,155,208,230.0
12247,2012-05-30,2,1,5,12,33,220,253,212.66666666666666
12248,2012-05-30,2,1,5,13,53,236,289,250.0
12249,2012-05-30,2,1,5,14,44,208,252,264.6666666666667
12250,2012-05-30,2,1,5,15,54,221,275,272.0
12251,2012-05-30,2,1,5,16,46,352,398,308.3333333333333
12252,2012-05-30,2,1,5,17,83,756,839,504.0
12253,2012-05-30,2,1,5,18,50,746,796,677.6666666666666
12254,2012-05-30,2,1,5,19,50,506,556,730.3333333333334
12255,2012-05-30,2,1,5,20,57,374,431,594.3333333333334
12256,2012-05-30,2,1,5,21,41,263,304,430.3333333333333
12257,2012-05-30,2,1,5,22,26,191,217,317.3333333333333
12258,2012-05-30,2,1,5,23,39,121,160,227.0
12259,2012-05-31,2,1,5,0,13,48,61,146.0
12260,2012-05-31,2,1,5,1,4,22,26,82.33333333333333
12261,2012-05-31,2,1,5,2,6,8,14,33.666666666666664
12262,2012-05-31,2,1,5,3,0,8,8,16.0
12263,2012-05-31,2,1,5,4,0,8,8,10.0
12264,2012-05-31,2,1,5,5,1,32,33,16.333333333333332
12265,2012-05-31,2,1,5,6,7,171,178,73.0
12266,2012-05-31,2,1,5,7,18,489,507,239.33333333333334
12267,2012-05-31,2,1,5,8,18,675,693,459.3333333333333
12268,2012-05-31,2,1,5,9,47,264,311,503.6666666666667
12269,2012-05-31,2,1,5,10,65,155,220,408.0
12270,2012-05-31,2,1,5,11,65,153,218,249.66666666666666
12271,2012-05-31,2,1,5,12,62,230,292,243.33333333333334
12272,2012-05-31,2,1,5,13,77,216,293,267.6666666666667
12273,2012-05-31,2,1,5,14,61,193,254,279.6666666666667
12274,2012-05-31,2,1,5,15,81,209,290,279.0
12275,2012-05-31,2,1,5,16,103,384,487,343.6666666666667
12276,2012-05-31,2,1,5,17,85,742,827,534.6666666666666
12277,2012-05-31,2,1,5,18,85,700,785,699.6666666666666
12278,2012-05-31,2,1,5,19,104,487,591,734.3333333333334
12279,2012-05-31,2,1,5,20,88,391,479,618.3333333333334
12280,2012-05-31,2,1,5,21,41,318,359,476.3333333333333
12281,2012-05-31,2,1,5,22,43,221,264,367.3333333333333
12282,2012-05-31,2,1,5,23,26,114,140,254.33333333333334
12283,2012-06-01,2,1,6,0,10,76,86,163.33333333333334
12284,2012-06-01,2,1,6,1,0,34,34,86.66666666666667
12285,2012-06-01,2,1,6,2,3,13,16,45.333333333333336
12286,2012-06-01,2,1,6,3,0,4,4,18.0
12287,2012-06-01,2,1,6,4,1,5,6,8.666666666666666
12288,2012-06-01,2,1,6,5,4,41,45,18.333333333333332
12289,2012-06-01,2,1,6,6,5,136,141,64.0
12290,2012-06-01,2,1,6,7,33,369,402,196.0
12291,2012-06-01,2,1,6,8,19,675,694,412.3333333333333
12292,2012-06-01,2,1,6,9,24,274,298,464.6666666666667
12293,2012-06-01,2,1,6,10,49,155,204,398.6666666666667
12294,2012-06-01,2,1,6,11,42,193,235,245.66666666666666
12295,2012-06-01,2,1,6,12,72,238,310,249.66666666666666
12296,2012-06-01,2,1,6,13,76,240,316,287.0
12297,2012-06-01,2,1,6,14,55,199,254,293.3333333333333
12298,2012-06-01,2,1,6,15,45,213,258,276.0
12299,2012-06-01,2,1,6,16,36,186,222,244.66666666666666
12300,2012-06-01,2,1,6,17,25,202,227,235.66666666666666
12301,2012-06-01,2,1,6,18,10,100,110,186.33333333333334
12302,2012-06-01,2,1,6,19,4,41,45,127.33333333333333
12303,2012-06-01,2,1,6,20,1,38,39,64.66666666666667
12304,2012-06-01,2,1,6,21,12,73,85,56.333333333333336
12305,2012-06-01,2,1,6,22,1,22,23,49.0
12306,2012-06-01,2,1,6,23,6,67,73,60.333333333333336
12307,2012-06-02,2,1,6,0,5,81,86,60.666666666666664
12308,2012-06-02,2,1,6,1,15,61,76,78.33333333333333
12309,2012-06-02,2,1,6,2,3,38,41,67.66666666666667
12310,2012-06-02,2,1,6,3,8,18,26,47.666666666666664
12311,2012-06-02,2,1,6,4,2,11,13,26.666666666666668
12312,2012-06-02,2,1,6,5,1,11,12,17.0
12313,2012-06-02,2,1,6,6,5,31,36,20.333333333333332
12314,2012-06-02,2,1,6,7,9,77,86,44.666666666666664
12315,2012-06-02,2,1,6,8,30,180,210,110.66666666666667
12316,2012-06-02,2,1,6,9,89,243,332,209.33333333333334
12317,2012-06-02,2,1,6,10,145,348,493,345.0
12318,2012-06-02,2,1,6,11,179,357,536,453.6666666666667
12319,2012-06-02,2,1,6,12,250,418,668,565.6666666666666
12320,2012-06-02,2,1,6,13,279,400,679,627.6666666666666
12321,2012-06-02,2,1,6,14,259,388,647,664.6666666666666
12322,2012-06-02,2,1,6,15,297,405,702,676.0
12323,2012-06-02,2,1,6,16,275,369,644,664.3333333333334
12324,2012-06-02,2,1,6,17,248,338,586,644.0
12325,2012-06-02,2,1,6,18,171,341,512,580.6666666666666
12326,2012-06-02,2,1,6,19,185,369,554,550.6666666666666
12327,2012-06-02,2,1,6,20,139,260,399,488.3333333333333
12328,2012-06-02,2,1,6,21,96,220,316,423.0
12329,2012-06-02,2,1,6,22,52,176,228,314.3333333333333
12330,2012-06-02,2,1,6,23,53,185,238,260.6666666666667
12331,2012-06-03,2,1,6,0,27,142,169,211.66666666666666
12332,2012-06-03,2,1,6,1,21,100,121,176.0
12333,2012-06-03,2,1,6,2,22,67,89,126.33333333333333
12334,2012-06-03,2,1,6,3,16,34,50,86.66666666666667
12335,2012-06-03,2,1,6,4,1,12,13,50.666666666666664
12336,2012-06-03,2,1,6,5,1,11,12,25.0
12337,2012-06-03,2,1,6,6,6,16,22,15.666666666666666
12338,2012-06-03,2,1,6,7,6,29,35,23.0
12339,2012-06-03,2,1,6,8,30,110,140,65.66666666666667
12340,2012-06-03,2,1,6,9,70,230,300,158.33333333333334
12341,2012-06-03,2,1,6,10,127,277,404,281.3333333333333
12342,2012-06-03,2,1,6,11,199,312,511,405.0
12343,2012-06-03,2,1,6,12,276,408,684,533.0
12344,2012-06-03,2,1,6,13,265,421,686,627.0
12345,2012-06-03,2,1,6,14,267,411,678,682.6666666666666
12346,2012-06-03,2,1,6,15,236,408,644,669.3333333333334
12347,2012-06-03,2,1,6,16,226,436,662,661.3333333333334
12348,2012-06-03,2,1,6,17,192,386,578,628.0
12349,2012-06-03,2,1,6,18,153,343,496,578.6666666666666
12350,2012-06-03,2,1,6,19,116,337,453,509.0
12351,2012-06-03,2,1,6,20,84,230,314,421.0
12352,2012-06-03,2,1,6,21,66,180,246,337.6666666666667
12353,2012-06-03,2,1,6,22,61,165,226,262.0
12354,2012-06-03,2,1,6,23,26,82,108,193.33333333333334
12355,2012-06-04,2,1,6,0,11,38,49,127.66666666666667
12356,2012-06-04,2,1,6,1,4,10,14,57.0
12357,2012-06-04,2,1,6,2,1,10,11,24.666666666666668
12358,2012-06-04,2,1,6,3,0,5,5,10.0
12359,2012-06-04,2,1,6,4,2,6,8,8.0
12360,2012-06-04,2,1,6,5,2,33,35,16.0
12361,2012-06-04,2,1,6,6,4,135,139,60.666666666666664
12362,2012-06-04,2,1,6,7,13,504,517,230.33333333333334
12363,2012-06-04,2,1,6,8,22,643,665,440.3333333333333
12364,2012-06-04,2,1,6,9,38,244,282,488.0
12365,2012-06-04,2,1,6,10,67,120,187,378.0
12366,2012-06-04,2,1,6,11,71,168,239,236.0
12367,2012-06-04,2,1,6,12,62,220,282,236.0
12368,2012-06-04,2,1,6,13,85,189,274,265.0
12369,2012-06-04,2,1,6,14,84,186,270,275.3333333333333
12370,2012-06-04,2,1,6,15,77,215,292,278.6666666666667
12371,2012-06-04,2,1,6,16,73,375,448,336.6666666666667
12372,2012-06-04,2,1,6,17,101,733,834,524.6666666666666
12373,2012-06-04,2,1,6,18,103,719,822,701.3333333333334
12374,2012-06-04,2,1,6,19,91,554,645,767.0
12375,2012-06-04,2,1,6,20,71,390,461,642.6666666666666
12376,2012-06-04,2,1,6,21,40,225,265,457.0
12377,2012-06-04,2,1,6,22,41,127,168,298.0
12378,2012-06-04,2,1,6,23,8,78,86,173.0
12379,2012-06-05,2,1,6,0,6,28,34,96.0
12380,2012-06-05,2,1,6,1,2,18,20,46.666666666666664
12381,2012-06-05,2,1,6,2,0,8,8,20.666666666666668
12382,2012-06-05,2,1,6,3,0,5,5,11.0
12383,2012-06-05,2,1,6,4,1,4,5,6.0
12384,2012-06-05,2,1,6,5,1,35,36,15.333333333333334
12385,2012-06-05,2,1,6,6,7,177,184,75.0
12386,2012-06-05,2,1,6,7,29,540,569,263.0
12387,2012-06-05,2,1,6,8,30,680,710,487.6666666666667
12388,2012-06-05,2,1,6,9,50,285,335,538.0
12389,2012-06-05,2,1,6,10,58,118,176,407.0
12390,2012-06-05,2,1,6,11,65,162,227,246.0
12391,2012-06-05,2,1,6,12,45,202,247,216.66666666666666
12392,2012-06-05,2,1,6,13,66,201,267,247.0
12393,2012-06-05,2,1,6,14,82,194,276,263.3333333333333
12394,2012-06-05,2,1,6,15,54,218,272,271.6666666666667
12395,2012-06-05,2,1,6,16,91,382,473,340.3333333333333
12396,2012-06-05,2,1,6,17,86,764,850,531.6666666666666
12397,2012-06-05,2,1,6,18,111,679,790,704.3333333333334
12398,2012-06-05,2,1,6,19,68,445,513,717.6666666666666
12399,2012-06-05,2,1,6,20,44,371,415,572.6666666666666
12400,2012-06-05,2,1,6,21,30,253,283,403.6666666666667
12401,2012-06-05,2,1,6,22,22,171,193,297.0
12402,2012-06-05,2,1,6,23,20,93,113,196.33333333333334
12403,2012-06-06,2,1,6,0,3,46,49,118.33333333333333
12404,2012-06-06,2,1,6,1,6,21,27,63.0
12405,2012-06-06,2,1,6,2,4,7,11,29.0
12406,2012-06-06,2,1,6,3,0,8,8,15.333333333333334
12407,2012-06-06,2,1,6,4,3,7,10,9.666666666666666
12408,2012-06-06,2,1,6,5,1,37,38,18.666666666666668
12409,2012-06-06,2,1,6,6,7,165,172,73.33333333333333
12410,2012-06-06,2,1,6,7,16,531,547,252.33333333333334
12411,2012-06-06,2,1,6,8,31,637,668,462.3333333333333
12412,2012-06-06,2,1,6,9,35,268,303,506.0
12413,2012-06-06,2,1,6,10,55,148,203,391.3333333333333
12414,2012-06-06,2,1,6,11,65,161,226,244.0
12415,2012-06-06,2,1,6,12,80,235,315,248.0
12416,2012-06-06,2,1,6,13,73,230,303,281.3333333333333
12417,2012-06-06,2,1,6,14,111,191,302,306.6666666666667
12418,2012-06-06,2,1,6,15,75,225,300,301.6666666666667
12419,2012-06-06,2,1,6,16,107,345,452,351.3333333333333
12420,2012-06-06,2,1,6,17,72,652,724,492.0
12421,2012-06-06,2,1,6,18,94,688,782,652.6666666666666
12422,2012-06-06,2,1,6,19,52,486,538,681.3333333333334
12423,2012-06-06,2,1,6,20,59,349,408,576.0
12424,2012-06-06,2,1,6,21,38,260,298,414.6666666666667
12425,2012-06-06,2,1,6,22,27,221,248,318.0
12426,2012-06-06,2,1,6,23,13,110,123,223.0
12427,2012-06-07,2,1,6,0,9,50,59,143.33333333333334
12428,2012-06-07,2,1,6,1,5,17,22,68.0
12429,2012-06-07,2,1,6,2,0,12,12,31.0
12430,2012-06-07,2,1,6,3,0,5,5,13.0
12431,2012-06-07,2,1,6,4,0,6,6,7.666666666666667
12432,2012-06-07,2,1,6,5,0,34,34,15.0
12433,2012-06-07,2,1,6,6,5,165,170,70.0
12434,2012-06-07,2,1,6,7,20,506,526,243.33333333333334
12435,2012-06-07,2,1,6,8,20,661,681,459.0
12436,2012-06-07,2,1,6,9,37,300,337,514.6666666666666
12437,2012-06-07,2,1,6,10,56,154,210,409.3333333333333
12438,2012-06-07,2,1,6,11,67,170,237,261.3333333333333
12439,2012-06-07,2,1,6,12,62,274,336,261.0
12440,2012-06-07,2,1,6,13,65,250,315,296.0
12441,2012-06-07,2,1,6,14,67,198,265,305.3333333333333
12442,2012-06-07,2,1,6,15,99,234,333,304.3333333333333
12443,2012-06-07,2,1,6,16,77,389,466,354.6666666666667
12444,2012-06-07,2,1,6,17,91,778,869,556.0
12445,2012-06-07,2,1,6,18,110,703,813,716.0
12446,2012-06-07,2,1,6,19,65,537,602,761.3333333333334
12447,2012-06-07,2,1,6,20,76,402,478,631.0
12448,2012-06-07,2,1,6,21,30,283,313,464.3333333333333
12449,2012-06-07,2,1,6,22,35,193,228,339.6666666666667
12450,2012-06-07,2,1,6,23,42,135,177,239.33333333333334
12451,2012-06-08,2,1,6,0,18,59,77,160.66666666666666
12452,2012-06-08,2,1,6,1,4,25,29,94.33333333333333
12453,2012-06-08,2,1,6,2,2,17,19,41.666666666666664
12454,2012-06-08,2,1,6,3,0,8,8,18.666666666666668
12455,2012-06-08,2,1,6,4,1,9,10,12.333333333333334
12456,2012-06-08,2,1,6,5,1,28,29,15.666666666666666
12457,2012-06-08,2,1,6,6,8,131,139,59.333333333333336
12458,2012-06-08,2,1,6,7,19,409,428,198.66666666666666
12459,2012-06-08,2,1,6,8,37,663,700,422.3333333333333
12460,2012-06-08,2,1,6,9,47,335,382,503.3333333333333
12461,2012-06-08,2,1,6,10,62,187,249,443.6666666666667
12462,2012-06-08,2,1,6,11,65,199,264,298.3333333333333
12463,2012-06-08,2,1,6,12,89,280,369,294.0
12464,2012-06-08,2,1,6,13,129,287,416,349.6666666666667
12465,2012-06-08,2,1,6,14,128,245,373,386.0
12466,2012-06-08,2,1,6,15,98,299,397,395.3333333333333
12467,2012-06-08,2,1,6,16,111,412,523,431.0
12468,2012-06-08,2,1,6,17,114,679,793,571.0
12469,2012-06-08,2,1,6,18,147,576,723,679.6666666666666
12470,2012-06-08,2,1,6,19,95,460,555,690.3333333333334
12471,2012-06-08,2,1,6,20,117,291,408,562.0
12472,2012-06-08,2,1,6,21,83,256,339,434.0
12473,2012-06-08,2,1,6,22,61,230,291,346.0
12474,2012-06-08,2,1,6,23,52,163,215,281.6666666666667
12475,2012-06-09,2,1,6,0,54,152,206,237.33333333333334
12476,2012-06-09,2,1,6,1,34,89,123,181.33333333333334
12477,2012-06-09,2,1,6,2,21,68,89,139.33333333333334
12478,2012-06-09,2,1,6,3,12,28,40,84.0
12479,2012-06-09,2,1,6,4,2,6,8,45.666666666666664
12480,2012-06-09,2,1,6,5,4,15,19,22.333333333333332
12481,2012-06-09,2,1,6,6,17,63,80,35.666666666666664
12482,2012-06-09,2,1,6,7,26,61,87,62.0
12483,2012-06-09,2,1,6,8,42,202,244,137.0
12484,2012-06-09,2,1,6,9,99,241,340,223.66666666666666
12485,2012-06-09,2,1,6,10,168,298,466,350.0
12486,2012-06-09,2,1,6,11,218,351,569,458.3333333333333
12487,2012-06-09,2,1,6,12,196,335,531,522.0
12488,2012-06-09,2,1,6,13,236,349,585,561.6666666666666
12489,2012-06-09,2,1,6,14,239,354,593,569.6666666666666
12490,2012-06-09,2,1,6,15,218,337,555,577.6666666666666
12491,2012-06-09,2,1,6,16,219,315,534,560.6666666666666
12492,2012-06-09,2,1,6,17,238,257,495,528.0
12493,2012-06-09,2,1,6,18,175,276,451,493.3333333333333
12494,2012-06-09,2,1,6,19,128,232,360,435.3333333333333
12495,2012-06-09,2,1,6,20,125,238,363,391.3333333333333
12496,2012-06-09,2,1,6,21,105,211,316,346.3333333333333
12497,2012-06-09,2,1,6,22,63,151,214,297.6666666666667
12498,2012-06-09,2,1,6,23,69,161,230,253.33333333333334
12499,2012-06-10,2,1,6,0,33,125,158,200.66666666666666
12500,2012-06-10,2,1,6,1,32,84,116,168.0
12501,2012-06-10,2,1,6,2,17,56,73,115.66666666666667
12502,2012-06-10,2,1,6,3,6,23,29,72.66666666666667
12503,2012-06-10,2,1,6,4,1,9,10,37.333333333333336
12504,2012-06-10,2,1,6,5,3,10,13,17.333333333333332
12505,2012-06-10,2,1,6,6,3,27,30,17.666666666666668
12506,2012-06-10,2,1,6,7,21,41,62,35.0
12507,2012-06-10,2,1,6,8,59,122,181,91.0
12508,2012-06-10,2,1,6,9,91,175,266,169.66666666666666
12509,2012-06-10,2,1,6,10,148,265,413,286.6666666666667
12510,2012-06-10,2,1,6,11,184,315,499,392.6666666666667
12511,2012-06-10,2,1,6,12,173,329,502,471.3333333333333
12512,2012-06-10,2,1,6,13,204,288,492,497.6666666666667
12513,2012-06-10,2,1,6,14,186,314,500,498.0
12514,2012-06-10,2,1,6,15,159,316,475,489.0
12515,2012-06-10,2,1,6,16,173,335,508,494.3333333333333
12516,2012-06-10,2,1,6,17,184,337,521,501.3333333333333
12517,2012-06-10,2,1,6,18,164,326,490,506.3333333333333
12518,2012-06-10,2,1,6,19,115,260,375,462.0
12519,2012-06-10,2,1,6,20,113,250,363,409.3333333333333
12520,2012-06-10,2,1,6,21,83,170,253,330.3333333333333
12521,2012-06-10,2,1,6,22,42,117,159,258.3333333333333
12522,2012-06-10,2,1,6,23,30,80,110,174.0
12523,2012-06-11,2,1,6,0,8,33,41,103.33333333333333
12524,2012-06-11,2,1,6,1,9,15,24,58.333333333333336
12525,2012-06-11,2,1,6,2,5,12,17,27.333333333333332
12526,2012-06-11,2,1,6,3,2,4,6,15.666666666666666
12527,2012-06-11,2,1,6,4,0,7,7,10.0
12528,2012-06-11,2,1,6,5,1,36,37,16.666666666666668
12529,2012-06-11,2,1,6,6,8,136,144,62.666666666666664
12530,2012-06-11,2,1,6,7,25,478,503,228.0
12531,2012-06-11,2,1,6,8,38,613,651,432.6666666666667
12532,2012-06-11,2,1,6,9,57,259,316,490.0
12533,2012-06-11,2,1,6,10,52,95,147,371.3333333333333
12534,2012-06-11,2,1,6,11,59,143,202,221.66666666666666
12535,2012-06-11,2,1,6,12,63,198,261,203.33333333333334
12536,2012-06-11,2,1,6,13,63,185,248,237.0
12537,2012-06-11,2,1,6,14,66,193,259,256.0
12538,2012-06-11,2,1,6,15,72,187,259,255.33333333333334
12539,2012-06-11,2,1,6,16,87,340,427,315.0
12540,2012-06-11,2,1,6,17,85,715,800,495.3333333333333
12541,2012-06-11,2,1,6,18,105,726,831,686.0
12542,2012-06-11,2,1,6,19,89,507,596,742.3333333333334
12543,2012-06-11,2,1,6,20,61,333,394,607.0
12544,2012-06-11,2,1,6,21,32,218,250,413.3333333333333
12545,2012-06-11,2,1,6,22,22,142,164,269.3333333333333
12546,2012-06-11,2,1,6,23,8,72,80,164.66666666666666
12547,2012-06-12,2,1,6,0,2,26,28,90.66666666666667
12548,2012-06-12,2,1,6,1,5,11,16,41.333333333333336
12549,2012-06-12,2,1,6,2,0,6,6,16.666666666666668
12550,2012-06-12,2,1,6,3,3,9,12,11.333333333333334
12551,2012-06-12,2,1,6,4,0,4,4,7.333333333333333
12552,2012-06-12,2,1,6,5,1,28,29,15.0
12553,2012-06-12,2,1,6,6,6,130,136,56.333333333333336
12554,2012-06-12,2,1,6,7,16,287,303,156.0
12555,2012-06-12,2,1,6,8,15,598,613,350.6666666666667
12556,2012-06-12,2,1,6,9,31,254,285,400.3333333333333
12557,2012-06-12,2,1,6,10,29,96,125,341.0
12558,2012-06-12,2,1,6,11,8,57,65,158.33333333333334
12559,2012-06-12,2,1,6,12,19,76,95,95.0
12560,2012-06-12,2,1,6,13,11,48,59,73.0
12561,2012-06-12,2,1,6,14,12,48,60,71.33333333333333
12562,2012-06-12,2,1,6,15,22,94,116,78.33333333333333
12563,2012-06-12,2,1,6,16,30,209,239,138.33333333333334
12564,2012-06-12,2,1,6,17,56,625,681,345.3333333333333
12565,2012-06-12,2,1,6,18,57,596,653,524.3333333333334
12566,2012-06-12,2,1,6,19,47,444,491,608.3333333333334
12567,2012-06-12,2,1,6,20,36,350,386,510.0
12568,2012-06-12,2,1,6,21,41,233,274,383.6666666666667
12569,2012-06-12,2,1,6,22,19,188,207,289.0
12570,2012-06-12,2,1,6,23,11,78,89,190.0
12571,2012-06-13,2,1,6,0,7,27,34,110.0
12572,2012-06-13,2,1,6,1,7,21,28,50.333333333333336
12573,2012-06-13,2,1,6,2,0,4,4,22.0
12574,2012-06-13,2,1,6,3,1,7,8,13.333333333333334
12575,2012-06-13,2,1,6,4,1,9,10,7.333333333333333
12576,2012-06-13,2,1,6,5,2,38,40,19.333333333333332
12577,2012-06-13,2,1,6,6,6,188,194,81.33333333333333
12578,2012-06-13,2,1,6,7,25,480,505,246.33333333333334
12579,2012-06-13,2,1,6,8,41,672,713,470.6666666666667
12580,2012-06-13,2,1,6,9,54,298,352,523.3333333333334
12581,2012-06-13,2,1,6,10,64,134,198,421.0
12582,2012-06-13,2,1,6,11,64,182,246,265.3333333333333
12583,2012-06-13,2,1,6,12,93,241,334,259.3333333333333
12584,2012-06-13,2,1,6,13,52,203,255,278.3333333333333
12585,2012-06-13,2,1,6,14,98,222,320,303.0
12586,2012-06-13,2,1,6,15,65,216,281,285.3333333333333
12587,2012-06-13,2,1,6,16,72,320,392,331.0
12588,2012-06-13,2,1,6,17,75,782,857,510.0
12589,2012-06-13,2,1,6,18,104,640,744,664.3333333333334
12590,2012-06-13,2,1,6,19,123,548,671,757.3333333333334
12591,2012-06-13,2,1,6,20,86,362,448,621.0
12592,2012-06-13,2,1,6,21,79,317,396,505.0
12593,2012-06-13,2,1,6,22,29,209,238,360.6666666666667
12594,2012-06-13,2,1,6,23,25,128,153,262.3333333333333
12595,2012-06-14,2,1,6,0,3,45,48,146.33333333333334
12596,2012-06-14,2,1,6,1,4,17,21,74.0
12597,2012-06-14,2,1,6,2,1,8,9,26.0
12598,2012-06-14,2,1,6,3,1,4,5,11.666666666666666
12599,2012-06-14,2,1,6,4,0,6,6,6.666666666666667
12600,2012-06-14,2,1,6,5,0,40,40,17.0
12601,2012-06-14,2,1,6,6,12,169,181,75.66666666666667
12602,2012-06-14,2,1,6,7,26,480,506,242.33333333333334
12603,2012-06-14,2,1,6,8,37,682,719,468.6666666666667
12604,2012-06-14,2,1,6,9,45,312,357,527.3333333333334
12605,2012-06-14,2,1,6,10,47,132,179,418.3333333333333
12606,2012-06-14,2,1,6,11,60,168,228,254.66666666666666
12607,2012-06-14,2,1,6,12,55,210,265,224.0
12608,2012-06-14,2,1,6,13,71,213,284,259.0
12609,2012-06-14,2,1,6,14,84,214,298,282.3333333333333
12610,2012-06-14,2,1,6,15,111,213,324,302.0
12611,2012-06-14,2,1,6,16,70,368,438,353.3333333333333
12612,2012-06-14,2,1,6,17,117,750,867,543.0
12613,2012-06-14,2,1,6,18,107,716,823,709.3333333333334
12614,2012-06-14,2,1,6,19,96,483,579,756.3333333333334
12615,2012-06-14,2,1,6,20,84,351,435,612.3333333333334
12616,2012-06-14,2,1,6,21,67,270,337,450.3333333333333
12617,2012-06-14,2,1,6,22,46,196,242,338.0
12618,2012-06-14,2,1,6,23,36,136,172,250.33333333333334
12619,2012-06-15,2,1,6,0,26,68,94,169.33333333333334
12620,2012-06-15,2,1,6,1,9,42,51,105.66666666666667
12621,2012-06-15,2,1,6,2,0,15,15,53.333333333333336
12622,2012-06-15,2,1,6,3,2,3,5,23.666666666666668
12623,2012-06-15,2,1,6,4,1,13,14,11.333333333333334
12624,2012-06-15,2,1,6,5,2,31,33,17.333333333333332
12625,2012-06-15,2,1,6,6,9,142,151,66.0
12626,2012-06-15,2,1,6,7,17,413,430,204.66666666666666
12627,2012-06-15,2,1,6,8,44,609,653,411.3333333333333
12628,2012-06-15,2,1,6,9,58,308,366,483.0
12629,2012-06-15,2,1,6,10,56,160,216,411.6666666666667
12630,2012-06-15,2,1,6,11,106,180,286,289.3333333333333
12631,2012-06-15,2,1,6,12,111,292,403,301.6666666666667
12632,2012-06-15,2,1,6,13,121,272,393,360.6666666666667
12633,2012-06-15,2,1,6,14,121,255,376,390.6666666666667
12634,2012-06-15,2,1,6,15,107,270,377,382.0
12635,2012-06-15,2,1,6,16,132,426,558,437.0
12636,2012-06-15,2,1,6,17,125,698,823,586.0
12637,2012-06-15,2,1,6,18,121,572,693,691.3333333333334
12638,2012-06-15,2,1,6,19,98,369,467,661.0
12639,2012-06-15,2,1,6,20,89,296,385,515.0
12640,2012-06-15,2,1,6,21,83,250,333,395.0
12641,2012-06-15,2,1,6,22,79,242,321,346.3333333333333
12642,2012-06-15,2,1,6,23,46,176,222,292.0
12643,2012-06-16,2,1,6,0,25,112,137,226.66666666666666
12644,2012-06-16,2,1,6,1,16,79,95,151.33333333333334
12645,2012-06-16,2,1,6,2,12,55,67,99.66666666666667
12646,2012-06-16,2,1,6,3,8,19,27,63.0
12647,2012-06-16,2,1,6,4,3,5,8,34.0
12648,2012-06-16,2,1,6,5,2,21,23,19.333333333333332
12649,2012-06-16,2,1,6,6,11,36,47,26.0
12650,2012-06-16,2,1,6,7,10,68,78,49.333333333333336
12651,2012-06-16,2,1,6,8,47,157,204,109.66666666666667
12652,2012-06-16,2,1,6,9,88,279,367,216.33333333333334
12653,2012-06-16,2,1,6,10,139,296,435,335.3333333333333
12654,2012-06-16,2,1,6,11,213,353,566,456.0
12655,2012-06-16,2,1,6,12,254,349,603,534.6666666666666
12656,2012-06-16,2,1,6,13,293,324,617,595.3333333333334
12657,2012-06-16,2,1,6,14,264,309,573,597.6666666666666
12658,2012-06-16,2,1,6,15,295,288,583,591.0
12659,2012-06-16,2,1,6,16,238,304,542,566.0
12660,2012-06-16,2,1,6,17,244,349,593,572.6666666666666
12661,2012-06-16,2,1,6,18,256,315,571,568.6666666666666
12662,2012-06-16,2,1,6,19,184,277,461,541.6666666666666
12663,2012-06-16,2,1,6,20,123,229,352,461.3333333333333
12664,2012-06-16,2,1,6,21,98,192,290,367.6666666666667
12665,2012-06-16,2,1,6,22,91,189,280,307.3333333333333
12666,2012-06-16,2,1,6,23,49,134,183,251.0
12667,2012-06-17,2,1,6,0,31,117,148,203.66666666666666
12668,2012-06-17,2,1,6,1,21,67,88,139.66666666666666
12669,2012-06-17,2,1,6,2,19,55,74,103.33333333333333
12670,2012-06-17,2,1,6,3,6,22,28,63.333333333333336
12671,2012-06-17,2,1,6,4,2,16,18,40.0
12672,2012-06-17,2,1,6,5,4,13,17,21.0
12673,2012-06-17,2,1,6,6,7,16,23,19.333333333333332
12674,2012-06-17,2,1,6,7,18,30,48,29.333333333333332
12675,2012-06-17,2,1,6,8,24,95,119,63.333333333333336
12676,2012-06-17,2,1,6,9,91,183,274,147.0
12677,2012-06-17,2,1,6,10,148,288,436,276.3333333333333
12678,2012-06-17,2,1,6,11,196,350,546,418.6666666666667
12679,2012-06-17,2,1,6,12,260,355,615,532.3333333333334
12680,2012-06-17,2,1,6,13,267,347,614,591.6666666666666
12681,2012-06-17,2,1,6,14,255,327,582,603.6666666666666
12682,2012-06-17,2,1,6,15,203,260,463,553.0
12683,2012-06-17,2,1,6,16,240,340,580,541.6666666666666
12684,2012-06-17,2,1,6,17,232,361,593,545.3333333333334
12685,2012-06-17,2,1,6,18,203,310,513,562.0
12686,2012-06-17,2,1,6,19,146,244,390,498.6666666666667
12687,2012-06-17,2,1,6,20,101,201,302,401.6666666666667
12688,2012-06-17,2,1,6,21,76,170,246,312.6666666666667
12689,2012-06-17,2,1,6,22,55,98,153,233.66666666666666
12690,2012-06-17,2,1,6,23,29,79,108,169.0
12691,2012-06-18,2,1,6,0,12,28,40,100.33333333333333
12692,2012-06-18,2,1,6,1,9,5,14,54.0
12693,2012-06-18,2,1,6,2,3,6,9,21.0
12694,2012-06-18,2,1,6,3,1,3,4,9.0
12695,2012-06-18,2,1,6,4,0,9,9,7.333333333333333
12696,2012-06-18,2,1,6,5,1,22,23,12.0
12697,2012-06-18,2,1,6,6,0,37,37,23.0
12698,2012-06-18,2,1,6,7,10,135,145,68.33333333333333
12699,2012-06-18,2,1,6,8,27,447,474,218.66666666666666
12700,2012-06-18,2,1,6,9,28,222,250,289.6666666666667
12701,2012-06-18,2,1,6,10,13,78,91,271.6666666666667
12702,2012-06-18,2,1,6,11,25,96,121,154.0
12703,2012-06-18,2,1,6,12,29,139,168,126.66666666666667
12704,2012-06-18,2,1,6,13,51,174,225,171.33333333333334
12705,2012-06-18,2,1,6,14,59,160,219,204.0
12706,2012-06-18,2,1,6,15,61,176,237,227.0
12707,2012-06-18,2,1,6,16,53,279,332,262.6666666666667
12708,2012-06-18,2,1,6,17,54,669,723,430.6666666666667
12709,2012-06-18,2,1,6,18,47,595,642,565.6666666666666
12710,2012-06-18,2,1,6,19,52,411,463,609.3333333333334
12711,2012-06-18,2,1,6,20,45,317,362,489.0
12712,2012-06-18,2,1,6,21,35,238,273,366.0
12713,2012-06-18,2,1,6,22,21,143,164,266.3333333333333
12714,2012-06-18,2,1,6,23,17,57,74,170.33333333333334
12715,2012-06-19,2,1,6,0,5,30,35,91.0
12716,2012-06-19,2,1,6,1,1,13,14,41.0
12717,2012-06-19,2,1,6,2,1,14,15,21.333333333333332
12718,2012-06-19,2,1,6,3,1,7,8,12.333333333333334
12719,2012-06-19,2,1,6,4,1,9,10,11.0
12720,2012-06-19,2,1,6,5,3,34,37,18.333333333333332
12721,2012-06-19,2,1,6,6,9,152,161,69.33333333333333
12722,2012-06-19,2,1,6,7,18,462,480,226.0
12723,2012-06-19,2,1,6,8,40,633,673,438.0
12724,2012-06-19,2,1,6,9,40,288,328,493.6666666666667
12725,2012-06-19,2,1,6,10,44,136,180,393.6666666666667
12726,2012-06-19,2,1,6,11,56,174,230,246.0
12727,2012-06-19,2,1,6,12,70,222,292,234.0
12728,2012-06-19,2,1,6,13,69,203,272,264.6666666666667
12729,2012-06-19,2,1,6,14,61,166,227,263.6666666666667
12730,2012-06-19,2,1,6,15,72,187,259,252.66666666666666
12731,2012-06-19,2,1,6,16,48,286,334,273.3333333333333
12732,2012-06-19,2,1,6,17,86,725,811,468.0
12733,2012-06-19,2,1,6,18,91,704,795,646.6666666666666
12734,2012-06-19,2,1,6,19,82,432,514,706.6666666666666
12735,2012-06-19,2,1,6,20,59,399,458,589.0
12736,2012-06-19,2,1,6,21,37,239,276,416.0
12737,2012-06-19,2,1,6,22,51,240,291,341.6666666666667
12738,2012-06-19,2,1,6,23,23,102,125,230.66666666666666
12739,2012-06-20,2,1,6,0,5,48,53,156.33333333333334
12740,2012-06-20,2,1,6,1,7,20,27,68.33333333333333
12741,2012-06-20,2,1,6,2,1,5,6,28.666666666666668
12742,2012-06-20,2,1,6,3,2,6,8,13.666666666666666
12743,2012-06-20,2,1,6,4,1,6,7,7.0
12744,2012-06-20,2,1,6,5,2,37,39,18.0
12745,2012-06-20,2,1,6,6,9,156,165,70.33333333333333
12746,2012-06-20,2,1,6,7,20,444,464,222.66666666666666
12747,2012-06-20,2,1,6,8,43,600,643,424.0
12748,2012-06-20,2,1,6,9,40,276,316,474.3333333333333
12749,2012-06-20,2,1,6,10,41,126,167,375.3333333333333
12750,2012-06-20,2,1,6,11,54,134,188,223.66666666666666
12751,2012-06-20,2,1,6,12,30,150,180,178.33333333333334
12752,2012-06-20,2,1,6,13,48,163,211,193.0
12753,2012-06-20,2,1,6,14,56,134,190,193.66666666666666
12754,2012-06-20,2,1,6,15,36,143,179,193.33333333333334
12755,2012-06-20,2,1,6,16,51,284,335,234.66666666666666
12756,2012-06-20,2,1,6,17,80,611,691,401.6666666666667
12757,2012-06-20,2,1,6,18,81,591,672,566.0
12758,2012-06-20,2,1,6,19,90,449,539,634.0
12759,2012-06-20,2,1,6,20,81,326,407,539.3333333333334
12760,2012-06-20,2,1,6,21,42,302,344,430.0
12761,2012-06-20,2,1,6,22,31,226,257,336.0
12762,2012-06-20,2,1,6,23,21,102,123,241.33333333333334
12763,2012-06-21,3,1,6,0,16,53,69,149.66666666666666
12764,2012-06-21,3,1,6,1,2,16,18,70.0
12765,2012-06-21,3,1,6,2,11,7,18,35.0
12766,2012-06-21,3,1,6,3,3,8,11,15.666666666666666
12767,2012-06-21,3,1,6,4,1,11,12,13.666666666666666
12768,2012-06-21,3,1,6,5,3,37,40,21.0
12769,2012-06-21,3,1,6,6,3,147,150,67.33333333333333
12770,2012-06-21,3,1,6,7,26,437,463,217.66666666666666
12771,2012-06-21,3,1,6,8,27,563,590,401.0
12772,2012-06-21,3,1,6,9,32,224,256,436.3333333333333
12773,2012-06-21,3,1,6,10,36,114,150,332.0
12774,2012-06-21,3,1,6,11,40,121,161,189.0
12775,2012-06-21,3,1,6,12,33,182,215,175.33333333333334
12776,2012-06-21,3,1,6,13,31,141,172,182.66666666666666
12777,2012-06-21,3,1,6,14,27,149,176,187.66666666666666
12778,2012-06-21,3,1,6,15,40,154,194,180.66666666666666
12779,2012-06-21,3,1,6,16,37,283,320,230.0
12780,2012-06-21,3,1,6,17,80,535,615,376.3333333333333
12781,2012-06-21,3,1,6,18,78,562,640,525.0
12782,2012-06-21,3,1,6,19,84,415,499,584.6666666666666
12783,2012-06-21,3,1,6,20,79,357,436,525.0
12784,2012-06-21,3,1,6,21,55,256,311,415.3333333333333
12785,2012-06-21,3,1,6,22,22,221,243,330.0
12786,2012-06-21,3,1,6,23,12,134,146,233.33333333333334
12787,2012-06-22,3,1,6,0,16,77,93,160.66666666666666
12788,2012-06-22,3,1,6,1,3,28,31,90.0
12789,2012-06-22,3,1,6,2,0,12,12,45.333333333333336
12790,2012-06-22,3,1,6,3,1,6,7,16.666666666666668
12791,2012-06-22,3,1,6,4,3,7,10,9.666666666666666
12792,2012-06-22,3,1,6,5,3,35,38,18.333333333333332
12793,2012-06-22,3,1,6,6,4,118,122,56.666666666666664
12794,2012-06-22,3,1,6,7,19,340,359,173.0
12795,2012-06-22,3,1,6,8,49,564,613,364.6666666666667
12796,2012-06-22,3,1,6,9,55,278,333,435.0
12797,2012-06-22,3,1,6,10,52,133,185,377.0
12798,2012-06-22,3,1,6,11,76,160,236,251.33333333333334
12799,2012-06-22,3,1,6,12,63,191,254,225.0
12800,2012-06-22,3,1,6,13,72,228,300,263.3333333333333
12801,2012-06-22,3,1,6,14,65,198,263,272.3333333333333
12802,2012-06-22,3,1,6,15,72,212,284,282.3333333333333
12803,2012-06-22,3,1,6,16,67,313,380,309.0
12804,2012-06-22,3,1,6,17,95,551,646,436.6666666666667
12805,2012-06-22,3,1,6,18,62,443,505,510.3333333333333
12806,2012-06-22,3,1,6,19,45,317,362,504.3333333333333
12807,2012-06-22,3,1,6,20,31,171,202,356.3333333333333
12808,2012-06-22,3,1,6,21,40,177,217,260.3333333333333
12809,2012-06-22,3,1,6,22,42,155,197,205.33333333333334
12810,2012-06-22,3,1,6,23,29,145,174,196.0
12811,2012-06-23,3,1,6,0,14,102,116,162.33333333333334
12812,2012-06-23,3,1,6,1,16,107,123,137.66666666666666
12813,2012-06-23,3,1,6,2,18,75,93,110.66666666666667
12814,2012-06-23,3,1,6,3,10,32,42,86.0
12815,2012-06-23,3,1,6,4,6,13,19,51.333333333333336
12816,2012-06-23,3,1,6,5,1,11,12,24.333333333333332
12817,2012-06-23,3,1,6,6,10,37,47,26.0
12818,2012-06-23,3,1,6,7,19,59,78,45.666666666666664
12819,2012-06-23,3,1,6,8,34,133,167,97.33333333333333
12820,2012-06-23,3,1,6,9,85,247,332,192.33333333333334
12821,2012-06-23,3,1,6,10,177,317,494,331.0
12822,2012-06-23,3,1,6,11,167,349,516,447.3333333333333
12823,2012-06-23,3,1,6,12,203,399,602,537.3333333333334
12824,2012-06-23,3,1,6,13,226,338,564,560.6666666666666
12825,2012-06-23,3,1,6,14,238,371,609,591.6666666666666
12826,2012-06-23,3,1,6,15,217,266,483,552.0
12827,2012-06-23,3,1,6,16,196,317,513,535.0
12828,2012-06-23,3,1,6,17,214,316,530,508.6666666666667
12829,2012-06-23,3,1,6,18,194,287,481,508.0
12830,2012-06-23,3,1,6,19,185,240,425,478.6666666666667
12831,2012-06-23,3,1,6,20,158,228,386,430.6666666666667
12832,2012-06-23,3,1,6,21,99,223,322,377.6666666666667
12833,2012-06-23,3,1,6,22,101,178,279,329.0
12834,2012-06-23,3,1,6,23,69,156,225,275.3333333333333
12835,2012-06-24,3,1,6,0,31,132,163,222.33333333333334
12836,2012-06-24,3,1,6,1,39,88,127,171.66666666666666
12837,2012-06-24,3,1,6,2,34,80,114,134.66666666666666
12838,2012-06-24,3,1,6,3,19,41,60,100.33333333333333
12839,2012-06-24,3,1,6,4,4,9,13,62.333333333333336
12840,2012-06-24,3,1,6,5,1,7,8,27.0
12841,2012-06-24,3,1,6,6,6,19,25,15.333333333333334
12842,2012-06-24,3,1,6,7,23,48,71,34.666666666666664
12843,2012-06-24,3,1,6,8,38,103,141,79.0
12844,2012-06-24,3,1,6,9,63,169,232,148.0
12845,2012-06-24,3,1,6,10,161,291,452,275.0
12846,2012-06-24,3,1,6,11,215,291,506,396.6666666666667
12847,2012-06-24,3,1,6,12,227,329,556,504.6666666666667
12848,2012-06-24,3,1,6,13,237,348,585,549.0
12849,2012-06-24,3,1,6,14,253,298,551,564.0
12850,2012-06-24,3,1,6,15,197,290,487,541.0
12851,2012-06-24,3,1,6,16,181,280,461,499.6666666666667
12852,2012-06-24,3,1,6,17,203,329,532,493.3333333333333
12853,2012-06-24,3,1,6,18,186,348,534,509.0
12854,2012-06-24,3,1,6,19,176,247,423,496.3333333333333
12855,2012-06-24,3,1,6,20,108,224,332,429.6666666666667
12856,2012-06-24,3,1,6,21,76,177,253,336.0
12857,2012-06-24,3,1,6,22,53,125,178,254.33333333333334
12858,2012-06-24,3,1,6,23,20,67,87,172.66666666666666
12859,2012-06-25,3,1,6,0,31,37,68,111.0
12860,2012-06-25,3,1,6,1,11,20,31,62.0
12861,2012-06-25,3,1,6,2,4,10,14,37.666666666666664
12862,2012-06-25,3,1,6,3,1,4,5,16.666666666666668
12863,2012-06-25,3,1,6,4,0,4,4,7.666666666666667
12864,2012-06-25,3,1,6,5,1,42,43,17.333333333333332
12865,2012-06-25,3,1,6,6,11,147,158,68.33333333333333
12866,2012-06-25,3,1,6,7,30,455,485,228.66666666666666
12867,2012-06-25,3,1,6,8,53,555,608,417.0
12868,2012-06-25,3,1,6,9,37,231,268,453.6666666666667
12869,2012-06-25,3,1,6,10,58,126,184,353.3333333333333
12870,2012-06-25,3,1,6,11,54,127,181,211.0
12871,2012-06-25,3,1,6,12,74,196,270,211.66666666666666
12872,2012-06-25,3,1,6,13,79,181,260,237.0
12873,2012-06-25,3,1,6,14,90,161,251,260.3333333333333
12874,2012-06-25,3,1,6,15,65,168,233,248.0
12875,2012-06-25,3,1,6,16,104,310,414,299.3333333333333
12876,2012-06-25,3,1,6,17,76,757,833,493.3333333333333
12877,2012-06-25,3,1,6,18,100,691,791,679.3333333333334
12878,2012-06-25,3,1,6,19,74,508,582,735.3333333333334
12879,2012-06-25,3,1,6,20,100,375,475,616.0
12880,2012-06-25,3,1,6,21,50,281,331,462.6666666666667
12881,2012-06-25,3,1,6,22,21,166,187,331.0
12882,2012-06-25,3,1,6,23,15,88,103,207.0
12883,2012-06-26,3,1,6,0,8,29,37,109.0
12884,2012-06-26,3,1,6,1,11,19,30,56.666666666666664
12885,2012-06-26,3,1,6,2,2,7,9,25.333333333333332
12886,2012-06-26,3,1,6,3,2,7,9,16.0
12887,2012-06-26,3,1,6,4,1,9,10,9.333333333333334
12888,2012-06-26,3,1,6,5,3,36,39,19.333333333333332
12889,2012-06-26,3,1,6,6,12,176,188,79.0
12890,2012-06-26,3,1,6,7,21,531,552,259.6666666666667
12891,2012-06-26,3,1,6,8,34,622,656,465.3333333333333
12892,2012-06-26,3,1,6,9,30,298,328,512.0
12893,2012-06-26,3,1,6,10,37,153,190,391.3333333333333
12894,2012-06-26,3,1,6,11,46,189,235,251.0
12895,2012-06-26,3,1,6,12,80,228,308,244.33333333333334
12896,2012-06-26,3,1,6,13,74,232,306,283.0
12897,2012-06-26,3,1,6,14,81,186,267,293.6666666666667
12898,2012-06-26,3,1,6,15,88,229,317,296.6666666666667
12899,2012-06-26,3,1,6,16,67,349,416,333.3333333333333
12900,2012-06-26,3,1,6,17,104,796,900,544.3333333333334
12901,2012-06-26,3,1,6,18,105,719,824,713.3333333333334
12902,2012-06-26,3,1,6,19,83,529,612,778.6666666666666
12903,2012-06-26,3,1,6,20,88,417,505,647.0
12904,2012-06-26,3,1,6,21,61,267,328,481.6666666666667
12905,2012-06-26,3,1,6,22,26,219,245,359.3333333333333
12906,2012-06-26,3,1,6,23,13,118,131,234.66666666666666
12907,2012-06-27,3,1,6,0,15,39,54,143.33333333333334
12908,2012-06-27,3,1,6,1,5,18,23,69.33333333333333
12909,2012-06-27,3,1,6,2,2,12,14,30.333333333333332
12910,2012-06-27,3,1,6,3,1,7,8,15.0
12911,2012-06-27,3,1,6,4,0,11,11,11.0
12912,2012-06-27,3,1,6,5,2,34,36,18.333333333333332
12913,2012-06-27,3,1,6,6,7,193,200,82.33333333333333
12914,2012-06-27,3,1,6,7,29,498,527,254.33333333333334
12915,2012-06-27,3,1,6,8,49,638,687,471.3333333333333
12916,2012-06-27,3,1,6,9,29,253,282,498.6666666666667
12917,2012-06-27,3,1,6,10,34,138,172,380.3333333333333
12918,2012-06-27,3,1,6,11,64,145,209,221.0
12919,2012-06-27,3,1,6,12,77,245,322,234.33333333333334
12920,2012-06-27,3,1,6,13,77,244,321,284.0
12921,2012-06-27,3,1,6,14,78,192,270,304.3333333333333
12922,2012-06-27,3,1,6,15,61,188,249,280.0
12923,2012-06-27,3,1,6,16,55,337,392,303.6666666666667
12924,2012-06-27,3,1,6,17,113,730,843,494.6666666666667
12925,2012-06-27,3,1,6,18,85,719,804,679.6666666666666
12926,2012-06-27,3,1,6,19,101,542,643,763.3333333333334
12927,2012-06-27,3,1,6,20,76,369,445,630.6666666666666
12928,2012-06-27,3,1,6,21,54,313,367,485.0
12929,2012-06-27,3,1,6,22,52,245,297,369.6666666666667
12930,2012-06-27,3,1,6,23,11,148,159,274.3333333333333
12931,2012-06-28,3,1,6,0,2,52,54,170.0
12932,2012-06-28,3,1,6,1,11,14,25,79.33333333333333
12933,2012-06-28,3,1,6,2,1,12,13,30.666666666666668
12934,2012-06-28,3,1,6,3,1,6,7,15.0
12935,2012-06-28,3,1,6,4,0,11,11,10.333333333333334
12936,2012-06-28,3,1,6,5,8,39,47,21.666666666666668
12937,2012-06-28,3,1,6,6,8,185,193,83.66666666666667
12938,2012-06-28,3,1,6,7,24,484,508,249.33333333333334
12939,2012-06-28,3,1,6,8,40,577,617,439.3333333333333
12940,2012-06-28,3,1,6,9,33,318,351,492.0
12941,2012-06-28,3,1,6,10,40,144,184,384.0
12942,2012-06-28,3,1,6,11,41,170,211,248.66666666666666
12943,2012-06-28,3,1,6,12,49,227,276,223.66666666666666
12944,2012-06-28,3,1,6,13,31,205,236,241.0
12945,2012-06-28,3,1,6,14,66,188,254,255.33333333333334
12946,2012-06-28,3,1,6,15,24,195,219,236.33333333333334
12947,2012-06-28,3,1,6,16,56,331,387,286.6666666666667
12948,2012-06-28,3,1,6,17,71,634,705,437.0
12949,2012-06-28,3,1,6,18,100,597,697,596.3333333333334
12950,2012-06-28,3,1,6,19,79,492,571,657.6666666666666
12951,2012-06-28,3,1,6,20,71,399,470,579.3333333333334
12952,2012-06-28,3,1,6,21,89,309,398,479.6666666666667
12953,2012-06-28,3,1,6,22,50,224,274,380.6666666666667
12954,2012-06-28,3,1,6,23,26,145,171,281.0
12955,2012-06-29,3,1,6,0,24,90,114,186.33333333333334
12956,2012-06-29,3,1,6,1,9,33,42,109.0
12957,2012-06-29,3,1,6,2,3,15,18,58.0
12958,2012-06-29,3,1,6,3,3,5,8,22.666666666666668
12959,2012-06-29,3,1,6,4,1,9,10,12.0
12960,2012-06-29,3,1,6,5,6,39,45,21.0
12961,2012-06-29,3,1,6,6,15,148,163,72.66666666666667
12962,2012-06-29,3,1,6,7,19,361,380,196.0
12963,2012-06-29,3,1,6,8,48,576,624,389.0
12964,2012-06-29,3,1,6,9,39,261,300,434.6666666666667
12965,2012-06-29,3,1,6,10,32,139,171,365.0
12966,2012-06-29,3,1,6,11,51,137,188,219.66666666666666
12967,2012-06-29,3,1,6,12,53,173,226,195.0
12968,2012-06-29,3,1,6,13,45,194,239,217.66666666666666
12969,2012-06-29,3,1,6,14,49,184,233,232.66666666666666
12970,2012-06-29,3,1,6,15,47,183,230,234.0
12971,2012-06-29,3,1,6,16,59,292,351,271.3333333333333
12972,2012-06-29,3,1,6,17,82,457,539,373.3333333333333
12973,2012-06-29,3,1,6,18,50,414,464,451.3333333333333
12974,2012-06-29,3,1,6,19,60,303,363,455.3333333333333
12975,2012-06-29,3,1,6,20,53,255,308,378.3333333333333
12976,2012-06-29,3,1,6,21,41,195,236,302.3333333333333
12977,2012-06-29,3,1,6,22,34,129,163,235.66666666666666
12978,2012-06-29,3,1,6,23,6,42,48,149.0
12979,2012-06-30,3,1,6,0,4,65,69,93.33333333333333
12980,2012-06-30,3,1,6,1,3,55,58,58.333333333333336
12981,2012-06-30,3,1,6,2,7,54,61,62.666666666666664
12982,2012-06-30,3,1,6,3,3,20,23,47.333333333333336
12983,2012-06-30,3,1,6,4,3,15,18,34.0
12984,2012-06-30,3,1,6,5,3,7,10,17.0
12985,2012-06-30,3,1,6,6,6,36,42,23.333333333333332
12986,2012-06-30,3,1,6,7,10,82,92,48.0
12987,2012-06-30,3,1,6,8,26,168,194,109.33333333333333
12988,2012-06-30,3,1,6,9,41,234,275,187.0
12989,2012-06-30,3,1,6,10,96,308,404,291.0
12990,2012-06-30,3,1,6,11,102,350,452,377.0
12991,2012-06-30,3,1,6,12,143,328,471,442.3333333333333
12992,2012-06-30,3,1,6,13,105,323,428,450.3333333333333
12993,2012-06-30,3,1,6,14,114,295,409,436.0
12994,2012-06-30,3,1,6,15,117,287,404,413.6666666666667
12995,2012-06-30,3,1,6,16,109,264,373,395.3333333333333
12996,2012-06-30,3,1,6,17,131,231,362,379.6666666666667
12997,2012-06-30,3,1,6,18,91,248,339,358.0
12998,2012-06-30,3,1,6,19,134,240,374,358.3333333333333
12999,2012-06-30,3,1,6,20,88,204,292,335.0
13000,2012-06-30,3,1,6,21,48,165,213,293.0
13001,2012-06-30,3,1,6,22,38,134,172,225.66666666666666
13002,2012-06-30,3,1,6,23,33,119,152,179.0
13003,2012-07-01,3,1,7,0,27,122,149,157.66666666666666
13004,2012-07-01,3,1,7,1,12,81,93,131.33333333333334
13005,2012-07-01,3,1,7,2,21,69,90,110.66666666666667
13006,2012-07-01,3,1,7,3,6,27,33,72.0
13007,2012-07-01,3,1,7,4,0,4,4,42.333333333333336
13008,2012-07-01,3,1,7,5,3,7,10,15.666666666666666
13009,2012-07-01,3,1,7,6,8,19,27,13.666666666666666
13010,2012-07-01,3,1,7,7,13,37,50,29.0
13011,2012-07-01,3,1,7,8,36,106,142,73.0
13012,2012-07-01,3,1,7,9,51,168,219,137.0
13013,2012-07-01,3,1,7,10,98,268,366,242.33333333333334
13014,2012-07-01,3,1,7,11,121,256,377,320.6666666666667
13015,2012-07-01,3,1,7,12,114,319,433,392.0
13016,2012-07-01,3,1,7,13,111,309,420,410.0
13017,2012-07-01,3,1,7,14,98,346,444,432.3333333333333
13018,2012-07-01,3,1,7,15,101,244,345,403.0
13019,2012-07-01,3,1,7,16,85,228,313,367.3333333333333
13020,2012-07-01,3,1,7,17,90,323,413,357.0
13021,2012-07-01,3,1,7,18,95,275,370,365.3333333333333
13022,2012-07-01,3,1,7,19,103,279,382,388.3333333333333
13023,2012-07-01,3,1,7,20,88,244,332,361.3333333333333
13024,2012-07-01,3,1,7,21,77,181,258,324.0
13025,2012-07-01,3,1,7,22,41,110,151,247.0
13026,2012-07-01,3,1,7,23,22,88,110,173.0
13027,2012-07-02,3,1,7,0,12,31,43,101.33333333333333
13028,2012-07-02,3,1,7,1,3,14,17,56.666666666666664
13029,2012-07-02,3,1,7,2,1,14,15,25.0
13030,2012-07-02,3,1,7,3,0,5,5,12.333333333333334
13031,2012-07-02,3,1,7,4,2,10,12,10.666666666666666
13032,2012-07-02,3,1,7,5,3,37,40,19.0
13033,2012-07-02,3,1,7,6,4,132,136,62.666666666666664
13034,2012-07-02,3,1,7,7,8,390,398,191.33333333333334
13035,2012-07-02,3,1,7,8,20,548,568,367.3333333333333
13036,2012-07-02,3,1,7,9,56,239,295,420.3333333333333
13037,2012-07-02,3,1,7,10,70,104,174,345.6666666666667
13038,2012-07-02,3,1,7,11,67,134,201,223.33333333333334
13039,2012-07-02,3,1,7,12,74,183,257,210.66666666666666
13040,2012-07-02,3,1,7,13,74,162,236,231.33333333333334
13041,2012-07-02,3,1,7,14,79,151,230,241.0
13042,2012-07-02,3,1,7,15,59,175,234,233.33333333333334
13043,2012-07-02,3,1,7,16,61,304,365,276.3333333333333
13044,2012-07-02,3,1,7,17,82,665,747,448.6666666666667
13045,2012-07-02,3,1,7,18,72,658,730,614.0
13046,2012-07-02,3,1,7,19,71,510,581,686.0
13047,2012-07-02,3,1,7,20,38,357,395,568.6666666666666
13048,2012-07-02,3,1,7,21,17,241,258,411.3333333333333
13049,2012-07-02,3,1,7,22,19,169,188,280.3333333333333
13050,2012-07-02,3,1,7,23,12,90,102,182.66666666666666
13051,2012-07-03,3,1,7,0,9,44,53,114.33333333333333
13052,2012-07-03,3,1,7,1,5,9,14,56.333333333333336
13053,2012-07-03,3,1,7,2,2,8,10,25.666666666666668
13054,2012-07-03,3,1,7,3,0,2,2,8.666666666666666
13055,2012-07-03,3,1,7,4,0,6,6,6.0
13056,2012-07-03,3,1,7,5,2,33,35,14.333333333333334
13057,2012-07-03,3,1,7,6,5,149,154,65.0
13058,2012-07-03,3,1,7,7,21,462,483,224.0
13059,2012-07-03,3,1,7,8,42,604,646,427.6666666666667
13060,2012-07-03,3,1,7,9,46,226,272,467.0
13061,2012-07-03,3,1,7,10,56,153,209,375.6666666666667
13062,2012-07-03,3,1,7,11,66,151,217,232.66666666666666
13063,2012-07-03,3,1,7,12,74,198,272,232.66666666666666
13064,2012-07-03,3,1,7,13,80,203,283,257.3333333333333
13065,2012-07-03,3,1,7,14,69,241,310,288.3333333333333
13066,2012-07-03,3,1,7,15,71,330,401,331.3333333333333
13067,2012-07-03,3,1,7,16,90,437,527,412.6666666666667
13068,2012-07-03,3,1,7,17,102,620,722,550.0
13069,2012-07-03,3,1,7,18,85,542,627,625.3333333333334
13070,2012-07-03,3,1,7,19,66,431,497,615.3333333333334
13071,2012-07-03,3,1,7,20,80,296,376,500.0
13072,2012-07-03,3,1,7,21,36,160,196,356.3333333333333
13073,2012-07-03,3,1,7,22,26,151,177,249.66666666666666
13074,2012-07-03,3,1,7,23,19,152,171,181.33333333333334
13075,2012-07-04,3,1,7,0,19,140,159,169.0
13076,2012-07-04,3,1,7,1,27,96,123,151.0
13077,2012-07-04,3,1,7,2,27,66,93,125.0
13078,2012-07-04,3,1,7,3,9,23,32,82.66666666666667
13079,2012-07-04,3,1,7,4,5,11,16,47.0
13080,2012-07-04,3,1,7,5,5,14,19,22.333333333333332
13081,2012-07-04,3,1,7,6,9,23,32,22.333333333333332
13082,2012-07-04,3,1,7,7,10,62,72,41.0
13083,2012-07-04,3,1,7,8,43,110,153,85.66666666666667
13084,2012-07-04,3,1,7,9,90,203,293,172.66666666666666
13085,2012-07-04,3,1,7,10,143,304,447,297.6666666666667
13086,2012-07-04,3,1,7,11,164,321,485,408.3333333333333
13087,2012-07-04,3,1,7,12,164,330,494,475.3333333333333
13088,2012-07-04,3,1,7,13,177,322,499,492.6666666666667
13089,2012-07-04,3,1,7,14,190,357,547,513.3333333333334
13090,2012-07-04,3,1,7,15,155,299,454,500.0
13091,2012-07-04,3,1,7,16,163,226,389,463.3333333333333
13092,2012-07-04,3,1,7,17,161,253,414,419.0
13093,2012-07-04,3,1,7,18,159,271,430,411.0
13094,2012-07-04,3,1,7,19,177,255,432,425.3333333333333
13095,2012-07-04,3,1,7,20,237,314,551,471.0
13096,2012-07-04,3,1,7,21,222,362,584,522.3333333333334
13097,2012-07-04,3,1,7,22,175,327,502,545.6666666666666
13098,2012-07-04,3,1,7,23,31,152,183,423.0
13099,2012-07-05,3,1,7,0,17,71,88,257.6666666666667
13100,2012-07-05,3,1,7,1,6,24,30,100.33333333333333
13101,2012-07-05,3,1,7,2,4,14,18,45.333333333333336
13102,2012-07-05,3,1,7,3,2,5,7,18.333333333333332
13103,2012-07-05,3,1,7,4,0,7,7,10.666666666666666
13104,2012-07-05,3,1,7,5,1,28,29,14.333333333333334
13105,2012-07-05,3,1,7,6,3,130,133,56.333333333333336
13106,2012-07-05,3,1,7,7,27,316,343,168.33333333333334
13107,2012-07-05,3,1,7,8,36,514,550,342.0
13108,2012-07-05,3,1,7,9,47,246,293,395.3333333333333
13109,2012-07-05,3,1,7,10,69,117,186,343.0
13110,2012-07-05,3,1,7,11,107,137,244,241.0
13111,2012-07-05,3,1,7,12,88,188,276,235.33333333333334
13112,2012-07-05,3,1,7,13,129,181,310,276.6666666666667
13113,2012-07-05,3,1,7,14,87,154,241,275.6666666666667
13114,2012-07-05,3,1,7,15,71,183,254,268.3333333333333
13115,2012-07-05,3,1,7,16,109,324,433,309.3333333333333
13116,2012-07-05,3,1,7,17,114,575,689,458.6666666666667
13117,2012-07-05,3,1,7,18,96,511,607,576.3333333333334
13118,2012-07-05,3,1,7,19,128,375,503,599.6666666666666
13119,2012-07-05,3,1,7,20,78,243,321,477.0
13120,2012-07-05,3,1,7,21,91,232,323,382.3333333333333
13121,2012-07-05,3,1,7,22,63,162,225,289.6666666666667
13122,2012-07-05,3,1,7,23,32,99,131,226.33333333333334
13123,2012-07-06,3,1,7,0,39,63,102,152.66666666666666
13124,2012-07-06,3,1,7,1,7,22,29,87.33333333333333
13125,2012-07-06,3,1,7,2,4,13,17,49.333333333333336
13126,2012-07-06,3,1,7,3,1,6,7,17.666666666666668
13127,2012-07-06,3,1,7,4,2,4,6,10.0
13128,2012-07-06,3,1,7,5,4,31,35,16.0
13129,2012-07-06,3,1,7,6,4,127,131,57.333333333333336
13130,2012-07-06,3,1,7,7,20,333,353,173.0
13131,2012-07-06,3,1,7,8,28,557,585,356.3333333333333
13132,2012-07-06,3,1,7,9,55,249,304,414.0
13133,2012-07-06,3,1,7,10,80,130,210,366.3333333333333
13134,2012-07-06,3,1,7,11,92,141,233,249.0
13135,2012-07-06,3,1,7,12,111,220,331,258.0
13136,2012-07-06,3,1,7,13,99,194,293,285.6666666666667
13137,2012-07-06,3,1,7,14,91,184,275,299.6666666666667
13138,2012-07-06,3,1,7,15,79,206,285,284.3333333333333
13139,2012-07-06,3,1,7,16,69,300,369,309.6666666666667
13140,2012-07-06,3,1,7,17,90,486,576,410.0
13141,2012-07-06,3,1,7,18,106,454,560,501.6666666666667
13142,2012-07-06,3,1,7,19,112,306,418,518.0
13143,2012-07-06,3,1,7,20,91,245,336,438.0
13144,2012-07-06,3,1,7,21,77,223,300,351.3333333333333
13145,2012-07-06,3,1,7,22,78,210,288,308.0
13146,2012-07-06,3,1,7,23,27,137,164,250.66666666666666
13147,2012-07-07,3,1,7,0,35,115,150,200.66666666666666
13148,2012-07-07,3,1,7,1,16,55,71,128.33333333333334
13149,2012-07-07,3,1,7,2,11,47,58,93.0
13150,2012-07-07,3,1,7,3,12,19,31,53.333333333333336
13151,2012-07-07,3,1,7,4,3,13,16,35.0
13152,2012-07-07,3,1,7,5,2,12,14,20.333333333333332
13153,2012-07-07,3,1,7,6,4,27,31,20.333333333333332
13154,2012-07-07,3,1,7,7,8,63,71,38.666666666666664
13155,2012-07-07,3,1,7,8,32,120,152,84.66666666666667
13156,2012-07-07,3,1,7,9,69,187,256,159.66666666666666
13157,2012-07-07,3,1,7,10,100,225,325,244.33333333333334
13158,2012-07-07,3,1,7,11,122,245,367,316.0
13159,2012-07-07,3,1,7,12,124,218,342,344.6666666666667
13160,2012-07-07,3,1,7,13,116,244,360,356.3333333333333
13161,2012-07-07,3,1,7,14,105,203,308,336.6666666666667
13162,2012-07-07,3,1,7,15,113,193,306,324.6666666666667
13163,2012-07-07,3,1,7,16,102,192,294,302.6666666666667
13164,2012-07-07,3,1,7,17,103,176,279,293.0
13165,2012-07-07,3,1,7,18,83,194,277,283.3333333333333
13166,2012-07-07,3,1,7,19,68,219,287,281.0
13167,2012-07-07,3,1,7,20,79,197,276,280.0
13168,2012-07-07,3,1,7,21,51,150,201,254.66666666666666
13169,2012-07-07,3,1,7,22,56,164,220,232.33333333333334
13170,2012-07-07,3,1,7,23,34,114,148,189.66666666666666
13171,2012-07-08,3,1,7,0,22,125,147,171.66666666666666
13172,2012-07-08,3,1,7,1,25,99,124,139.66666666666666
13173,2012-07-08,3,1,7,2,11,59,70,113.66666666666667
13174,2012-07-08,3,1,7,3,1,34,35,76.33333333333333
13175,2012-07-08,3,1,7,4,2,11,13,39.333333333333336
13176,2012-07-08,3,1,7,5,1,5,6,18.0
13177,2012-07-08,3,1,7,6,5,16,21,13.333333333333334
13178,2012-07-08,3,1,7,7,19,33,52,26.333333333333332
13179,2012-07-08,3,1,7,8,35,95,130,67.66666666666667
13180,2012-07-08,3,1,7,9,70,172,242,141.33333333333334
13181,2012-07-08,3,1,7,10,85,234,319,230.33333333333334
13182,2012-07-08,3,1,7,11,120,269,389,316.6666666666667
13183,2012-07-08,3,1,7,12,105,271,376,361.3333333333333
13184,2012-07-08,3,1,7,13,118,219,337,367.3333333333333
13185,2012-07-08,3,1,7,14,77,235,312,341.6666666666667
13186,2012-07-08,3,1,7,15,80,218,298,315.6666666666667
13187,2012-07-08,3,1,7,16,65,226,291,300.3333333333333
13188,2012-07-08,3,1,7,17,68,202,270,286.3333333333333
13189,2012-07-08,3,1,7,18,54,199,253,271.3333333333333
13190,2012-07-08,3,1,7,19,66,184,250,257.6666666666667
13191,2012-07-08,3,1,7,20,79,206,285,262.6666666666667
13192,2012-07-08,3,1,7,21,58,149,207,247.33333333333334
13193,2012-07-08,3,1,7,22,12,110,122,204.66666666666666
13194,2012-07-08,3,1,7,23,25,98,123,150.66666666666666
13195,2012-07-09,3,1,7,0,6,33,39,94.66666666666667
13196,2012-07-09,3,1,7,1,5,13,18,60.0
13197,2012-07-09,3,1,7,2,1,4,5,20.666666666666668
13198,2012-07-09,3,1,7,3,0,5,5,9.333333333333334
13199,2012-07-09,3,1,7,4,1,1,2,4.0
13200,2012-07-09,3,1,7,5,1,27,28,11.666666666666666
13201,2012-07-09,3,1,7,6,6,86,92,40.666666666666664
13202,2012-07-09,3,1,7,7,7,223,230,116.66666666666667
13203,2012-07-09,3,1,7,8,26,429,455,259.0
13204,2012-07-09,3,1,7,9,38,325,363,349.3333333333333
13205,2012-07-09,3,1,7,10,58,117,175,331.0
13206,2012-07-09,3,1,7,11,72,144,216,251.33333333333334
13207,2012-07-09,3,1,7,12,61,205,266,219.0
13208,2012-07-09,3,1,7,13,67,188,255,245.66666666666666
13209,2012-07-09,3,1,7,14,58,184,242,254.33333333333334
13210,2012-07-09,3,1,7,15,66,214,280,259.0
13211,2012-07-09,3,1,7,16,88,325,413,311.6666666666667
13212,2012-07-09,3,1,7,17,108,741,849,514.0
13213,2012-07-09,3,1,7,18,82,790,872,711.3333333333334
13214,2012-07-09,3,1,7,19,88,543,631,784.0
13215,2012-07-09,3,1,7,20,69,378,447,650.0
13216,2012-07-09,3,1,7,21,33,298,331,469.6666666666667
13217,2012-07-09,3,1,7,22,35,189,224,334.0
13218,2012-07-09,3,1,7,23,22,109,131,228.66666666666666
13219,2012-07-10,3,1,7,0,16,53,69,141.33333333333334
13220,2012-07-10,3,1,7,1,0,15,15,71.66666666666667
13221,2012-07-10,3,1,7,2,1,15,16,33.333333333333336
13222,2012-07-10,3,1,7,3,0,3,3,11.333333333333334
13223,2012-07-10,3,1,7,4,0,4,4,7.666666666666667
13224,2012-07-10,3,1,7,5,3,39,42,16.333333333333332
13225,2012-07-10,3,1,7,6,4,183,187,77.66666666666667
13226,2012-07-10,3,1,7,7,31,489,520,249.66666666666666
13227,2012-07-10,3,1,7,8,34,615,649,452.0
13228,2012-07-10,3,1,7,9,47,284,331,500.0
13229,2012-07-10,3,1,7,10,56,134,190,390.0
13230,2012-07-10,3,1,7,11,92,157,249,256.6666666666667
13231,2012-07-10,3,1,7,12,69,203,272,237.0
13232,2012-07-10,3,1,7,13,77,203,280,267.0
13233,2012-07-10,3,1,7,14,71,171,242,264.6666666666667
13234,2012-07-10,3,1,7,15,77,188,265,262.3333333333333
13235,2012-07-10,3,1,7,16,89,346,435,314.0
13236,2012-07-10,3,1,7,17,103,769,872,524.0
13237,2012-07-10,3,1,7,18,70,749,819,708.6666666666666
13238,2012-07-10,3,1,7,19,55,359,414,701.6666666666666
13239,2012-07-10,3,1,7,20,9,75,84,439.0
13240,2012-07-10,3,1,7,21,7,83,90,196.0
13241,2012-07-10,3,1,7,22,14,125,139,104.33333333333333
13242,2012-07-10,3,1,7,23,29,74,103,110.66666666666667
13243,2012-07-11,3,1,7,0,6,38,44,95.33333333333333
13244,2012-07-11,3,1,7,1,3,11,14,53.666666666666664
13245,2012-07-11,3,1,7,2,0,5,5,21.0
13246,2012-07-11,3,1,7,3,0,5,5,8.0
13247,2012-07-11,3,1,7,4,1,6,7,5.666666666666667
13248,2012-07-11,3,1,7,5,5,36,41,17.666666666666668
13249,2012-07-11,3,1,7,6,17,168,185,77.66666666666667
13250,2012-07-11,3,1,7,7,26,471,497,241.0
13251,2012-07-11,3,1,7,8,30,644,674,452.0
13252,2012-07-11,3,1,7,9,30,298,328,499.6666666666667
13253,2012-07-11,3,1,7,10,47,148,195,399.0
13254,2012-07-11,3,1,7,11,56,173,229,250.66666666666666
13255,2012-07-11,3,1,7,12,69,223,292,238.66666666666666
13256,2012-07-11,3,1,7,13,65,208,273,264.6666666666667
13257,2012-07-11,3,1,7,14,66,175,241,268.6666666666667
13258,2012-07-11,3,1,7,15,56,220,276,263.3333333333333
13259,2012-07-11,3,1,7,16,53,358,411,309.3333333333333
13260,2012-07-11,3,1,7,17,90,740,830,505.6666666666667
13261,2012-07-11,3,1,7,18,79,735,814,685.0
13262,2012-07-11,3,1,7,19,73,560,633,759.0
13263,2012-07-11,3,1,7,20,73,410,483,643.3333333333334
13264,2012-07-11,3,1,7,21,69,322,391,502.3333333333333
13265,2012-07-11,3,1,7,22,41,203,244,372.6666666666667
13266,2012-07-11,3,1,7,23,20,132,152,262.3333333333333
13267,2012-07-12,3,1,7,0,1,55,56,150.66666666666666
13268,2012-07-12,3,1,7,1,0,21,21,76.33333333333333
13269,2012-07-12,3,1,7,2,0,9,9,28.666666666666668
13270,2012-07-12,3,1,7,3,0,10,10,13.333333333333334
13271,2012-07-12,3,1,7,4,0,5,5,8.0
13272,2012-07-12,3,1,7,5,4,40,44,19.666666666666668
13273,2012-07-12,3,1,7,6,7,171,178,75.66666666666667
13274,2012-07-12,3,1,7,7,32,480,512,244.66666666666666
13275,2012-07-12,3,1,7,8,49,653,702,464.0
13276,2012-07-12,3,1,7,9,42,285,327,513.6666666666666
13277,2012-07-12,3,1,7,10,69,145,214,414.3333333333333
13278,2012-07-12,3,1,7,11,49,166,215,252.0
13279,2012-07-12,3,1,7,12,71,221,292,240.33333333333334
13280,2012-07-12,3,1,7,13,52,225,277,261.3333333333333
13281,2012-07-12,3,1,7,14,42,167,209,259.3333333333333
13282,2012-07-12,3,1,7,15,63,208,271,252.33333333333334
13283,2012-07-12,3,1,7,16,69,370,439,306.3333333333333
13284,2012-07-12,3,1,7,17,91,704,795,501.6666666666667
13285,2012-07-12,3,1,7,18,86,739,825,686.3333333333334
13286,2012-07-12,3,1,7,19,97,532,629,749.6666666666666
13287,2012-07-12,3,1,7,20,75,439,514,656.0
13288,2012-07-12,3,1,7,21,44,329,373,505.3333333333333
13289,2012-07-12,3,1,7,22,56,262,318,401.6666666666667
13290,2012-07-12,3,1,7,23,33,178,211,300.6666666666667
13291,2012-07-13,3,1,7,0,19,76,95,208.0
13292,2012-07-13,3,1,7,1,17,42,59,121.66666666666667
13293,2012-07-13,3,1,7,2,2,15,17,57.0
13294,2012-07-13,3,1,7,3,2,7,9,28.333333333333332
13295,2012-07-13,3,1,7,4,0,11,11,12.333333333333334
13296,2012-07-13,3,1,7,5,4,30,34,18.0
13297,2012-07-13,3,1,7,6,7,120,127,57.333333333333336
13298,2012-07-13,3,1,7,7,27,353,380,180.33333333333334
13299,2012-07-13,3,1,7,8,53,660,713,406.6666666666667
13300,2012-07-13,3,1,7,9,70,344,414,502.3333333333333
13301,2012-07-13,3,1,7,10,78,190,268,465.0
13302,2012-07-13,3,1,7,11,68,220,288,323.3333333333333
13303,2012-07-13,3,1,7,12,125,254,379,311.6666666666667
13304,2012-07-13,3,1,7,13,100,274,374,347.0
13305,2012-07-13,3,1,7,14,120,249,369,374.0
13306,2012-07-13,3,1,7,15,92,261,353,365.3333333333333
13307,2012-07-13,3,1,7,16,111,381,492,404.6666666666667
13308,2012-07-13,3,1,7,17,138,697,835,560.0
13309,2012-07-13,3,1,7,18,108,523,631,652.6666666666666
13310,2012-07-13,3,1,7,19,103,385,488,651.3333333333334
13311,2012-07-13,3,1,7,20,95,294,389,502.6666666666667
13312,2012-07-13,3,1,7,21,76,223,299,392.0
13313,2012-07-13,3,1,7,22,59,204,263,317.0
13314,2012-07-13,3,1,7,23,37,175,212,258.0
13315,2012-07-14,3,1,7,0,35,156,191,222.0
13316,2012-07-14,3,1,7,1,13,105,118,173.66666666666666
13317,2012-07-14,3,1,7,2,10,91,101,136.66666666666666
13318,2012-07-14,3,1,7,3,9,31,40,86.33333333333333
13319,2012-07-14,3,1,7,4,3,6,9,50.0
13320,2012-07-14,3,1,7,5,0,5,5,18.0
13321,2012-07-14,3,1,7,6,6,29,35,16.333333333333332
13322,2012-07-14,3,1,7,7,7,41,48,29.333333333333332
13323,2012-07-14,3,1,7,8,33,118,151,78.0
13324,2012-07-14,3,1,7,9,82,200,282,160.33333333333334
13325,2012-07-14,3,1,7,10,123,278,401,278.0
13326,2012-07-14,3,1,7,11,143,296,439,374.0
13327,2012-07-14,3,1,7,12,181,318,499,446.3333333333333
13328,2012-07-14,3,1,7,13,219,372,591,509.6666666666667
13329,2012-07-14,3,1,7,14,269,363,632,574.0
13330,2012-07-14,3,1,7,15,243,317,560,594.3333333333334
13331,2012-07-14,3,1,7,16,226,340,566,586.0
13332,2012-07-14,3,1,7,17,199,259,458,528.0
13333,2012-07-14,3,1,7,18,108,243,351,458.3333333333333
13334,2012-07-14,3,1,7,19,156,275,431,413.3333333333333
13335,2012-07-14,3,1,7,20,101,255,356,379.3333333333333
13336,2012-07-14,3,1,7,21,69,200,269,352.0
13337,2012-07-14,3,1,7,22,65,160,225,283.3333333333333
13338,2012-07-14,3,1,7,23,55,156,211,235.0
13339,2012-07-15,3,1,7,0,40,147,187,207.66666666666666
13340,2012-07-15,3,1,7,1,49,119,168,188.66666666666666
13341,2012-07-15,3,1,7,2,29,86,115,156.66666666666666
13342,2012-07-15,3,1,7,3,15,42,57,113.33333333333333
13343,2012-07-15,3,1,7,4,8,11,19,63.666666666666664
13344,2012-07-15,3,1,7,5,2,7,9,28.333333333333332
13345,2012-07-15,3,1,7,6,6,9,15,14.333333333333334
13346,2012-07-15,3,1,7,7,17,30,47,23.666666666666668
13347,2012-07-15,3,1,7,8,37,96,133,65.0
13348,2012-07-15,3,1,7,9,58,163,221,133.66666666666666
13349,2012-07-15,3,1,7,10,141,241,382,245.33333333333334
13350,2012-07-15,3,1,7,11,170,281,451,351.3333333333333
13351,2012-07-15,3,1,7,12,153,336,489,440.6666666666667
13352,2012-07-15,3,1,7,13,171,309,480,473.3333333333333
13353,2012-07-15,3,1,7,14,162,314,476,481.6666666666667
13354,2012-07-15,3,1,7,15,182,307,489,481.6666666666667
13355,2012-07-15,3,1,7,16,152,343,495,486.6666666666667
13356,2012-07-15,3,1,7,17,122,314,436,473.3333333333333
13357,2012-07-15,3,1,7,18,84,228,312,414.3333333333333
13358,2012-07-15,3,1,7,19,109,203,312,353.3333333333333
13359,2012-07-15,3,1,7,20,95,199,294,306.0
13360,2012-07-15,3,1,7,21,59,164,223,276.3333333333333
13361,2012-07-15,3,1,7,22,34,96,130,215.66666666666666
13362,2012-07-15,3,1,7,23,25,66,91,148.0
13363,2012-07-16,3,1,7,0,11,32,43,88.0
13364,2012-07-16,3,1,7,1,1,10,11,48.333333333333336
13365,2012-07-16,3,1,7,2,4,11,15,23.0
13366,2012-07-16,3,1,7,3,2,4,6,10.666666666666666
13367,2012-07-16,3,1,7,4,1,11,12,11.0
13368,2012-07-16,3,1,7,5,10,40,50,22.666666666666668
13369,2012-07-16,3,1,7,6,8,132,140,67.33333333333333
13370,2012-07-16,3,1,7,7,24,459,483,224.33333333333334
13371,2012-07-16,3,1,7,8,48,619,667,430.0
13372,2012-07-16,3,1,7,9,51,297,348,499.3333333333333
13373,2012-07-16,3,1,7,10,69,117,186,400.3333333333333
13374,2012-07-16,3,1,7,11,57,125,182,238.66666666666666
13375,2012-07-16,3,1,7,12,79,158,237,201.66666666666666
13376,2012-07-16,3,1,7,13,63,176,239,219.33333333333334
13377,2012-07-16,3,1,7,14,53,159,212,229.33333333333334
13378,2012-07-16,3,1,7,15,61,176,237,229.33333333333334
13379,2012-07-16,3,1,7,16,77,309,386,278.3333333333333
13380,2012-07-16,3,1,7,17,86,669,755,459.3333333333333
13381,2012-07-16,3,1,7,18,97,697,794,645.0
13382,2012-07-16,3,1,7,19,92,503,595,714.6666666666666
13383,2012-07-16,3,1,7,20,66,388,454,614.3333333333334
13384,2012-07-16,3,1,7,21,45,283,328,459.0
13385,2012-07-16,3,1,7,22,56,228,284,355.3333333333333
13386,2012-07-16,3,1,7,23,27,139,166,259.3333333333333
13387,2012-07-17,3,1,7,0,10,43,53,167.66666666666666
13388,2012-07-17,3,1,7,1,4,21,25,81.33333333333333
13389,2012-07-17,3,1,7,2,1,6,7,28.333333333333332
13390,2012-07-17,3,1,7,3,0,3,3,11.666666666666666
13391,2012-07-17,3,1,7,4,0,7,7,5.666666666666667
13392,2012-07-17,3,1,7,5,7,31,38,16.0
13393,2012-07-17,3,1,7,6,16,197,213,86.0
13394,2012-07-17,3,1,7,7,26,500,526,259.0
13395,2012-07-17,3,1,7,8,43,618,661,466.6666666666667
13396,2012-07-17,3,1,7,9,32,288,320,502.3333333333333
13397,2012-07-17,3,1,7,10,37,122,159,380.0
13398,2012-07-17,3,1,7,11,60,146,206,228.33333333333334
13399,2012-07-17,3,1,7,12,80,174,254,206.33333333333334
13400,2012-07-17,3,1,7,13,53,168,221,227.0
13401,2012-07-17,3,1,7,14,54,160,214,229.66666666666666
13402,2012-07-17,3,1,7,15,57,187,244,226.33333333333334
13403,2012-07-17,3,1,7,16,64,317,381,279.6666666666667
13404,2012-07-17,3,1,7,17,95,675,770,465.0
13405,2012-07-17,3,1,7,18,60,712,772,641.0
13406,2012-07-17,3,1,7,19,69,478,547,696.3333333333334
13407,2012-07-17,3,1,7,20,52,375,427,582.0
13408,2012-07-17,3,1,7,21,50,283,333,435.6666666666667
13409,2012-07-17,3,1,7,22,29,215,244,334.6666666666667
13410,2012-07-17,3,1,7,23,22,139,161,246.0
13411,2012-07-18,3,1,7,0,8,45,53,152.66666666666666
13412,2012-07-18,3,1,7,1,2,14,16,76.66666666666667
13413,2012-07-18,3,1,7,2,3,5,8,25.666666666666668
13414,2012-07-18,3,1,7,3,2,2,4,9.333333333333334
13415,2012-07-18,3,1,7,4,0,6,6,6.0
13416,2012-07-18,3,1,7,5,5,41,46,18.666666666666668
13417,2012-07-18,3,1,7,6,10,152,162,71.33333333333333
13418,2012-07-18,3,1,7,7,23,472,495,234.33333333333334
13419,2012-07-18,3,1,7,8,55,624,679,445.3333333333333
13420,2012-07-18,3,1,7,9,44,253,297,490.3333333333333
13421,2012-07-18,3,1,7,10,39,99,138,371.3333333333333
13422,2012-07-18,3,1,7,11,47,136,183,206.0
13423,2012-07-18,3,1,7,12,36,166,202,174.33333333333334
13424,2012-07-18,3,1,7,13,49,154,203,196.0
13425,2012-07-18,3,1,7,14,54,116,170,191.66666666666666
13426,2012-07-18,3,1,7,15,42,152,194,189.0
13427,2012-07-18,3,1,7,16,34,190,224,196.0
13428,2012-07-18,3,1,7,17,35,335,370,262.6666666666667
13429,2012-07-18,3,1,7,18,63,580,643,412.3333333333333
13430,2012-07-18,3,1,7,19,78,438,516,509.6666666666667
13431,2012-07-18,3,1,7,20,56,310,366,508.3333333333333
13432,2012-07-18,3,1,7,21,53,266,319,400.3333333333333
13433,2012-07-18,3,1,7,22,42,246,288,324.3333333333333
13434,2012-07-18,3,1,7,23,19,112,131,246.0
13435,2012-07-19,3,1,7,0,16,50,66,161.66666666666666
13436,2012-07-19,3,1,7,1,6,19,25,74.0
13437,2012-07-19,3,1,7,2,0,7,7,32.666666666666664
13438,2012-07-19,3,1,7,3,1,4,5,12.333333333333334
13439,2012-07-19,3,1,7,4,0,8,8,6.666666666666667
13440,2012-07-19,3,1,7,5,5,35,40,17.666666666666668
13441,2012-07-19,3,1,7,6,8,144,152,66.66666666666667
13442,2012-07-19,3,1,7,7,23,450,473,221.66666666666666
13443,2012-07-19,3,1,7,8,32,625,657,427.3333333333333
13444,2012-07-19,3,1,7,9,36,282,318,482.6666666666667
13445,2012-07-19,3,1,7,10,41,157,198,391.0
13446,2012-07-19,3,1,7,11,54,162,216,244.0
13447,2012-07-19,3,1,7,12,59,215,274,229.33333333333334
13448,2012-07-19,3,1,7,13,74,180,254,248.0
13449,2012-07-19,3,1,7,14,46,151,197,241.66666666666666
13450,2012-07-19,3,1,7,15,66,226,292,247.66666666666666
13451,2012-07-19,3,1,7,16,70,288,358,282.3333333333333
13452,2012-07-19,3,1,7,17,93,678,771,473.6666666666667
13453,2012-07-19,3,1,7,18,93,684,777,635.3333333333334
13454,2012-07-19,3,1,7,19,53,480,533,693.6666666666666
13455,2012-07-19,3,1,7,20,65,440,505,605.0
13456,2012-07-19,3,1,7,21,38,294,332,456.6666666666667
13457,2012-07-19,3,1,7,22,6,62,68,301.6666666666667
13458,2012-07-19,3,1,7,23,3,62,65,155.0
13459,2012-07-20,3,1,7,0,2,32,34,55.666666666666664
13460,2012-07-20,3,1,7,1,2,9,11,36.666666666666664
13461,2012-07-20,3,1,7,2,5,14,19,21.333333333333332
13462,2012-07-20,3,1,7,3,7,29,36,22.0
13463,2012-07-20,3,1,7,4,3,6,9,21.333333333333332
13464,2012-07-20,3,1,7,5,2,40,42,29.0
13465,2012-07-20,3,1,7,6,3,123,126,59.0
13466,2012-07-20,3,1,7,7,14,346,360,176.0
13467,2012-07-20,3,1,7,8,39,652,691,392.3333333333333
13468,2012-07-20,3,1,7,9,45,328,373,474.6666666666667
13469,2012-07-20,3,1,7,10,51,182,233,432.3333333333333
13470,2012-07-20,3,1,7,11,51,161,212,272.6666666666667
13471,2012-07-20,3,1,7,12,41,233,274,239.66666666666666
13472,2012-07-20,3,1,7,13,20,136,156,214.0
13473,2012-07-20,3,1,7,14,53,176,229,219.66666666666666
13474,2012-07-20,3,1,7,15,47,169,216,200.33333333333334
13475,2012-07-20,3,1,7,16,70,366,436,293.6666666666667
13476,2012-07-20,3,1,7,17,95,620,715,455.6666666666667
13477,2012-07-20,3,1,7,18,73,549,622,591.0
13478,2012-07-20,3,1,7,19,44,358,402,579.6666666666666
13479,2012-07-20,3,1,7,20,35,216,251,425.0
13480,2012-07-20,3,1,7,21,14,108,122,258.3333333333333
13481,2012-07-20,3,1,7,22,13,122,135,169.33333333333334
13482,2012-07-20,3,1,7,23,18,148,166,141.0
13483,2012-07-21,3,1,7,0,11,92,103,134.66666666666666
13484,2012-07-21,3,1,7,1,10,62,72,113.66666666666667
13485,2012-07-21,3,1,7,2,5,55,60,78.33333333333333
13486,2012-07-21,3,1,7,3,7,18,25,52.333333333333336
13487,2012-07-21,3,1,7,4,11,5,16,33.666666666666664
13488,2012-07-21,3,1,7,5,7,10,17,19.333333333333332
13489,2012-07-21,3,1,7,6,3,12,15,16.0
13490,2012-07-21,3,1,7,7,8,29,37,23.0
13491,2012-07-21,3,1,7,8,18,94,112,54.666666666666664
13492,2012-07-21,3,1,7,9,32,175,207,118.66666666666667
13493,2012-07-21,3,1,7,10,49,219,268,195.66666666666666
13494,2012-07-21,3,1,7,11,80,225,305,260.0
13495,2012-07-21,3,1,7,12,156,301,457,343.3333333333333
13496,2012-07-21,3,1,7,13,106,248,354,372.0
13497,2012-07-21,3,1,7,14,121,222,343,384.6666666666667
13498,2012-07-21,3,1,7,15,148,232,380,359.0
13499,2012-07-21,3,1,7,16,130,196,326,349.6666666666667
13500,2012-07-21,3,1,7,17,92,149,241,315.6666666666667
13501,2012-07-21,3,1,7,18,51,126,177,248.0
13502,2012-07-21,3,1,7,19,67,171,238,218.66666666666666
13503,2012-07-21,3,1,7,20,51,163,214,209.66666666666666
13504,2012-07-21,3,1,7,21,29,134,163,205.0
13505,2012-07-21,3,1,7,22,40,140,180,185.66666666666666
13506,2012-07-21,3,1,7,23,32,117,149,164.0
13507,2012-07-22,3,1,7,0,17,96,113,147.33333333333334
13508,2012-07-22,3,1,7,1,31,99,130,130.66666666666666
13509,2012-07-22,3,1,7,2,32,90,122,121.66666666666667
13510,2012-07-22,3,1,7,3,13,30,43,98.33333333333333
13511,2012-07-22,3,1,7,4,6,10,16,60.333333333333336
13512,2012-07-22,3,1,7,5,0,6,6,21.666666666666668
13513,2012-07-22,3,1,7,6,5,14,19,13.666666666666666
13514,2012-07-22,3,1,7,7,13,25,38,21.0
13515,2012-07-22,3,1,7,8,31,122,153,70.0
13516,2012-07-22,3,1,7,9,79,179,258,149.66666666666666
13517,2012-07-22,3,1,7,10,114,265,379,263.3333333333333
13518,2012-07-22,3,1,7,11,191,314,505,380.6666666666667
13519,2012-07-22,3,1,7,12,178,326,504,462.6666666666667
13520,2012-07-22,3,1,7,13,238,388,626,545.0
13521,2012-07-22,3,1,7,14,256,360,616,582.0
13522,2012-07-22,3,1,7,15,254,370,624,622.0
13523,2012-07-22,3,1,7,16,245,383,628,622.6666666666666
13524,2012-07-22,3,1,7,17,188,368,556,602.6666666666666
13525,2012-07-22,3,1,7,18,173,342,515,566.3333333333334
13526,2012-07-22,3,1,7,19,180,342,522,531.0
13527,2012-07-22,3,1,7,20,124,254,378,471.6666666666667
13528,2012-07-22,3,1,7,21,88,257,345,415.0
13529,2012-07-22,3,1,7,22,55,136,191,304.6666666666667
13530,2012-07-22,3,1,7,23,33,90,123,219.66666666666666
13531,2012-07-23,3,1,7,0,11,36,47,120.33333333333333
13532,2012-07-23,3,1,7,1,7,20,27,65.66666666666667
13533,2012-07-23,3,1,7,2,3,14,17,30.333333333333332
13534,2012-07-23,3,1,7,3,0,2,2,15.333333333333334
13535,2012-07-23,3,1,7,4,0,8,8,9.0
13536,2012-07-23,3,1,7,5,3,48,51,20.333333333333332
13537,2012-07-23,3,1,7,6,9,148,157,72.0
13538,2012-07-23,3,1,7,7,17,404,421,209.66666666666666
13539,2012-07-23,3,1,7,8,47,691,738,438.6666666666667
13540,2012-07-23,3,1,7,9,57,288,345,501.3333333333333
13541,2012-07-23,3,1,7,10,63,137,200,427.6666666666667
13542,2012-07-23,3,1,7,11,69,129,198,247.66666666666666
13543,2012-07-23,3,1,7,12,109,205,314,237.33333333333334
13544,2012-07-23,3,1,7,13,64,176,240,250.66666666666666
13545,2012-07-23,3,1,7,14,82,189,271,275.0
13546,2012-07-23,3,1,7,15,76,205,281,264.0
13547,2012-07-23,3,1,7,16,111,346,457,336.3333333333333
13548,2012-07-23,3,1,7,17,87,760,847,528.3333333333334
13549,2012-07-23,3,1,7,18,69,672,741,681.6666666666666
13550,2012-07-23,3,1,7,19,94,488,582,723.3333333333334
13551,2012-07-23,3,1,7,20,56,347,403,575.3333333333334
13552,2012-07-23,3,1,7,21,45,251,296,427.0
13553,2012-07-23,3,1,7,22,40,169,209,302.6666666666667
13554,2012-07-23,3,1,7,23,16,98,114,206.33333333333334
13555,2012-07-24,3,1,7,0,12,52,64,129.0
13556,2012-07-24,3,1,7,1,7,10,17,65.0
13557,2012-07-24,3,1,7,2,6,10,16,32.333333333333336
13558,2012-07-24,3,1,7,3,1,5,6,13.0
13559,2012-07-24,3,1,7,4,0,6,6,9.333333333333334
13560,2012-07-24,3,1,7,5,5,45,50,20.666666666666668
13561,2012-07-24,3,1,7,6,17,173,190,82.0
13562,2012-07-24,3,1,7,7,24,492,516,252.0
13563,2012-07-24,3,1,7,8,49,694,743,483.0
13564,2012-07-24,3,1,7,9,40,299,339,532.6666666666666
13565,2012-07-24,3,1,7,10,62,156,218,433.3333333333333
13566,2012-07-24,3,1,7,11,45,156,201,252.66666666666666
13567,2012-07-24,3,1,7,12,60,169,229,216.0
13568,2012-07-24,3,1,7,13,73,200,273,234.33333333333334
13569,2012-07-24,3,1,7,14,48,196,244,248.66666666666666
13570,2012-07-24,3,1,7,15,73,212,285,267.3333333333333
13571,2012-07-24,3,1,7,16,86,369,455,328.0
13572,2012-07-24,3,1,7,17,94,775,869,536.3333333333334
13573,2012-07-24,3,1,7,18,110,767,877,733.6666666666666
13574,2012-07-24,3,1,7,19,109,523,632,792.6666666666666
13575,2012-07-24,3,1,7,20,85,438,523,677.3333333333334
13576,2012-07-24,3,1,7,21,53,325,378,511.0
13577,2012-07-24,3,1,7,22,43,226,269,390.0
13578,2012-07-24,3,1,7,23,38,154,192,279.6666666666667
13579,2012-07-25,3,1,7,0,9,57,66,175.66666666666666
13580,2012-07-25,3,1,7,1,2,26,28,95.33333333333333
13581,2012-07-25,3,1,7,2,1,11,12,35.333333333333336
13582,2012-07-25,3,1,7,3,1,11,12,17.333333333333332
13583,2012-07-25,3,1,7,4,0,4,4,9.333333333333334
13584,2012-07-25,3,1,7,5,5,54,59,25.0
13585,2012-07-25,3,1,7,6,11,179,190,84.33333333333333
13586,2012-07-25,3,1,7,7,34,473,507,252.0
13587,2012-07-25,3,1,7,8,43,745,788,495.0
13588,2012-07-25,3,1,7,9,65,277,342,545.6666666666666
13589,2012-07-25,3,1,7,10,68,163,231,453.6666666666667
13590,2012-07-25,3,1,7,11,79,202,281,284.6666666666667
13591,2012-07-25,3,1,7,12,77,233,310,274.0
13592,2012-07-25,3,1,7,13,81,231,312,301.0
13593,2012-07-25,3,1,7,14,88,159,247,289.6666666666667
13594,2012-07-25,3,1,7,15,94,223,317,292.0
13595,2012-07-25,3,1,7,16,91,393,484,349.3333333333333
13596,2012-07-25,3,1,7,17,130,783,913,571.3333333333334
13597,2012-07-25,3,1,7,18,104,787,891,762.6666666666666
13598,2012-07-25,3,1,7,19,116,582,698,834.0
13599,2012-07-25,3,1,7,20,106,461,567,718.6666666666666
13600,2012-07-25,3,1,7,21,71,326,397,554.0
13601,2012-07-25,3,1,7,22,55,223,278,414.0
13602,2012-07-25,3,1,7,23,52,187,239,304.6666666666667
13603,2012-07-26,3,1,7,0,27,65,92,203.0
13604,2012-07-26,3,1,7,1,6,23,29,120.0
13605,2012-07-26,3,1,7,2,5,16,21,47.333333333333336
13606,2012-07-26,3,1,7,3,0,8,8,19.333333333333332
13607,2012-07-26,3,1,7,4,0,4,4,11.0
13608,2012-07-26,3,1,7,5,2,40,42,18.0
13609,2012-07-26,3,1,7,6,16,165,181,75.66666666666667
13610,2012-07-26,3,1,7,7,17,478,495,239.33333333333334
13611,2012-07-26,3,1,7,8,49,680,729,468.3333333333333
13612,2012-07-26,3,1,7,9,55,289,344,522.6666666666666
13613,2012-07-26,3,1,7,10,79,143,222,431.6666666666667
13614,2012-07-26,3,1,7,11,69,143,212,259.3333333333333
13615,2012-07-26,3,1,7,12,73,206,279,237.66666666666666
13616,2012-07-26,3,1,7,13,53,189,242,244.33333333333334
13617,2012-07-26,3,1,7,14,62,151,213,244.66666666666666
13618,2012-07-26,3,1,7,15,65,173,238,231.0
13619,2012-07-26,3,1,7,16,62,312,374,275.0
13620,2012-07-26,3,1,7,17,110,628,738,450.0
13621,2012-07-26,3,1,7,18,73,615,688,600.0
13622,2012-07-26,3,1,7,19,80,534,614,680.0
13623,2012-07-26,3,1,7,20,47,399,446,582.6666666666666
13624,2012-07-26,3,1,7,21,35,236,271,443.6666666666667
13625,2012-07-26,3,1,7,22,33,201,234,317.0
13626,2012-07-26,3,1,7,23,18,127,145,216.66666666666666
13627,2012-07-27,3,1,7,0,14,83,97,158.66666666666666
13628,2012-07-27,3,1,7,1,12,42,54,98.66666666666667
13629,2012-07-27,3,1,7,2,8,18,26,59.0
13630,2012-07-27,3,1,7,3,3,9,12,30.666666666666668
13631,2012-07-27,3,1,7,4,3,5,8,15.333333333333334
13632,2012-07-27,3,1,7,5,3,34,37,19.0
13633,2012-07-27,3,1,7,6,10,129,139,61.333333333333336
13634,2012-07-27,3,1,7,7,13,397,410,195.33333333333334
13635,2012-07-27,3,1,7,8,34,642,676,408.3333333333333
13636,2012-07-27,3,1,7,9,34,329,363,483.0
13637,2012-07-27,3,1,7,10,85,146,231,423.3333333333333
13638,2012-07-27,3,1,7,11,67,184,251,281.6666666666667
13639,2012-07-27,3,1,7,12,92,207,299,260.3333333333333
13640,2012-07-27,3,1,7,13,83,231,314,288.0
13641,2012-07-27,3,1,7,14,105,221,326,313.0
13642,2012-07-27,3,1,7,15,81,242,323,321.0
13643,2012-07-27,3,1,7,16,80,419,499,382.6666666666667
13644,2012-07-27,3,1,7,17,101,598,699,507.0
13645,2012-07-27,3,1,7,18,100,522,622,606.6666666666666
13646,2012-07-27,3,1,7,19,93,423,516,612.3333333333334
13647,2012-07-27,3,1,7,20,85,269,354,497.3333333333333
13648,2012-07-27,3,1,7,21,71,189,260,376.6666666666667
13649,2012-07-27,3,1,7,22,48,151,199,271.0
13650,2012-07-27,3,1,7,23,34,155,189,216.0
13651,2012-07-28,3,1,7,0,21,170,191,193.0
13652,2012-07-28,3,1,7,1,11,69,80,153.33333333333334
13653,2012-07-28,3,1,7,2,14,76,90,120.33333333333333
13654,2012-07-28,3,1,7,3,10,33,43,71.0
13655,2012-07-28,3,1,7,4,1,10,11,48.0
13656,2012-07-28,3,1,7,5,4,10,14,22.666666666666668
13657,2012-07-28,3,1,7,6,10,40,50,25.0
13658,2012-07-28,3,1,7,7,18,58,76,46.666666666666664
13659,2012-07-28,3,1,7,8,36,127,163,96.33333333333333
13660,2012-07-28,3,1,7,9,110,227,337,192.0
13661,2012-07-28,3,1,7,10,129,266,395,298.3333333333333
13662,2012-07-28,3,1,7,11,162,295,457,396.3333333333333
13663,2012-07-28,3,1,7,12,157,330,487,446.3333333333333
13664,2012-07-28,3,1,7,13,173,325,498,480.6666666666667
13665,2012-07-28,3,1,7,14,186,308,494,493.0
13666,2012-07-28,3,1,7,15,206,291,497,496.3333333333333
13667,2012-07-28,3,1,7,16,208,279,487,492.6666666666667
13668,2012-07-28,3,1,7,17,199,280,479,487.6666666666667
13669,2012-07-28,3,1,7,18,151,330,481,482.3333333333333
13670,2012-07-28,3,1,7,19,115,223,338,432.6666666666667
13671,2012-07-28,3,1,7,20,79,154,233,350.6666666666667
13672,2012-07-28,3,1,7,21,94,206,300,290.3333333333333
13673,2012-07-28,3,1,7,22,88,188,276,269.6666666666667
13674,2012-07-28,3,1,7,23,52,156,208,261.3333333333333
13675,2012-07-29,3,1,7,0,59,129,188,224.0
13676,2012-07-29,3,1,7,1,49,109,158,184.66666666666666
13677,2012-07-29,3,1,7,2,33,79,112,152.66666666666666
13678,2012-07-29,3,1,7,3,18,37,55,108.33333333333333
13679,2012-07-29,3,1,7,4,2,11,13,60.0
13680,2012-07-29,3,1,7,5,3,14,17,28.333333333333332
13681,2012-07-29,3,1,7,6,6,12,18,16.0
13682,2012-07-29,3,1,7,7,4,36,40,25.0
13683,2012-07-29,3,1,7,8,37,90,127,61.666666666666664
13684,2012-07-29,3,1,7,9,64,162,226,131.0
13685,2012-07-29,3,1,7,10,123,258,381,244.66666666666666
13686,2012-07-29,3,1,7,11,183,326,509,372.0
13687,2012-07-29,3,1,7,12,154,357,511,467.0
13688,2012-07-29,3,1,7,13,181,302,483,501.0
13689,2012-07-29,3,1,7,14,231,291,522,505.3333333333333
13690,2012-07-29,3,1,7,15,195,306,501,502.0
13691,2012-07-29,3,1,7,16,191,330,521,514.6666666666666
13692,2012-07-29,3,1,7,17,164,367,531,517.6666666666666
13693,2012-07-29,3,1,7,18,117,302,419,490.3333333333333
13694,2012-07-29,3,1,7,19,143,300,443,464.3333333333333
13695,2012-07-29,3,1,7,20,75,228,303,388.3333333333333
13696,2012-07-29,3,1,7,21,72,199,271,339.0
13697,2012-07-29,3,1,7,22,31,117,148,240.66666666666666
13698,2012-07-29,3,1,7,23,18,82,100,173.0
13699,2012-07-30,3,1,7,0,12,46,58,102.0
13700,2012-07-30,3,1,7,1,4,15,19,59.0
13701,2012-07-30,3,1,7,2,2,6,8,28.333333333333332
13702,2012-07-30,3,1,7,3,0,3,3,10.0
13703,2012-07-30,3,1,7,4,0,5,5,5.333333333333333
13704,2012-07-30,3,1,7,5,4,43,47,18.333333333333332
13705,2012-07-30,3,1,7,6,6,155,161,71.0
13706,2012-07-30,3,1,7,7,14,455,469,225.66666666666666
13707,2012-07-30,3,1,7,8,31,720,751,460.3333333333333
13708,2012-07-30,3,1,7,9,34,259,293,504.3333333333333
13709,2012-07-30,3,1,7,10,54,135,189,411.0
13710,2012-07-30,3,1,7,11,69,146,215,232.33333333333334
13711,2012-07-30,3,1,7,12,77,201,278,227.33333333333334
13712,2012-07-30,3,1,7,13,57,169,226,239.66666666666666
13713,2012-07-30,3,1,7,14,87,167,254,252.66666666666666
13714,2012-07-30,3,1,7,15,51,185,236,238.66666666666666
13715,2012-07-30,3,1,7,16,88,337,425,305.0
13716,2012-07-30,3,1,7,17,62,765,827,496.0
13717,2012-07-30,3,1,7,18,77,735,812,688.0
13718,2012-07-30,3,1,7,19,81,584,665,768.0
13719,2012-07-30,3,1,7,20,78,384,462,646.3333333333334
13720,2012-07-30,3,1,7,21,71,251,322,483.0
13721,2012-07-30,3,1,7,22,47,183,230,338.0
13722,2012-07-30,3,1,7,23,34,116,150,234.0
13723,2012-07-31,3,1,7,0,11,27,38,139.33333333333334
13724,2012-07-31,3,1,7,1,3,18,21,69.66666666666667
13725,2012-07-31,3,1,7,2,0,8,8,22.333333333333332
13726,2012-07-31,3,1,7,3,1,5,6,11.666666666666666
13727,2012-07-31,3,1,7,4,0,6,6,6.666666666666667
13728,2012-07-31,3,1,7,5,5,40,45,19.0
13729,2012-07-31,3,1,7,6,2,192,194,81.66666666666667
13730,2012-07-31,3,1,7,7,21,492,513,250.66666666666666
13731,2012-07-31,3,1,7,8,30,730,760,489.0
13732,2012-07-31,3,1,7,9,31,302,333,535.3333333333334
13733,2012-07-31,3,1,7,10,73,154,227,440.0
13734,2012-07-31,3,1,7,11,54,170,224,261.3333333333333
13735,2012-07-31,3,1,7,12,50,198,248,233.0
13736,2012-07-31,3,1,7,13,69,219,288,253.33333333333334
13737,2012-07-31,3,1,7,14,72,188,260,265.3333333333333
13738,2012-07-31,3,1,7,15,29,115,144,230.66666666666666
13739,2012-07-31,3,1,7,16,66,336,402,268.6666666666667
13740,2012-07-31,3,1,7,17,94,726,820,455.3333333333333
13741,2012-07-31,3,1,7,18,99,758,857,693.0
13742,2012-07-31,3,1,7,19,90,524,614,763.6666666666666
13743,2012-07-31,3,1,7,20,55,397,452,641.0
13744,2012-07-31,3,1,7,21,60,292,352,472.6666666666667
13745,2012-07-31,3,1,7,22,33,224,257,353.6666666666667
13746,2012-07-31,3,1,7,23,20,127,147,252.0
13747,2012-08-01,3,1,8,0,3,44,47,150.33333333333334
13748,2012-08-01,3,1,8,1,5,28,33,75.66666666666667
13749,2012-08-01,3,1,8,2,0,13,13,31.0
13750,2012-08-01,3,1,8,3,0,7,7,17.666666666666668
13751,2012-08-01,3,1,8,4,1,3,4,8.0
13752,2012-08-01,3,1,8,5,3,46,49,20.0
13753,2012-08-01,3,1,8,6,6,179,185,79.33333333333333
13754,2012-08-01,3,1,8,7,19,468,487,240.33333333333334
13755,2012-08-01,3,1,8,8,32,649,681,451.0
13756,2012-08-01,3,1,8,9,34,316,350,506.0
13757,2012-08-01,3,1,8,10,61,175,236,422.3333333333333
13758,2012-08-01,3,1,8,11,54,180,234,273.3333333333333
13759,2012-08-01,3,1,8,12,75,209,284,251.33333333333334
13760,2012-08-01,3,1,8,13,59,221,280,266.0
13761,2012-08-01,3,1,8,14,88,175,263,275.6666666666667
13762,2012-08-01,3,1,8,15,89,206,295,279.3333333333333
13763,2012-08-01,3,1,8,16,93,386,479,345.6666666666667
13764,2012-08-01,3,1,8,17,103,734,837,537.0
13765,2012-08-01,3,1,8,18,105,786,891,735.6666666666666
13766,2012-08-01,3,1,8,19,88,564,652,793.3333333333334
13767,2012-08-01,3,1,8,20,65,448,513,685.3333333333334
13768,2012-08-01,3,1,8,21,36,284,320,495.0
13769,2012-08-01,3,1,8,22,37,251,288,373.6666666666667
13770,2012-08-01,3,1,8,23,18,134,152,253.33333333333334
13771,2012-08-02,3,1,8,0,8,55,63,167.66666666666666
13772,2012-08-02,3,1,8,1,6,36,42,85.66666666666667
13773,2012-08-02,3,1,8,2,3,8,11,38.666666666666664
13774,2012-08-02,3,1,8,3,0,6,6,19.666666666666668
13775,2012-08-02,3,1,8,4,0,9,9,8.666666666666666
13776,2012-08-02,3,1,8,5,4,37,41,18.666666666666668
13777,2012-08-02,3,1,8,6,6,177,183,77.66666666666667
13778,2012-08-02,3,1,8,7,21,452,473,232.33333333333334
13779,2012-08-02,3,1,8,8,21,718,739,465.0
13780,2012-08-02,3,1,8,9,31,312,343,518.3333333333334
13781,2012-08-02,3,1,8,10,51,130,181,421.0
13782,2012-08-02,3,1,8,11,59,167,226,250.0
13783,2012-08-02,3,1,8,12,56,230,286,231.0
13784,2012-08-02,3,1,8,13,98,212,310,274.0
13785,2012-08-02,3,1,8,14,54,171,225,273.6666666666667
13786,2012-08-02,3,1,8,15,68,202,270,268.3333333333333
13787,2012-08-02,3,1,8,16,71,335,406,300.3333333333333
13788,2012-08-02,3,1,8,17,90,775,865,513.6666666666666
13789,2012-08-02,3,1,8,18,86,681,767,679.3333333333334
13790,2012-08-02,3,1,8,19,98,509,607,746.3333333333334
13791,2012-08-02,3,1,8,20,51,376,427,600.3333333333334
13792,2012-08-02,3,1,8,21,41,301,342,458.6666666666667
13793,2012-08-02,3,1,8,22,35,227,262,343.6666666666667
13794,2012-08-02,3,1,8,23,25,152,177,260.3333333333333
13795,2012-08-03,3,1,8,0,15,56,71,170.0
13796,2012-08-03,3,1,8,1,11,32,43,97.0
13797,2012-08-03,3,1,8,2,0,14,14,42.666666666666664
13798,2012-08-03,3,1,8,3,1,5,6,21.0
13799,2012-08-03,3,1,8,4,1,11,12,10.666666666666666
13800,2012-08-03,3,1,8,5,2,35,37,18.333333333333332
13801,2012-08-03,3,1,8,6,5,158,163,70.66666666666667
13802,2012-08-03,3,1,8,7,25,396,421,207.0
13803,2012-08-03,3,1,8,8,32,636,668,417.3333333333333
13804,2012-08-03,3,1,8,9,69,327,396,495.0
13805,2012-08-03,3,1,8,10,82,167,249,437.6666666666667
13806,2012-08-03,3,1,8,11,77,186,263,302.6666666666667
13807,2012-08-03,3,1,8,12,95,243,338,283.3333333333333
13808,2012-08-03,3,1,8,13,98,247,345,315.3333333333333
13809,2012-08-03,3,1,8,14,102,229,331,338.0
13810,2012-08-03,3,1,8,15,112,268,380,352.0
13811,2012-08-03,3,1,8,16,112,380,492,401.0
13812,2012-08-03,3,1,8,17,95,646,741,537.6666666666666
13813,2012-08-03,3,1,8,18,98,573,671,634.6666666666666
13814,2012-08-03,3,1,8,19,81,388,469,627.0
13815,2012-08-03,3,1,8,20,89,300,389,509.6666666666667
13816,2012-08-03,3,1,8,21,54,224,278,378.6666666666667
13817,2012-08-03,3,1,8,22,46,156,202,289.6666666666667
13818,2012-08-03,3,1,8,23,26,170,196,225.33333333333334
13819,2012-08-04,3,1,8,0,24,137,161,186.33333333333334
13820,2012-08-04,3,1,8,1,23,99,122,159.66666666666666
13821,2012-08-04,3,1,8,2,20,64,84,122.33333333333333
13822,2012-08-04,3,1,8,3,11,19,30,78.66666666666667
13823,2012-08-04,3,1,8,4,2,11,13,42.333333333333336
13824,2012-08-04,3,1,8,5,1,16,17,20.0
13825,2012-08-04,3,1,8,6,12,37,49,26.333333333333332
13826,2012-08-04,3,1,8,7,18,49,67,44.333333333333336
13827,2012-08-04,3,1,8,8,49,132,181,99.0
13828,2012-08-04,3,1,8,9,61,217,278,175.33333333333334
13829,2012-08-04,3,1,8,10,108,288,396,285.0
13830,2012-08-04,3,1,8,11,155,315,470,381.3333333333333
13831,2012-08-04,3,1,8,12,222,325,547,471.0
13832,2012-08-04,3,1,8,13,195,332,527,514.6666666666666
13833,2012-08-04,3,1,8,14,183,289,472,515.3333333333334
13834,2012-08-04,3,1,8,15,205,284,489,496.0
13835,2012-08-04,3,1,8,16,197,253,450,470.3333333333333
13836,2012-08-04,3,1,8,17,179,313,492,477.0
13837,2012-08-04,3,1,8,18,169,321,490,477.3333333333333
13838,2012-08-04,3,1,8,19,133,264,397,459.6666666666667
13839,2012-08-04,3,1,8,20,117,195,312,399.6666666666667
13840,2012-08-04,3,1,8,21,96,193,289,332.6666666666667
13841,2012-08-04,3,1,8,22,104,165,269,290.0
13842,2012-08-04,3,1,8,23,61,161,222,260.0
13843,2012-08-05,3,1,8,0,32,121,153,214.66666666666666
13844,2012-08-05,3,1,8,1,8,79,87,154.0
13845,2012-08-05,3,1,8,2,5,68,73,104.33333333333333
13846,2012-08-05,3,1,8,3,9,32,41,67.0
13847,2012-08-05,3,1,8,4,3,11,14,42.666666666666664
13848,2012-08-05,3,1,8,5,1,18,19,24.666666666666668
13849,2012-08-05,3,1,8,6,7,12,19,17.333333333333332
13850,2012-08-05,3,1,8,7,18,50,68,35.333333333333336
13851,2012-08-05,3,1,8,8,27,81,108,65.0
13852,2012-08-05,3,1,8,9,61,168,229,135.0
13853,2012-08-05,3,1,8,10,111,253,364,233.66666666666666
13854,2012-08-05,3,1,8,11,155,282,437,343.3333333333333
13855,2012-08-05,3,1,8,12,161,330,491,430.6666666666667
13856,2012-08-05,3,1,8,13,208,315,523,483.6666666666667
13857,2012-08-05,3,1,8,14,161,365,526,513.3333333333334
13858,2012-08-05,3,1,8,15,164,286,450,499.6666666666667
13859,2012-08-05,3,1,8,16,143,278,421,465.6666666666667
13860,2012-08-05,3,1,8,17,122,260,382,417.6666666666667
13861,2012-08-05,3,1,8,18,75,154,229,344.0
13862,2012-08-05,3,1,8,19,46,139,185,265.3333333333333
13863,2012-08-05,3,1,8,20,53,140,193,202.33333333333334
13864,2012-08-05,3,1,8,21,51,157,208,195.33333333333334
13865,2012-08-05,3,1,8,22,57,100,157,186.0
13866,2012-08-05,3,1,8,23,29,58,87,150.66666666666666
13867,2012-08-06,3,1,8,0,9,24,33,92.33333333333333
13868,2012-08-06,3,1,8,1,1,10,11,43.666666666666664
13869,2012-08-06,3,1,8,2,0,5,5,16.333333333333332
13870,2012-08-06,3,1,8,3,0,5,5,7.0
13871,2012-08-06,3,1,8,4,3,8,11,7.0
13872,2012-08-06,3,1,8,5,2,23,25,13.666666666666666
13873,2012-08-06,3,1,8,6,4,137,141,59.0
13874,2012-08-06,3,1,8,7,14,393,407,191.0
13875,2012-08-06,3,1,8,8,27,578,605,384.3333333333333
13876,2012-08-06,3,1,8,9,28,248,276,429.3333333333333
13877,2012-08-06,3,1,8,10,54,159,213,364.6666666666667
13878,2012-08-06,3,1,8,11,108,152,260,249.66666666666666
13879,2012-08-06,3,1,8,12,72,213,285,252.66666666666666
13880,2012-08-06,3,1,8,13,85,204,289,278.0
13881,2012-08-06,3,1,8,14,99,188,287,287.0
13882,2012-08-06,3,1,8,15,91,183,274,283.3333333333333
13883,2012-08-06,3,1,8,16,88,363,451,337.3333333333333
13884,2012-08-06,3,1,8,17,112,746,858,527.6666666666666
13885,2012-08-06,3,1,8,18,100,743,843,717.3333333333334
13886,2012-08-06,3,1,8,19,109,531,640,780.3333333333334
13887,2012-08-06,3,1,8,20,89,368,457,646.6666666666666
13888,2012-08-06,3,1,8,21,72,245,317,471.3333333333333
13889,2012-08-06,3,1,8,22,50,157,207,327.0
13890,2012-08-06,3,1,8,23,16,97,113,212.33333333333334
13891,2012-08-07,3,1,8,0,15,32,47,122.33333333333333
13892,2012-08-07,3,1,8,1,2,16,18,59.333333333333336
13893,2012-08-07,3,1,8,2,6,7,13,26.0
13894,2012-08-07,3,1,8,3,0,6,6,12.333333333333334
13895,2012-08-07,3,1,8,4,2,7,9,9.333333333333334
13896,2012-08-07,3,1,8,5,3,33,36,17.0
13897,2012-08-07,3,1,8,6,3,176,179,74.66666666666667
13898,2012-08-07,3,1,8,7,21,481,502,239.0
13899,2012-08-07,3,1,8,8,41,664,705,462.0
13900,2012-08-07,3,1,8,9,44,283,327,511.3333333333333
13901,2012-08-07,3,1,8,10,89,161,250,427.3333333333333
13902,2012-08-07,3,1,8,11,84,130,214,263.6666666666667
13903,2012-08-07,3,1,8,12,86,197,283,249.0
13904,2012-08-07,3,1,8,13,68,185,253,250.0
13905,2012-08-07,3,1,8,14,76,185,261,265.6666666666667
13906,2012-08-07,3,1,8,15,100,206,306,273.3333333333333
13907,2012-08-07,3,1,8,16,101,344,445,337.3333333333333
13908,2012-08-07,3,1,8,17,125,743,868,539.6666666666666
13909,2012-08-07,3,1,8,18,103,711,814,709.0
13910,2012-08-07,3,1,8,19,104,506,610,764.0
13911,2012-08-07,3,1,8,20,74,374,448,624.0
13912,2012-08-07,3,1,8,21,70,247,317,458.3333333333333
13913,2012-08-07,3,1,8,22,43,181,224,329.6666666666667
13914,2012-08-07,3,1,8,23,18,120,138,226.33333333333334
13915,2012-08-08,3,1,8,0,12,46,58,140.0
13916,2012-08-08,3,1,8,1,3,20,23,73.0
13917,2012-08-08,3,1,8,2,1,5,6,29.0
13918,2012-08-08,3,1,8,3,1,6,7,12.0
13919,2012-08-08,3,1,8,4,1,6,7,6.666666666666667
13920,2012-08-08,3,1,8,5,3,40,43,19.0
13921,2012-08-08,3,1,8,6,4,169,173,74.33333333333333
13922,2012-08-08,3,1,8,7,24,458,482,232.66666666666666
13923,2012-08-08,3,1,8,8,48,689,737,464.0
13924,2012-08-08,3,1,8,9,33,308,341,520.0
13925,2012-08-08,3,1,8,10,63,151,214,430.6666666666667
13926,2012-08-08,3,1,8,11,80,159,239,264.6666666666667
13927,2012-08-08,3,1,8,12,63,217,280,244.33333333333334
13928,2012-08-08,3,1,8,13,101,212,313,277.3333333333333
13929,2012-08-08,3,1,8,14,63,173,236,276.3333333333333
13930,2012-08-08,3,1,8,15,110,168,278,275.6666666666667
13931,2012-08-08,3,1,8,16,113,328,441,318.3333333333333
13932,2012-08-08,3,1,8,17,107,751,858,525.6666666666666
13933,2012-08-08,3,1,8,18,117,745,862,720.3333333333334
13934,2012-08-08,3,1,8,19,119,567,686,802.0
13935,2012-08-08,3,1,8,20,76,424,500,682.6666666666666
13936,2012-08-08,3,1,8,21,70,311,381,522.3333333333334
13937,2012-08-08,3,1,8,22,35,198,233,371.3333333333333
13938,2012-08-08,3,1,8,23,16,120,136,250.0
13939,2012-08-09,3,1,8,0,16,51,67,145.33333333333334
13940,2012-08-09,3,1,8,1,5,23,28,77.0
13941,2012-08-09,3,1,8,2,2,12,14,36.333333333333336
13942,2012-08-09,3,1,8,3,1,5,6,16.0
13943,2012-08-09,3,1,8,4,0,10,10,10.0
13944,2012-08-09,3,1,8,5,4,37,41,19.0
13945,2012-08-09,3,1,8,6,5,162,167,72.66666666666667
13946,2012-08-09,3,1,8,7,24,451,475,227.66666666666666
13947,2012-08-09,3,1,8,8,28,670,698,446.6666666666667
13948,2012-08-09,3,1,8,9,54,299,353,508.6666666666667
13949,2012-08-09,3,1,8,10,72,133,205,418.6666666666667
13950,2012-08-09,3,1,8,11,94,166,260,272.6666666666667
13951,2012-08-09,3,1,8,12,85,192,277,247.33333333333334
13952,2012-08-09,3,1,8,13,80,201,281,272.6666666666667
13953,2012-08-09,3,1,8,14,86,161,247,268.3333333333333
13954,2012-08-09,3,1,8,15,63,204,267,265.0
13955,2012-08-09,3,1,8,16,97,320,417,310.3333333333333
13956,2012-08-09,3,1,8,17,111,699,810,498.0
13957,2012-08-09,3,1,8,18,78,733,811,679.3333333333334
13958,2012-08-09,3,1,8,19,90,533,623,748.0
13959,2012-08-09,3,1,8,20,91,387,478,637.3333333333334
13960,2012-08-09,3,1,8,21,50,286,336,479.0
13961,2012-08-09,3,1,8,22,41,218,259,357.6666666666667
13962,2012-08-09,3,1,8,23,19,137,156,250.33333333333334
13963,2012-08-10,3,1,8,0,17,68,85,166.66666666666666
13964,2012-08-10,3,1,8,1,6,35,41,94.0
13965,2012-08-10,3,1,8,2,6,14,20,48.666666666666664
13966,2012-08-10,3,1,8,3,3,6,9,23.333333333333332
13967,2012-08-10,3,1,8,4,0,7,7,12.0
13968,2012-08-10,3,1,8,5,4,29,33,16.333333333333332
13969,2012-08-10,3,1,8,6,3,41,44,28.0
13970,2012-08-10,3,1,8,7,5,128,133,70.0
13971,2012-08-10,3,1,8,8,7,112,119,98.66666666666667
13972,2012-08-10,3,1,8,9,21,199,220,157.33333333333334
13973,2012-08-10,3,1,8,10,27,166,193,177.33333333333334
13974,2012-08-10,3,1,8,11,73,178,251,221.33333333333334
13975,2012-08-10,3,1,8,12,75,240,315,253.0
13976,2012-08-10,3,1,8,13,66,224,290,285.3333333333333
13977,2012-08-10,3,1,8,14,71,236,307,304.0
13978,2012-08-10,3,1,8,15,100,224,324,307.0
13979,2012-08-10,3,1,8,16,96,371,467,366.0
13980,2012-08-10,3,1,8,17,111,619,730,507.0
13981,2012-08-10,3,1,8,18,88,552,640,612.3333333333334
13982,2012-08-10,3,1,8,19,98,394,492,620.6666666666666
13983,2012-08-10,3,1,8,20,55,315,370,500.6666666666667
13984,2012-08-10,3,1,8,21,50,236,286,382.6666666666667
13985,2012-08-10,3,1,8,22,50,168,218,291.3333333333333
13986,2012-08-10,3,1,8,23,33,159,192,232.0
13987,2012-08-11,3,1,8,0,38,142,180,196.66666666666666
13988,2012-08-11,3,1,8,1,32,84,116,162.66666666666666
13989,2012-08-11,3,1,8,2,19,66,85,127.0
13990,2012-08-11,3,1,8,3,2,19,21,74.0
13991,2012-08-11,3,1,8,4,3,7,10,38.666666666666664
13992,2012-08-11,3,1,8,5,2,9,11,14.0
13993,2012-08-11,3,1,8,6,5,18,23,14.666666666666666
13994,2012-08-11,3,1,8,7,8,54,62,32.0
13995,2012-08-11,3,1,8,8,30,132,162,82.33333333333333
13996,2012-08-11,3,1,8,9,54,217,271,165.0
13997,2012-08-11,3,1,8,10,125,282,407,280.0
13998,2012-08-11,3,1,8,11,203,296,499,392.3333333333333
13999,2012-08-11,3,1,8,12,214,332,546,484.0
14000,2012-08-11,3,1,8,13,228,341,569,538.0
14001,2012-08-11,3,1,8,14,248,290,538,551.0
14002,2012-08-11,3,1,8,15,246,316,562,556.3333333333334
14003,2012-08-11,3,1,8,16,227,304,531,543.6666666666666
14004,2012-08-11,3,1,8,17,220,292,512,535.0
14005,2012-08-11,3,1,8,18,107,193,300,447.6666666666667
14006,2012-08-11,3,1,8,19,97,178,275,362.3333333333333
14007,2012-08-11,3,1,8,20,31,129,160,245.0
14008,2012-08-11,3,1,8,21,26,102,128,187.66666666666666
14009,2012-08-11,3,1,8,22,40,128,168,152.0
14010,2012-08-11,3,1,8,23,42,121,163,153.0
14011,2012-08-12,3,1,8,0,24,96,120,150.33333333333334
14012,2012-08-12,3,1,8,1,21,92,113,132.0
14013,2012-08-12,3,1,8,2,19,67,86,106.33333333333333
14014,2012-08-12,3,1,8,3,11,37,48,82.33333333333333
14015,2012-08-12,3,1,8,4,2,8,10,48.0
14016,2012-08-12,3,1,8,5,1,9,10,22.666666666666668
14017,2012-08-12,3,1,8,6,2,14,16,12.0
14018,2012-08-12,3,1,8,7,9,30,39,21.666666666666668
14019,2012-08-12,3,1,8,8,35,84,119,58.0
14020,2012-08-12,3,1,8,9,64,153,217,125.0
14021,2012-08-12,3,1,8,10,88,240,328,221.33333333333334
14022,2012-08-12,3,1,8,11,167,282,449,331.3333333333333
14023,2012-08-12,3,1,8,12,163,342,505,427.3333333333333
14024,2012-08-12,3,1,8,13,178,365,543,499.0
14025,2012-08-12,3,1,8,14,213,366,579,542.3333333333334
14026,2012-08-12,3,1,8,15,235,342,577,566.3333333333334
14027,2012-08-12,3,1,8,16,213,300,513,556.3333333333334
14028,2012-08-12,3,1,8,17,186,319,505,531.6666666666666
14029,2012-08-12,3,1,8,18,164,327,491,503.0
14030,2012-08-12,3,1,8,19,148,317,465,487.0
14031,2012-08-12,3,1,8,20,96,204,300,418.6666666666667
14032,2012-08-12,3,1,8,21,78,142,220,328.3333333333333
14033,2012-08-12,3,1,8,22,40,141,181,233.66666666666666
14034,2012-08-12,3,1,8,23,25,85,110,170.33333333333334
14035,2012-08-13,3,1,8,0,14,33,47,112.66666666666667
14036,2012-08-13,3,1,8,1,3,11,14,57.0
14037,2012-08-13,3,1,8,2,1,8,9,23.333333333333332
14038,2012-08-13,3,1,8,3,1,5,6,9.666666666666666
14039,2012-08-13,3,1,8,4,0,11,11,8.666666666666666
14040,2012-08-13,3,1,8,5,3,33,36,17.666666666666668
14041,2012-08-13,3,1,8,6,4,155,159,68.66666666666667
14042,2012-08-13,3,1,8,7,11,425,436,210.33333333333334
14043,2012-08-13,3,1,8,8,25,648,673,422.6666666666667
14044,2012-08-13,3,1,8,9,40,265,305,471.3333333333333
14045,2012-08-13,3,1,8,10,88,111,199,392.3333333333333
14046,2012-08-13,3,1,8,11,94,151,245,249.66666666666666
14047,2012-08-13,3,1,8,12,96,180,276,240.0
14048,2012-08-13,3,1,8,13,79,175,254,258.3333333333333
14049,2012-08-13,3,1,8,14,85,163,248,259.3333333333333
14050,2012-08-13,3,1,8,15,80,194,274,258.6666666666667
14051,2012-08-13,3,1,8,16,116,348,464,328.6666666666667
14052,2012-08-13,3,1,8,17,102,716,818,518.6666666666666
14053,2012-08-13,3,1,8,18,103,709,812,698.0
14054,2012-08-13,3,1,8,19,88,467,555,728.3333333333334
14055,2012-08-13,3,1,8,20,58,374,432,599.6666666666666
14056,2012-08-13,3,1,8,21,44,246,290,425.6666666666667
14057,2012-08-13,3,1,8,22,44,148,192,304.6666666666667
14058,2012-08-13,3,1,8,23,28,100,128,203.33333333333334
14059,2012-08-14,3,1,8,0,12,48,60,126.66666666666667
14060,2012-08-14,3,1,8,1,8,19,27,71.66666666666667
14061,2012-08-14,3,1,8,2,2,9,11,32.666666666666664
14062,2012-08-14,3,1,8,3,0,3,3,13.666666666666666
14063,2012-08-14,3,1,8,4,0,5,5,6.333333333333333
14064,2012-08-14,3,1,8,5,1,35,36,14.666666666666666
14065,2012-08-14,3,1,8,6,1,63,64,35.0
14066,2012-08-14,3,1,8,7,1,178,179,93.0
14067,2012-08-14,3,1,8,8,27,591,618,287.0
14068,2012-08-14,3,1,8,9,48,354,402,399.6666666666667
14069,2012-08-14,3,1,8,10,53,155,208,409.3333333333333
14070,2012-08-14,3,1,8,11,69,127,196,268.6666666666667
14071,2012-08-14,3,1,8,12,93,207,300,234.66666666666666
14072,2012-08-14,3,1,8,13,83,203,286,260.6666666666667
14073,2012-08-14,3,1,8,14,80,175,255,280.3333333333333
14074,2012-08-14,3,1,8,15,84,199,283,274.6666666666667
14075,2012-08-14,3,1,8,16,95,363,458,332.0
14076,2012-08-14,3,1,8,17,78,734,812,517.6666666666666
14077,2012-08-14,3,1,8,18,97,757,854,708.0
14078,2012-08-14,3,1,8,19,94,533,627,764.3333333333334
14079,2012-08-14,3,1,8,20,65,371,436,639.0
14080,2012-08-14,3,1,8,21,56,252,308,457.0
14081,2012-08-14,3,1,8,22,28,161,189,311.0
14082,2012-08-14,3,1,8,23,53,114,167,221.33333333333334
14083,2012-08-15,3,1,8,0,8,52,60,138.66666666666666
14084,2012-08-15,3,1,8,1,6,31,37,88.0
14085,2012-08-15,3,1,8,2,1,7,8,35.0
14086,2012-08-15,3,1,8,3,1,10,11,18.666666666666668
14087,2012-08-15,3,1,8,4,0,4,4,7.666666666666667
14088,2012-08-15,3,1,8,5,4,35,39,18.0
14089,2012-08-15,3,1,8,6,12,160,172,71.66666666666667
14090,2012-08-15,3,1,8,7,25,467,492,234.33333333333334
14091,2012-08-15,3,1,8,8,40,642,682,448.6666666666667
14092,2012-08-15,3,1,8,9,57,310,367,513.6666666666666
14093,2012-08-15,3,1,8,10,70,163,233,427.3333333333333
14094,2012-08-15,3,1,8,11,80,155,235,278.3333333333333
14095,2012-08-15,3,1,8,12,77,230,307,258.3333333333333
14096,2012-08-15,3,1,8,13,88,206,294,278.6666666666667
14097,2012-08-15,3,1,8,14,94,161,255,285.3333333333333
14098,2012-08-15,3,1,8,15,70,196,266,271.6666666666667
14099,2012-08-15,3,1,8,16,91,340,431,317.3333333333333
14100,2012-08-15,3,1,8,17,102,749,851,516.0
14101,2012-08-15,3,1,8,18,80,768,848,710.0
14102,2012-08-15,3,1,8,19,124,525,649,782.6666666666666
14103,2012-08-15,3,1,8,20,72,355,427,641.3333333333334
14104,2012-08-15,3,1,8,21,49,266,315,463.6666666666667
14105,2012-08-15,3,1,8,22,29,197,226,322.6666666666667
14106,2012-08-15,3,1,8,23,18,120,138,226.33333333333334
14107,2012-08-16,3,1,8,0,13,63,76,146.66666666666666
14108,2012-08-16,3,1,8,1,3,18,21,78.33333333333333
14109,2012-08-16,3,1,8,2,0,15,15,37.333333333333336
14110,2012-08-16,3,1,8,3,0,4,4,13.333333333333334
14111,2012-08-16,3,1,8,4,2,3,5,8.0
14112,2012-08-16,3,1,8,5,7,30,37,15.333333333333334
14113,2012-08-16,3,1,8,6,3,162,165,69.0
14114,2012-08-16,3,1,8,7,16,448,464,222.0
14115,2012-08-16,3,1,8,8,33,649,682,437.0
14116,2012-08-16,3,1,8,9,41,296,337,494.3333333333333
14117,2012-08-16,3,1,8,10,78,121,199,406.0
14118,2012-08-16,3,1,8,11,83,191,274,270.0
14119,2012-08-16,3,1,8,12,96,247,343,272.0
14120,2012-08-16,3,1,8,13,81,219,300,305.6666666666667
14121,2012-08-16,3,1,8,14,72,176,248,297.0
14122,2012-08-16,3,1,8,15,63,197,260,269.3333333333333
14123,2012-08-16,3,1,8,16,79,340,419,309.0
14124,2012-08-16,3,1,8,17,130,767,897,525.3333333333334
14125,2012-08-16,3,1,8,18,109,723,832,716.0
14126,2012-08-16,3,1,8,19,119,558,677,802.0
14127,2012-08-16,3,1,8,20,100,414,514,674.3333333333334
14128,2012-08-16,3,1,8,21,83,273,356,515.6666666666666
14129,2012-08-16,3,1,8,22,69,185,254,374.6666666666667
14130,2012-08-16,3,1,8,23,58,168,226,278.6666666666667
14131,2012-08-17,3,1,8,0,21,67,88,189.33333333333334
14132,2012-08-17,3,1,8,1,16,38,54,122.66666666666667
14133,2012-08-17,3,1,8,2,4,15,19,53.666666666666664
14134,2012-08-17,3,1,8,3,0,6,6,26.333333333333332
14135,2012-08-17,3,1,8,4,0,9,9,11.333333333333334
14136,2012-08-17,3,1,8,5,2,34,36,17.0
14137,2012-08-17,3,1,8,6,6,151,157,67.33333333333333
14138,2012-08-17,3,1,8,7,11,368,379,190.66666666666666
14139,2012-08-17,3,1,8,8,43,625,668,401.3333333333333
14140,2012-08-17,3,1,8,9,58,320,378,475.0
14141,2012-08-17,3,1,8,10,82,149,231,425.6666666666667
14142,2012-08-17,3,1,8,11,98,205,303,304.0
14143,2012-08-17,3,1,8,12,110,255,365,299.6666666666667
14144,2012-08-17,3,1,8,13,103,254,357,341.6666666666667
14145,2012-08-17,3,1,8,14,128,200,328,350.0
14146,2012-08-17,3,1,8,15,127,256,383,356.0
14147,2012-08-17,3,1,8,16,116,372,488,399.6666666666667
14148,2012-08-17,3,1,8,17,144,647,791,554.0
14149,2012-08-17,3,1,8,18,108,561,669,649.3333333333334
14150,2012-08-17,3,1,8,19,88,403,491,650.3333333333334
14151,2012-08-17,3,1,8,20,97,262,359,506.3333333333333
14152,2012-08-17,3,1,8,21,57,198,255,368.3333333333333
14153,2012-08-17,3,1,8,22,43,170,213,275.6666666666667
14154,2012-08-17,3,1,8,23,21,100,121,196.33333333333334
14155,2012-08-18,3,1,8,0,6,99,105,146.33333333333334
14156,2012-08-18,3,1,8,1,14,78,92,106.0
14157,2012-08-18,3,1,8,2,4,39,43,80.0
14158,2012-08-18,3,1,8,3,7,23,30,55.0
14159,2012-08-18,3,1,8,4,5,8,13,28.666666666666668
14160,2012-08-18,3,1,8,5,2,7,9,17.333333333333332
14161,2012-08-18,3,1,8,6,4,23,27,16.333333333333332
14162,2012-08-18,3,1,8,7,12,52,64,33.333333333333336
14163,2012-08-18,3,1,8,8,28,161,189,93.33333333333333
14164,2012-08-18,3,1,8,9,81,211,292,181.66666666666666
14165,2012-08-18,3,1,8,10,166,314,480,320.3333333333333
14166,2012-08-18,3,1,8,11,180,356,536,436.0
14167,2012-08-18,3,1,8,12,266,388,654,556.6666666666666
14168,2012-08-18,3,1,8,13,289,355,644,611.3333333333334
14169,2012-08-18,3,1,8,14,242,356,598,632.0
14170,2012-08-18,3,1,8,15,250,346,596,612.6666666666666
14171,2012-08-18,3,1,8,16,287,354,641,611.6666666666666
14172,2012-08-18,3,1,8,17,256,379,635,624.0
14173,2012-08-18,3,1,8,18,225,329,554,610.0
14174,2012-08-18,3,1,8,19,164,324,488,559.0
14175,2012-08-18,3,1,8,20,99,242,341,461.0
14176,2012-08-18,3,1,8,21,90,248,338,389.0
14177,2012-08-18,3,1,8,22,90,171,261,313.3333333333333
14178,2012-08-18,3,1,8,23,60,175,235,278.0
14179,2012-08-19,3,1,8,0,44,143,187,227.66666666666666
14180,2012-08-19,3,1,8,1,29,102,131,184.33333333333334
14181,2012-08-19,3,1,8,2,16,103,119,145.66666666666666
14182,2012-08-19,3,1,8,3,21,34,55,101.66666666666667
14183,2012-08-19,3,1,8,4,4,22,26,66.66666666666667
14184,2012-08-19,3,1,8,5,3,8,11,30.666666666666668
14185,2012-08-19,3,1,8,6,5,15,20,19.0
14186,2012-08-19,3,1,8,7,12,29,41,24.0
14187,2012-08-19,3,1,8,8,34,90,124,61.666666666666664
14188,2012-08-19,3,1,8,9,86,184,270,145.0
14189,2012-08-19,3,1,8,10,138,287,425,273.0
14190,2012-08-19,3,1,8,11,83,189,272,322.3333333333333
14191,2012-08-19,3,1,8,12,112,186,298,331.6666666666667
14192,2012-08-19,3,1,8,13,50,112,162,244.0
14193,2012-08-19,3,1,8,14,41,108,149,203.0
14194,2012-08-19,3,1,8,15,89,187,276,195.66666666666666
14195,2012-08-19,3,1,8,16,97,259,356,260.3333333333333
14196,2012-08-19,3,1,8,17,76,267,343,325.0
14197,2012-08-19,3,1,8,18,86,291,377,358.6666666666667
14198,2012-08-19,3,1,8,19,72,269,341,353.6666666666667
14199,2012-08-19,3,1,8,20,61,213,274,330.6666666666667
14200,2012-08-19,3,1,8,21,36,154,190,268.3333333333333
14201,2012-08-19,3,1,8,22,6,50,56,173.33333333333334
14202,2012-08-19,3,1,8,23,7,39,46,97.33333333333333
14203,2012-08-20,3,1,8,0,1,25,26,42.666666666666664
14204,2012-08-20,3,1,8,1,0,10,10,27.333333333333332
14205,2012-08-20,3,1,8,2,0,5,5,13.666666666666666
14206,2012-08-20,3,1,8,3,0,3,3,6.0
14207,2012-08-20,3,1,8,4,0,7,7,5.0
14208,2012-08-20,3,1,8,5,2,35,37,15.666666666666666
14209,2012-08-20,3,1,8,6,6,155,161,68.33333333333333
14210,2012-08-20,3,1,8,7,15,427,442,213.33333333333334
14211,2012-08-20,3,1,8,8,37,618,655,419.3333333333333
14212,2012-08-20,3,1,8,9,55,302,357,484.6666666666667
14213,2012-08-20,3,1,8,10,69,124,193,401.6666666666667
14214,2012-08-20,3,1,8,11,90,151,241,263.6666666666667
14215,2012-08-20,3,1,8,12,66,216,282,238.66666666666666
14216,2012-08-20,3,1,8,13,97,194,291,271.3333333333333
14217,2012-08-20,3,1,8,14,87,188,275,282.6666666666667
14218,2012-08-20,3,1,8,15,102,207,309,291.6666666666667
14219,2012-08-20,3,1,8,16,103,357,460,348.0
14220,2012-08-20,3,1,8,17,83,810,893,554.0
14221,2012-08-20,3,1,8,18,89,726,815,722.6666666666666
14222,2012-08-20,3,1,8,19,33,266,299,669.0
14223,2012-08-20,3,1,8,20,30,231,261,458.3333333333333
14224,2012-08-20,3,1,8,21,26,219,245,268.3333333333333
14225,2012-08-20,3,1,8,22,25,136,161,222.33333333333334
14226,2012-08-20,3,1,8,23,10,92,102,169.33333333333334
14227,2012-08-21,3,1,8,0,7,52,59,107.33333333333333
14228,2012-08-21,3,1,8,1,11,22,33,64.66666666666667
14229,2012-08-21,3,1,8,2,1,7,8,33.333333333333336
14230,2012-08-21,3,1,8,3,0,3,3,14.666666666666666
14231,2012-08-21,3,1,8,4,0,4,4,5.0
14232,2012-08-21,3,1,8,5,4,30,34,13.666666666666666
14233,2012-08-21,3,1,8,6,5,164,169,69.0
14234,2012-08-21,3,1,8,7,19,500,519,240.66666666666666
14235,2012-08-21,3,1,8,8,27,696,723,470.3333333333333
14236,2012-08-21,3,1,8,9,47,281,328,523.3333333333334
14237,2012-08-21,3,1,8,10,58,120,178,409.6666666666667
14238,2012-08-21,3,1,8,11,61,195,256,254.0
14239,2012-08-21,3,1,8,12,79,226,305,246.33333333333334
14240,2012-08-21,3,1,8,13,76,255,331,297.3333333333333
14241,2012-08-21,3,1,8,14,110,192,302,312.6666666666667
14242,2012-08-21,3,1,8,15,76,226,302,311.6666666666667
14243,2012-08-21,3,1,8,16,109,358,467,357.0
14244,2012-08-21,3,1,8,17,92,786,878,549.0
14245,2012-08-21,3,1,8,18,93,532,625,656.6666666666666
14246,2012-08-21,3,1,8,19,56,420,476,659.6666666666666
14247,2012-08-21,3,1,8,20,62,296,358,486.3333333333333
14248,2012-08-21,3,1,8,21,41,239,280,371.3333333333333
14249,2012-08-21,3,1,8,22,24,208,232,290.0
14250,2012-08-21,3,1,8,23,23,113,136,216.0
14251,2012-08-22,3,1,8,0,9,46,55,141.0
14252,2012-08-22,3,1,8,1,1,20,21,70.66666666666667
14253,2012-08-22,3,1,8,2,7,10,17,31.0
14254,2012-08-22,3,1,8,3,0,7,7,15.0
14255,2012-08-22,3,1,8,4,1,7,8,10.666666666666666
14256,2012-08-22,3,1,8,5,2,38,40,18.333333333333332
14257,2012-08-22,3,1,8,6,12,175,187,78.33333333333333
14258,2012-08-22,3,1,8,7,16,537,553,260.0
14259,2012-08-22,3,1,8,8,37,703,740,493.3333333333333
14260,2012-08-22,3,1,8,9,41,335,376,556.3333333333334
14261,2012-08-22,3,1,8,10,66,159,225,447.0
14262,2012-08-22,3,1,8,11,71,196,267,289.3333333333333
14263,2012-08-22,3,1,8,12,59,253,312,268.0
14264,2012-08-22,3,1,8,13,74,242,316,298.3333333333333
14265,2012-08-22,3,1,8,14,82,184,266,298.0
14266,2012-08-22,3,1,8,15,94,222,316,299.3333333333333
14267,2012-08-22,3,1,8,16,102,358,460,347.3333333333333
14268,2012-08-22,3,1,8,17,72,711,783,519.6666666666666
14269,2012-08-22,3,1,8,18,91,592,683,642.0
14270,2012-08-22,3,1,8,19,56,524,580,682.0
14271,2012-08-22,3,1,8,20,59,332,391,551.3333333333334
14272,2012-08-22,3,1,8,21,60,291,351,440.6666666666667
14273,2012-08-22,3,1,8,22,55,226,281,341.0
14274,2012-08-22,3,1,8,23,27,113,140,257.3333333333333
14275,2012-08-23,3,1,8,0,9,51,60,160.33333333333334
14276,2012-08-23,3,1,8,1,10,15,25,75.0
14277,2012-08-23,3,1,8,2,9,11,20,35.0
14278,2012-08-23,3,1,8,3,3,6,9,18.0
14279,2012-08-23,3,1,8,4,0,6,6,11.666666666666666
14280,2012-08-23,3,1,8,5,1,36,37,17.333333333333332
14281,2012-08-23,3,1,8,6,14,178,192,78.33333333333333
14282,2012-08-23,3,1,8,7,18,463,481,236.66666666666666
14283,2012-08-23,3,1,8,8,45,662,707,460.0
14284,2012-08-23,3,1,8,9,58,354,412,533.3333333333334
14285,2012-08-23,3,1,8,10,76,157,233,450.6666666666667
14286,2012-08-23,3,1,8,11,86,192,278,307.6666666666667
14287,2012-08-23,3,1,8,12,97,235,332,281.0
14288,2012-08-23,3,1,8,13,93,253,346,318.6666666666667
14289,2012-08-23,3,1,8,14,114,191,305,327.6666666666667
14290,2012-08-23,3,1,8,15,104,201,305,318.6666666666667
14291,2012-08-23,3,1,8,16,121,344,465,358.3333333333333
14292,2012-08-23,3,1,8,17,111,709,820,530.0
14293,2012-08-23,3,1,8,18,130,811,941,742.0
14294,2012-08-23,3,1,8,19,96,537,633,798.0
14295,2012-08-23,3,1,8,20,70,404,474,682.6666666666666
14296,2012-08-23,3,1,8,21,53,276,329,478.6666666666667
14297,2012-08-23,3,1,8,22,21,177,198,333.6666666666667
14298,2012-08-23,3,1,8,23,24,133,157,228.0
14299,2012-08-24,3,1,8,0,27,84,111,155.33333333333334
14300,2012-08-24,3,1,8,1,5,37,42,103.33333333333333
14301,2012-08-24,3,1,8,2,1,15,16,56.333333333333336
14302,2012-08-24,3,1,8,3,2,6,8,22.0
14303,2012-08-24,3,1,8,4,2,6,8,10.666666666666666
14304,2012-08-24,3,1,8,5,1,37,38,18.0
14305,2012-08-24,3,1,8,6,9,142,151,65.66666666666667
14306,2012-08-24,3,1,8,7,13,412,425,204.66666666666666
14307,2012-08-24,3,1,8,8,41,703,744,440.0
14308,2012-08-24,3,1,8,9,58,331,389,519.3333333333334
14309,2012-08-24,3,1,8,10,78,184,262,465.0
14310,2012-08-24,3,1,8,11,69,212,281,310.6666666666667
14311,2012-08-24,3,1,8,12,95,276,371,304.6666666666667
14312,2012-08-24,3,1,8,13,79,272,351,334.3333333333333
14313,2012-08-24,3,1,8,14,109,229,338,353.3333333333333
14314,2012-08-24,3,1,8,15,99,251,350,346.3333333333333
14315,2012-08-24,3,1,8,16,101,414,515,401.0
14316,2012-08-24,3,1,8,17,117,695,812,559.0
14317,2012-08-24,3,1,8,18,109,627,736,687.6666666666666
14318,2012-08-24,3,1,8,19,106,430,536,694.6666666666666
14319,2012-08-24,3,1,8,20,66,297,363,545.0
14320,2012-08-24,3,1,8,21,58,248,306,401.6666666666667
14321,2012-08-24,3,1,8,22,42,209,251,306.6666666666667
14322,2012-08-24,3,1,8,23,38,140,178,245.0
14323,2012-08-25,3,1,8,0,21,114,135,188.0
14324,2012-08-25,3,1,8,1,15,100,115,142.66666666666666
14325,2012-08-25,3,1,8,2,18,61,79,109.66666666666667
14326,2012-08-25,3,1,8,3,7,31,38,77.33333333333333
14327,2012-08-25,3,1,8,4,3,9,12,43.0
14328,2012-08-25,3,1,8,5,4,10,14,21.333333333333332
14329,2012-08-25,3,1,8,6,5,25,30,18.666666666666668
14330,2012-08-25,3,1,8,7,14,88,102,48.666666666666664
14331,2012-08-25,3,1,8,8,29,133,162,98.0
14332,2012-08-25,3,1,8,9,60,228,288,184.0
14333,2012-08-25,3,1,8,10,148,294,442,297.3333333333333
14334,2012-08-25,3,1,8,11,143,314,457,395.6666666666667
14335,2012-08-25,3,1,8,12,217,367,584,494.3333333333333
14336,2012-08-25,3,1,8,13,186,331,517,519.3333333333334
14337,2012-08-25,3,1,8,14,150,332,482,527.6666666666666
14338,2012-08-25,3,1,8,15,79,154,233,410.6666666666667
14339,2012-08-25,3,1,8,16,174,260,434,383.0
14340,2012-08-25,3,1,8,17,132,271,403,356.6666666666667
14341,2012-08-25,3,1,8,18,122,261,383,406.6666666666667
14342,2012-08-25,3,1,8,19,97,257,354,380.0
14343,2012-08-25,3,1,8,20,65,176,241,326.0
14344,2012-08-25,3,1,8,21,60,148,208,267.6666666666667
14345,2012-08-25,3,1,8,22,46,136,182,210.33333333333334
14346,2012-08-25,3,1,8,23,34,124,158,182.66666666666666
14347,2012-08-26,3,1,8,0,23,111,134,158.0
14348,2012-08-26,3,1,8,1,18,116,134,142.0
14349,2012-08-26,3,1,8,2,12,104,116,128.0
14350,2012-08-26,3,1,8,3,11,42,53,101.0
14351,2012-08-26,3,1,8,4,5,11,16,61.666666666666664
14352,2012-08-26,3,1,8,5,3,13,16,28.333333333333332
14353,2012-08-26,3,1,8,6,5,16,21,17.666666666666668
14354,2012-08-26,3,1,8,7,11,23,34,23.666666666666668
14355,2012-08-26,3,1,8,8,21,112,133,62.666666666666664
14356,2012-08-26,3,1,8,9,67,196,263,143.33333333333334
14357,2012-08-26,3,1,8,10,127,258,385,260.3333333333333
14358,2012-08-26,3,1,8,11,150,332,482,376.6666666666667
14359,2012-08-26,3,1,8,12,225,401,626,497.6666666666667
14360,2012-08-26,3,1,8,13,166,375,541,549.6666666666666
14361,2012-08-26,3,1,8,14,125,252,377,514.6666666666666
14362,2012-08-26,3,1,8,15,132,259,391,436.3333333333333
14363,2012-08-26,3,1,8,16,57,116,173,313.6666666666667
14364,2012-08-26,3,1,8,17,61,172,233,265.6666666666667
14365,2012-08-26,3,1,8,18,77,187,264,223.33333333333334
14366,2012-08-26,3,1,8,19,80,212,292,263.0
14367,2012-08-26,3,1,8,20,40,171,211,255.66666666666666
14368,2012-08-26,3,1,8,21,26,140,166,223.0
14369,2012-08-26,3,1,8,22,20,94,114,163.66666666666666
14370,2012-08-26,3,1,8,23,21,59,80,120.0
14371,2012-08-27,3,1,8,0,4,28,32,75.33333333333333
14372,2012-08-27,3,1,8,1,3,4,7,39.666666666666664
14373,2012-08-27,3,1,8,2,0,8,8,15.666666666666666
14374,2012-08-27,3,1,8,3,1,3,4,6.333333333333333
14375,2012-08-27,3,1,8,4,1,11,12,8.0
14376,2012-08-27,3,1,8,5,4,32,36,17.333333333333332
14377,2012-08-27,3,1,8,6,4,141,145,64.33333333333333
14378,2012-08-27,3,1,8,7,15,418,433,204.66666666666666
14379,2012-08-27,3,1,8,8,29,670,699,425.6666666666667
14380,2012-08-27,3,1,8,9,40,302,342,491.3333333333333
14381,2012-08-27,3,1,8,10,63,143,206,415.6666666666667
14382,2012-08-27,3,1,8,11,47,182,229,259.0
14383,2012-08-27,3,1,8,12,69,214,283,239.33333333333334
14384,2012-08-27,3,1,8,13,77,211,288,266.6666666666667
14385,2012-08-27,3,1,8,14,66,180,246,272.3333333333333
14386,2012-08-27,3,1,8,15,77,205,282,272.0
14387,2012-08-27,3,1,8,16,77,367,444,324.0
14388,2012-08-27,3,1,8,17,101,744,845,523.6666666666666
14389,2012-08-27,3,1,8,18,83,751,834,707.6666666666666
14390,2012-08-27,3,1,8,19,74,499,573,750.6666666666666
14391,2012-08-27,3,1,8,20,50,366,416,607.6666666666666
14392,2012-08-27,3,1,8,21,39,239,278,422.3333333333333
14393,2012-08-27,3,1,8,22,30,131,161,285.0
14394,2012-08-27,3,1,8,23,35,79,114,184.33333333333334
14395,2012-08-28,3,1,8,0,9,29,38,104.33333333333333
14396,2012-08-28,3,1,8,1,4,17,21,57.666666666666664
14397,2012-08-28,3,1,8,2,2,13,15,24.666666666666668
14398,2012-08-28,3,1,8,3,0,4,4,13.333333333333334
14399,2012-08-28,3,1,8,4,2,6,8,9.0
14400,2012-08-28,3,1,8,5,3,39,42,18.0
14401,2012-08-28,3,1,8,6,3,144,147,65.66666666666667
14402,2012-08-28,3,1,8,7,14,255,269,152.66666666666666
14403,2012-08-28,3,1,8,8,25,668,693,369.6666666666667
14404,2012-08-28,3,1,8,9,44,351,395,452.3333333333333
14405,2012-08-28,3,1,8,10,39,165,204,430.6666666666667
14406,2012-08-28,3,1,8,11,47,171,218,272.3333333333333
14407,2012-08-28,3,1,8,12,56,241,297,239.66666666666666
14408,2012-08-28,3,1,8,13,56,232,288,267.6666666666667
14409,2012-08-28,3,1,8,14,72,179,251,278.6666666666667
14410,2012-08-28,3,1,8,15,59,258,317,285.3333333333333
14411,2012-08-28,3,1,8,16,84,396,480,349.3333333333333
14412,2012-08-28,3,1,8,17,90,774,864,553.6666666666666
14413,2012-08-28,3,1,8,18,82,736,818,720.6666666666666
14414,2012-08-28,3,1,8,19,82,515,597,759.6666666666666
14415,2012-08-28,3,1,8,20,87,348,435,616.6666666666666
14416,2012-08-28,3,1,8,21,38,276,314,448.6666666666667
14417,2012-08-28,3,1,8,22,20,196,216,321.6666666666667
14418,2012-08-28,3,1,8,23,17,92,109,213.0
14419,2012-08-29,3,1,8,0,8,39,47,124.0
14420,2012-08-29,3,1,8,1,2,12,14,56.666666666666664
14421,2012-08-29,3,1,8,2,2,4,6,22.333333333333332
14422,2012-08-29,3,1,8,3,0,9,9,9.666666666666666
14423,2012-08-29,3,1,8,4,2,8,10,8.333333333333334
14424,2012-08-29,3,1,8,5,3,37,40,19.666666666666668
14425,2012-08-29,3,1,8,6,6,175,181,77.0
14426,2012-08-29,3,1,8,7,23,531,554,258.3333333333333
14427,2012-08-29,3,1,8,8,28,780,808,514.3333333333334
14428,2012-08-29,3,1,8,9,40,308,348,570.0
14429,2012-08-29,3,1,8,10,34,144,178,444.6666666666667
14430,2012-08-29,3,1,8,11,67,186,253,259.6666666666667
14431,2012-08-29,3,1,8,12,79,281,360,263.6666666666667
14432,2012-08-29,3,1,8,13,68,232,300,304.3333333333333
14433,2012-08-29,3,1,8,14,87,214,301,320.3333333333333
14434,2012-08-29,3,1,8,15,96,242,338,313.0
14435,2012-08-29,3,1,8,16,104,389,493,377.3333333333333
14436,2012-08-29,3,1,8,17,108,762,870,567.0
14437,2012-08-29,3,1,8,18,119,693,812,725.0
14438,2012-08-29,3,1,8,19,120,523,643,775.0
14439,2012-08-29,3,1,8,20,49,378,427,627.3333333333334
14440,2012-08-29,3,1,8,21,48,265,313,461.0
14441,2012-08-29,3,1,8,22,50,185,235,325.0
14442,2012-08-29,3,1,8,23,34,123,157,235.0
14443,2012-08-30,3,1,8,0,14,51,65,152.33333333333334
14444,2012-08-30,3,1,8,1,6,17,23,81.66666666666667
14445,2012-08-30,3,1,8,2,3,14,17,35.0
14446,2012-08-30,3,1,8,3,0,5,5,15.0
14447,2012-08-30,3,1,8,4,4,4,8,10.0
14448,2012-08-30,3,1,8,5,2,33,35,16.0
14449,2012-08-30,3,1,8,6,8,155,163,68.66666666666667
14450,2012-08-30,3,1,8,7,31,501,532,243.33333333333334
14451,2012-08-30,3,1,8,8,53,701,754,483.0
14452,2012-08-30,3,1,8,9,57,339,396,560.6666666666666
14453,2012-08-30,3,1,8,10,73,161,234,461.3333333333333
14454,2012-08-30,3,1,8,11,85,191,276,302.0
14455,2012-08-30,3,1,8,12,73,221,294,268.0
14456,2012-08-30,3,1,8,13,76,214,290,286.6666666666667
14457,2012-08-30,3,1,8,14,74,199,273,285.6666666666667
14458,2012-08-30,3,1,8,15,99,239,338,300.3333333333333
14459,2012-08-30,3,1,8,16,77,405,482,364.3333333333333
14460,2012-08-30,3,1,8,17,93,751,844,554.6666666666666
14461,2012-08-30,3,1,8,18,109,744,853,726.3333333333334
14462,2012-08-30,3,1,8,19,78,532,610,769.0
14463,2012-08-30,3,1,8,20,68,403,471,644.6666666666666
14464,2012-08-30,3,1,8,21,32,275,307,462.6666666666667
14465,2012-08-30,3,1,8,22,38,253,291,356.3333333333333
14466,2012-08-30,3,1,8,23,19,133,152,250.0
14467,2012-08-31,3,1,8,0,13,69,82,175.0
14468,2012-08-31,3,1,8,1,8,24,32,88.66666666666667
14469,2012-08-31,3,1,8,2,9,11,20,44.666666666666664
14470,2012-08-31,3,1,8,3,3,2,5,19.0
14471,2012-08-31,3,1,8,4,0,7,7,10.666666666666666
14472,2012-08-31,3,1,8,5,2,27,29,13.666666666666666
14473,2012-08-31,3,1,8,6,7,101,108,48.0
14474,2012-08-31,3,1,8,7,21,400,421,186.0
14475,2012-08-31,3,1,8,8,36,654,690,406.3333333333333
14476,2012-08-31,3,1,8,9,61,337,398,503.0
14477,2012-08-31,3,1,8,10,59,197,256,448.0
14478,2012-08-31,3,1,8,11,88,221,309,321.0
14479,2012-08-31,3,1,8,12,120,290,410,325.0
14480,2012-08-31,3,1,8,13,97,271,368,362.3333333333333
14481,2012-08-31,3,1,8,14,112,324,436,404.6666666666667
14482,2012-08-31,3,1,8,15,109,417,526,443.3333333333333
14483,2012-08-31,3,1,8,16,111,417,528,496.6666666666667
14484,2012-08-31,3,1,8,17,129,488,617,557.0
14485,2012-08-31,3,1,8,18,87,459,546,563.6666666666666
14486,2012-08-31,3,1,8,19,91,361,452,538.3333333333334
14487,2012-08-31,3,1,8,20,102,254,356,451.3333333333333
14488,2012-08-31,3,1,8,21,71,232,303,370.3333333333333
14489,2012-08-31,3,1,8,22,65,212,277,312.0
14490,2012-08-31,3,1,8,23,32,142,174,251.33333333333334
14491,2012-09-01,3,1,9,0,22,146,168,206.33333333333334
14492,2012-09-01,3,1,9,1,11,68,79,140.33333333333334
14493,2012-09-01,3,1,9,2,8,61,69,105.33333333333333
14494,2012-09-01,3,1,9,3,6,29,35,61.0
14495,2012-09-01,3,1,9,4,3,9,12,38.666666666666664
14496,2012-09-01,3,1,9,5,2,20,22,23.0
14497,2012-09-01,3,1,9,6,13,23,36,23.333333333333332
14498,2012-09-01,3,1,9,7,8,58,66,41.333333333333336
14499,2012-09-01,3,1,9,8,28,134,162,88.0
14500,2012-09-01,3,1,9,9,62,175,237,155.0
14501,2012-09-01,3,1,9,10,128,289,417,272.0
14502,2012-09-01,3,1,9,11,219,273,492,382.0
14503,2012-09-01,3,1,9,12,187,284,471,460.0
14504,2012-09-01,3,1,9,13,237,267,504,489.0
14505,2012-09-01,3,1,9,14,240,274,514,496.3333333333333
14506,2012-09-01,3,1,9,15,257,306,563,527.0
14507,2012-09-01,3,1,9,16,209,253,462,513.0
14508,2012-09-01,3,1,9,17,205,258,463,496.0
14509,2012-09-01,3,1,9,18,184,258,442,455.6666666666667
14510,2012-09-01,3,1,9,19,157,235,392,432.3333333333333
14511,2012-09-01,3,1,9,20,67,140,207,347.0
14512,2012-09-01,3,1,9,21,21,83,104,234.33333333333334
14513,2012-09-01,3,1,9,22,21,57,78,129.66666666666666
14514,2012-09-01,3,1,9,23,57,88,145,109.0
14515,2012-09-02,3,1,9,0,27,72,99,107.33333333333333
14516,2012-09-02,3,1,9,1,15,58,73,105.66666666666667
14517,2012-09-02,3,1,9,2,28,56,84,85.33333333333333
14518,2012-09-02,3,1,9,3,9,33,42,66.33333333333333
14519,2012-09-02,3,1,9,4,7,15,22,49.333333333333336
14520,2012-09-02,3,1,9,5,2,10,12,25.333333333333332
14521,2012-09-02,3,1,9,6,2,13,15,16.333333333333332
14522,2012-09-02,3,1,9,7,13,29,42,23.0
14523,2012-09-02,3,1,9,8,30,99,129,62.0
14524,2012-09-02,3,1,9,9,88,144,232,134.33333333333334
14525,2012-09-02,3,1,9,10,158,230,388,249.66666666666666
14526,2012-09-02,3,1,9,11,226,263,489,369.6666666666667
14527,2012-09-02,3,1,9,12,248,297,545,474.0
14528,2012-09-02,3,1,9,13,263,230,493,509.0
14529,2012-09-02,3,1,9,14,249,208,457,498.3333333333333
14530,2012-09-02,3,1,9,15,179,176,355,435.0
14531,2012-09-02,3,1,9,16,222,252,474,428.6666666666667
14532,2012-09-02,3,1,9,17,219,284,503,444.0
14533,2012-09-02,3,1,9,18,227,273,500,492.3333333333333
14534,2012-09-02,3,1,9,19,140,152,292,431.6666666666667
14535,2012-09-02,3,1,9,20,63,41,104,298.6666666666667
14536,2012-09-02,3,1,9,21,79,92,171,189.0
14537,2012-09-02,3,1,9,22,66,100,166,147.0
14538,2012-09-02,3,1,9,23,53,70,123,153.33333333333334
14539,2012-09-03,3,1,9,0,42,62,104,131.0
14540,2012-09-03,3,1,9,1,18,37,55,94.0
14541,2012-09-03,3,1,9,2,10,30,40,66.33333333333333
14542,2012-09-03,3,1,9,3,6,22,28,41.0
14543,2012-09-03,3,1,9,4,6,5,11,26.333333333333332
14544,2012-09-03,3,1,9,5,1,3,4,14.333333333333334
14545,2012-09-03,3,1,9,6,3,12,15,10.0
14546,2012-09-03,3,1,9,7,6,37,43,20.666666666666668
14547,2012-09-03,3,1,9,8,36,91,127,61.666666666666664
14548,2012-09-03,3,1,9,9,71,158,229,133.0
14549,2012-09-03,3,1,9,10,135,224,359,238.33333333333334
14550,2012-09-03,3,1,9,11,187,272,459,349.0
14551,2012-09-03,3,1,9,12,191,352,543,453.6666666666667
14552,2012-09-03,3,1,9,13,209,357,566,522.6666666666666
14553,2012-09-03,3,1,9,14,163,349,512,540.3333333333334
14554,2012-09-03,3,1,9,15,168,281,449,509.0
14555,2012-09-03,3,1,9,16,165,335,500,487.0
14556,2012-09-03,3,1,9,17,181,317,498,482.3333333333333
14557,2012-09-03,3,1,9,18,145,337,482,493.3333333333333
14558,2012-09-03,3,1,9,19,73,301,374,451.3333333333333
14559,2012-09-03,3,1,9,20,78,183,261,372.3333333333333
14560,2012-09-03,3,1,9,21,42,142,184,273.0
14561,2012-09-03,3,1,9,22,17,104,121,188.66666666666666
14562,2012-09-03,3,1,9,23,12,58,70,125.0
14563,2012-09-04,3,1,9,0,10,19,29,73.33333333333333
14564,2012-09-04,3,1,9,1,15,9,24,41.0
14565,2012-09-04,3,1,9,2,1,4,5,19.333333333333332
14566,2012-09-04,3,1,9,3,1,9,10,13.0
14567,2012-09-04,3,1,9,4,0,8,8,7.666666666666667
14568,2012-09-04,3,1,9,5,1,37,38,18.666666666666668
14569,2012-09-04,3,1,9,6,7,165,172,72.66666666666667
14570,2012-09-04,3,1,9,7,13,480,493,234.33333333333334
14571,2012-09-04,3,1,9,8,15,617,632,432.3333333333333
14572,2012-09-04,3,1,9,9,30,293,323,482.6666666666667
14573,2012-09-04,3,1,9,10,42,130,172,375.6666666666667
14574,2012-09-04,3,1,9,11,39,159,198,231.0
14575,2012-09-04,3,1,9,12,54,233,287,219.0
14576,2012-09-04,3,1,9,13,72,203,275,253.33333333333334
14577,2012-09-04,3,1,9,14,72,202,274,278.6666666666667
14578,2012-09-04,3,1,9,15,68,224,292,280.3333333333333
14579,2012-09-04,3,1,9,16,61,397,458,341.3333333333333
14580,2012-09-04,3,1,9,17,110,746,856,535.3333333333334
14581,2012-09-04,3,1,9,18,94,745,839,717.6666666666666
14582,2012-09-04,3,1,9,19,50,502,552,749.0
14583,2012-09-04,3,1,9,20,47,338,385,592.0
14584,2012-09-04,3,1,9,21,28,240,268,401.6666666666667
14585,2012-09-04,3,1,9,22,25,154,179,277.3333333333333
14586,2012-09-04,3,1,9,23,12,83,95,180.66666666666666
14587,2012-09-05,3,1,9,0,10,27,37,103.66666666666667
14588,2012-09-05,3,1,9,1,2,11,13,48.333333333333336
14589,2012-09-05,3,1,9,2,0,9,9,19.666666666666668
14590,2012-09-05,3,1,9,3,0,4,4,8.666666666666666
14591,2012-09-05,3,1,9,4,2,3,5,6.0
14592,2012-09-05,3,1,9,5,1,39,40,16.333333333333332
14593,2012-09-05,3,1,9,6,7,203,210,85.0
14594,2012-09-05,3,1,9,7,11,489,500,250.0
14595,2012-09-05,3,1,9,8,33,692,725,478.3333333333333
14596,2012-09-05,3,1,9,9,27,263,290,505.0
14597,2012-09-05,3,1,9,10,54,181,235,416.6666666666667
14598,2012-09-05,3,1,9,11,61,156,217,247.33333333333334
14599,2012-09-05,3,1,9,12,49,217,266,239.33333333333334
14600,2012-09-05,3,1,9,13,50,184,234,239.0
14601,2012-09-05,3,1,9,14,34,177,211,237.0
14602,2012-09-05,3,1,9,15,41,204,245,230.0
14603,2012-09-05,3,1,9,16,86,344,430,295.3333333333333
14604,2012-09-05,3,1,9,17,83,780,863,512.6666666666666
14605,2012-09-05,3,1,9,18,82,757,839,710.6666666666666
14606,2012-09-05,3,1,9,19,64,598,662,788.0
14607,2012-09-05,3,1,9,20,55,357,412,637.6666666666666
14608,2012-09-05,3,1,9,21,18,278,296,456.6666666666667
14609,2012-09-05,3,1,9,22,38,181,219,309.0
14610,2012-09-05,3,1,9,23,24,126,150,221.66666666666666
14611,2012-09-06,3,1,9,0,30,35,65,144.66666666666666
14612,2012-09-06,3,1,9,1,2,16,18,77.66666666666667
14613,2012-09-06,3,1,9,2,1,7,8,30.333333333333332
14614,2012-09-06,3,1,9,3,0,9,9,11.666666666666666
14615,2012-09-06,3,1,9,4,0,8,8,8.333333333333334
14616,2012-09-06,3,1,9,5,3,35,38,18.333333333333332
14617,2012-09-06,3,1,9,6,11,189,200,82.0
14618,2012-09-06,3,1,9,7,21,461,482,240.0
14619,2012-09-06,3,1,9,8,24,622,646,442.6666666666667
14620,2012-09-06,3,1,9,9,8,115,123,417.0
14621,2012-09-06,3,1,9,10,9,40,49,272.6666666666667
14622,2012-09-06,3,1,9,11,10,52,62,78.0
14623,2012-09-06,3,1,9,12,11,126,137,82.66666666666667
14624,2012-09-06,3,1,9,13,39,152,191,130.0
14625,2012-09-06,3,1,9,14,38,178,216,181.33333333333334
14626,2012-09-06,3,1,9,15,42,228,270,225.66666666666666
14627,2012-09-06,3,1,9,16,42,374,416,300.6666666666667
14628,2012-09-06,3,1,9,17,67,741,808,498.0
14629,2012-09-06,3,1,9,18,74,761,835,686.3333333333334
14630,2012-09-06,3,1,9,19,54,504,558,733.6666666666666
14631,2012-09-06,3,1,9,20,50,356,406,599.6666666666666
14632,2012-09-06,3,1,9,21,32,240,272,412.0
14633,2012-09-06,3,1,9,22,24,193,217,298.3333333333333
14634,2012-09-06,3,1,9,23,19,150,169,219.33333333333334
14635,2012-09-07,3,1,9,0,17,79,96,160.66666666666666
14636,2012-09-07,3,1,9,1,10,19,29,98.0
14637,2012-09-07,3,1,9,2,1,10,11,45.333333333333336
14638,2012-09-07,3,1,9,3,0,9,9,16.333333333333332
14639,2012-09-07,3,1,9,4,1,7,8,9.333333333333334
14640,2012-09-07,3,1,9,5,1,39,40,19.0
14641,2012-09-07,3,1,9,6,5,135,140,62.666666666666664
14642,2012-09-07,3,1,9,7,21,465,486,222.0
14643,2012-09-07,3,1,9,8,29,690,719,448.3333333333333
14644,2012-09-07,3,1,9,9,33,311,344,516.3333333333334
14645,2012-09-07,3,1,9,10,53,171,224,429.0
14646,2012-09-07,3,1,9,11,81,215,296,288.0
14647,2012-09-07,3,1,9,12,76,247,323,281.0
14648,2012-09-07,3,1,9,13,71,283,354,324.3333333333333
14649,2012-09-07,3,1,9,14,66,187,253,310.0
14650,2012-09-07,3,1,9,15,66,265,331,312.6666666666667
14651,2012-09-07,3,1,9,16,75,395,470,351.3333333333333
14652,2012-09-07,3,1,9,17,88,684,772,524.3333333333334
14653,2012-09-07,3,1,9,18,95,697,792,678.0
14654,2012-09-07,3,1,9,19,70,498,568,710.6666666666666
14655,2012-09-07,3,1,9,20,51,340,391,583.6666666666666
14656,2012-09-07,3,1,9,21,55,246,301,420.0
14657,2012-09-07,3,1,9,22,52,247,299,330.3333333333333
14658,2012-09-07,3,1,9,23,28,220,248,282.6666666666667
14659,2012-09-08,3,1,9,0,20,130,150,232.33333333333334
14660,2012-09-08,3,1,9,1,10,107,117,171.66666666666666
14661,2012-09-08,3,1,9,2,9,68,77,114.66666666666667
14662,2012-09-08,3,1,9,3,3,40,43,79.0
14663,2012-09-08,3,1,9,4,3,8,11,43.666666666666664
14664,2012-09-08,3,1,9,5,2,13,15,23.0
14665,2012-09-08,3,1,9,6,8,26,34,20.0
14666,2012-09-08,3,1,9,7,11,71,82,43.666666666666664
14667,2012-09-08,3,1,9,8,33,197,230,115.33333333333333
14668,2012-09-08,3,1,9,9,87,261,348,220.0
14669,2012-09-08,3,1,9,10,100,322,422,333.3333333333333
14670,2012-09-08,3,1,9,11,173,405,578,449.3333333333333
14671,2012-09-08,3,1,9,12,220,474,694,564.6666666666666
14672,2012-09-08,3,1,9,13,233,435,668,646.6666666666666
14673,2012-09-08,3,1,9,14,260,366,626,662.6666666666666
14674,2012-09-08,3,1,9,15,175,337,512,602.0
14675,2012-09-08,3,1,9,16,19,95,114,417.3333333333333
14676,2012-09-08,3,1,9,17,52,119,171,265.6666666666667
14677,2012-09-08,3,1,9,18,27,140,167,150.66666666666666
14678,2012-09-08,3,1,9,19,28,187,215,184.33333333333334
14679,2012-09-08,3,1,9,20,28,166,194,192.0
14680,2012-09-08,3,1,9,21,26,155,181,196.66666666666666
14681,2012-09-08,3,1,9,22,18,176,194,189.66666666666666
14682,2012-09-08,3,1,9,23,12,121,133,169.33333333333334
14683,2012-09-09,3,1,9,0,18,106,124,150.33333333333334
14684,2012-09-09,3,1,9,1,20,104,124,127.0
14685,2012-09-09,3,1,9,2,15,81,96,114.66666666666667
14686,2012-09-09,3,1,9,3,14,32,46,88.66666666666667
14687,2012-09-09,3,1,9,4,12,16,28,56.666666666666664
14688,2012-09-09,3,1,9,5,16,39,55,43.0
14689,2012-09-09,3,1,9,6,11,24,35,39.333333333333336
14690,2012-09-09,3,1,9,7,20,50,70,53.333333333333336
14691,2012-09-09,3,1,9,8,27,143,170,91.66666666666667
14692,2012-09-09,3,1,9,9,85,214,299,179.66666666666666
14693,2012-09-09,3,1,9,10,172,323,495,321.3333333333333
14694,2012-09-09,3,1,9,11,194,391,585,459.6666666666667
14695,2012-09-09,3,1,9,12,247,510,757,612.3333333333334
14696,2012-09-09,3,1,9,13,238,491,729,690.3333333333334
14697,2012-09-09,3,1,9,14,232,415,647,711.0
14698,2012-09-09,3,1,9,15,284,412,696,690.6666666666666
14699,2012-09-09,3,1,9,16,228,473,701,681.3333333333334
14700,2012-09-09,3,1,9,17,213,458,671,689.3333333333334
14701,2012-09-09,3,1,9,18,156,404,560,644.0
14702,2012-09-09,3,1,9,19,134,362,496,575.6666666666666
14703,2012-09-09,3,1,9,20,91,265,356,470.6666666666667
14704,2012-09-09,3,1,9,21,57,149,206,352.6666666666667
14705,2012-09-09,3,1,9,22,64,125,189,250.33333333333334
14706,2012-09-09,3,1,9,23,22,70,92,162.33333333333334
14707,2012-09-10,3,1,9,0,6,35,41,107.33333333333333
14708,2012-09-10,3,1,9,1,7,11,18,50.333333333333336
14709,2012-09-10,3,1,9,2,11,6,17,25.333333333333332
14710,2012-09-10,3,1,9,3,5,7,12,15.666666666666666
14711,2012-09-10,3,1,9,4,1,4,5,11.333333333333334
14712,2012-09-10,3,1,9,5,4,36,40,19.0
14713,2012-09-10,3,1,9,6,8,172,180,75.0
14714,2012-09-10,3,1,9,7,20,427,447,222.33333333333334
14715,2012-09-10,3,1,9,8,33,697,730,452.3333333333333
14716,2012-09-10,3,1,9,9,40,321,361,512.6666666666666
14717,2012-09-10,3,1,9,10,42,168,210,433.6666666666667
14718,2012-09-10,3,1,9,11,69,167,236,269.0
14719,2012-09-10,3,1,9,12,76,256,332,259.3333333333333
14720,2012-09-10,3,1,9,13,72,251,323,297.0
14721,2012-09-10,3,1,9,14,107,233,340,331.6666666666667
14722,2012-09-10,3,1,9,15,115,231,346,336.3333333333333
14723,2012-09-10,3,1,9,16,108,380,488,391.3333333333333
14724,2012-09-10,3,1,9,17,127,744,871,568.3333333333334
14725,2012-09-10,3,1,9,18,111,857,968,775.6666666666666
14726,2012-09-10,3,1,9,19,71,562,633,824.0
14727,2012-09-10,3,1,9,20,34,356,390,663.6666666666666
14728,2012-09-10,3,1,9,21,29,256,285,436.0
14729,2012-09-10,3,1,9,22,15,144,159,278.0
14730,2012-09-10,3,1,9,23,7,86,93,179.0
14731,2012-09-11,3,1,9,0,5,27,32,94.66666666666667
14732,2012-09-11,3,1,9,1,0,10,10,45.0
14733,2012-09-11,3,1,9,2,1,5,6,16.0
14734,2012-09-11,3,1,9,3,1,7,8,8.0
14735,2012-09-11,3,1,9,4,1,8,9,7.666666666666667
14736,2012-09-11,3,1,9,5,3,41,44,20.333333333333332
14737,2012-09-11,3,1,9,6,11,200,211,88.0
14738,2012-09-11,3,1,9,7,24,572,596,283.6666666666667
14739,2012-09-11,3,1,9,8,48,702,750,519.0
14740,2012-09-11,3,1,9,9,35,323,358,568.0
14741,2012-09-11,3,1,9,10,54,142,196,434.6666666666667
14742,2012-09-11,3,1,9,11,60,187,247,267.0
14743,2012-09-11,3,1,9,12,62,254,316,253.0
14744,2012-09-11,3,1,9,13,72,256,328,297.0
14745,2012-09-11,3,1,9,14,74,181,255,299.6666666666667
14746,2012-09-11,3,1,9,15,73,253,326,303.0
14747,2012-09-11,3,1,9,16,99,437,536,372.3333333333333
14748,2012-09-11,3,1,9,17,168,802,970,610.6666666666666
14749,2012-09-11,3,1,9,18,110,767,877,794.3333333333334
14750,2012-09-11,3,1,9,19,56,540,596,814.3333333333334
14751,2012-09-11,3,1,9,20,40,421,461,644.6666666666666
14752,2012-09-11,3,1,9,21,28,282,310,455.6666666666667
14753,2012-09-11,3,1,9,22,27,189,216,329.0
14754,2012-09-11,3,1,9,23,18,91,109,211.66666666666666
14755,2012-09-12,3,1,9,0,8,41,49,124.66666666666667
14756,2012-09-12,3,1,9,1,2,19,21,59.666666666666664
14757,2012-09-12,3,1,9,2,2,9,11,27.0
14758,2012-09-12,3,1,9,3,0,7,7,13.0
14759,2012-09-12,3,1,9,4,0,5,5,7.666666666666667
14760,2012-09-12,3,1,9,5,4,44,48,20.0
14761,2012-09-12,3,1,9,6,6,199,205,86.0
14762,2012-09-12,3,1,9,7,24,533,557,270.0
14763,2012-09-12,3,1,9,8,43,727,770,510.6666666666667
14764,2012-09-12,3,1,9,9,50,278,328,551.6666666666666
14765,2012-09-12,3,1,9,10,57,148,205,434.3333333333333
14766,2012-09-12,3,1,9,11,51,181,232,255.0
14767,2012-09-12,3,1,9,12,88,264,352,263.0
14768,2012-09-12,3,1,9,13,85,238,323,302.3333333333333
14769,2012-09-12,3,1,9,14,78,200,278,317.6666666666667
14770,2012-09-12,3,1,9,15,75,243,318,306.3333333333333
14771,2012-09-12,3,1,9,16,90,419,509,368.3333333333333
14772,2012-09-12,3,1,9,17,114,811,925,584.0
14773,2012-09-12,3,1,9,18,91,886,977,803.6666666666666
14774,2012-09-12,3,1,9,19,78,557,635,845.6666666666666
14775,2012-09-12,3,1,9,20,38,432,470,694.0
14776,2012-09-12,3,1,9,21,27,279,306,470.3333333333333
14777,2012-09-12,3,1,9,22,23,189,212,329.3333333333333
14778,2012-09-12,3,1,9,23,16,111,127,215.0
14779,2012-09-13,3,1,9,0,11,46,57,132.0
14780,2012-09-13,3,1,9,1,6,22,28,70.66666666666667
14781,2012-09-13,3,1,9,2,0,9,9,31.333333333333332
14782,2012-09-13,3,1,9,3,2,9,11,16.0
14783,2012-09-13,3,1,9,4,0,6,6,8.666666666666666
14784,2012-09-13,3,1,9,5,3,54,57,24.666666666666668
14785,2012-09-13,3,1,9,6,9,186,195,86.0
14786,2012-09-13,3,1,9,7,22,549,571,274.3333333333333
14787,2012-09-13,3,1,9,8,33,725,758,508.0
14788,2012-09-13,3,1,9,9,46,292,338,555.6666666666666
14789,2012-09-13,3,1,9,10,63,149,212,436.0
14790,2012-09-13,3,1,9,11,71,183,254,268.0
14791,2012-09-13,3,1,9,12,57,240,297,254.33333333333334
14792,2012-09-13,3,1,9,13,60,223,283,278.0
14793,2012-09-13,3,1,9,14,60,214,274,284.6666666666667
14794,2012-09-13,3,1,9,15,99,253,352,303.0
14795,2012-09-13,3,1,9,16,85,406,491,372.3333333333333
14796,2012-09-13,3,1,9,17,97,787,884,575.6666666666666
14797,2012-09-13,3,1,9,18,108,744,852,742.3333333333334
14798,2012-09-13,3,1,9,19,80,594,674,803.3333333333334
14799,2012-09-13,3,1,9,20,55,408,463,663.0
14800,2012-09-13,3,1,9,21,26,291,317,484.6666666666667
14801,2012-09-13,3,1,9,22,28,223,251,343.6666666666667
14802,2012-09-13,3,1,9,23,33,137,170,246.0
14803,2012-09-14,3,1,9,0,24,63,87,169.33333333333334
14804,2012-09-14,3,1,9,1,6,35,41,99.33333333333333
14805,2012-09-14,3,1,9,2,7,23,30,52.666666666666664
14806,2012-09-14,3,1,9,3,5,9,14,28.333333333333332
14807,2012-09-14,3,1,9,4,1,11,12,18.666666666666668
14808,2012-09-14,3,1,9,5,1,40,41,22.333333333333332
14809,2012-09-14,3,1,9,6,8,144,152,68.33333333333333
14810,2012-09-14,3,1,9,7,17,437,454,215.66666666666666
14811,2012-09-14,3,1,9,8,51,715,766,457.3333333333333
14812,2012-09-14,3,1,9,9,46,301,347,522.3333333333334
14813,2012-09-14,3,1,9,10,75,171,246,453.0
14814,2012-09-14,3,1,9,11,84,196,280,291.0
14815,2012-09-14,3,1,9,12,119,290,409,311.6666666666667
14816,2012-09-14,3,1,9,13,107,301,408,365.6666666666667
14817,2012-09-14,3,1,9,14,113,258,371,396.0
14818,2012-09-14,3,1,9,15,94,273,367,382.0
14819,2012-09-14,3,1,9,16,109,454,563,433.6666666666667
14820,2012-09-14,3,1,9,17,137,757,894,608.0
14821,2012-09-14,3,1,9,18,116,692,808,755.0
14822,2012-09-14,3,1,9,19,83,496,579,760.3333333333334
14823,2012-09-14,3,1,9,20,67,337,404,597.0
14824,2012-09-14,3,1,9,21,42,270,312,431.6666666666667
14825,2012-09-14,3,1,9,22,40,189,229,315.0
14826,2012-09-14,3,1,9,23,27,168,195,245.33333333333334
14827,2012-09-15,3,1,9,0,38,169,207,210.33333333333334
14828,2012-09-15,3,1,9,1,8,101,109,170.33333333333334
14829,2012-09-15,3,1,9,2,18,75,93,136.33333333333334
14830,2012-09-15,3,1,9,3,6,31,37,79.66666666666667
14831,2012-09-15,3,1,9,4,3,3,6,45.333333333333336
14832,2012-09-15,3,1,9,5,1,15,16,19.666666666666668
14833,2012-09-15,3,1,9,6,6,27,33,18.333333333333332
14834,2012-09-15,3,1,9,7,10,63,73,40.666666666666664
14835,2012-09-15,3,1,9,8,43,169,212,106.0
14836,2012-09-15,3,1,9,9,79,263,342,209.0
14837,2012-09-15,3,1,9,10,119,323,442,332.0
14838,2012-09-15,3,1,9,11,228,399,627,470.3333333333333
14839,2012-09-15,3,1,9,12,287,419,706,591.6666666666666
14840,2012-09-15,3,1,9,13,327,377,704,679.0
14841,2012-09-15,3,1,9,14,325,390,715,708.3333333333334
14842,2012-09-15,3,1,9,15,312,342,654,691.0
14843,2012-09-15,3,1,9,16,350,433,783,717.3333333333334
14844,2012-09-15,3,1,9,17,295,434,729,722.0
14845,2012-09-15,3,1,9,18,232,382,614,708.6666666666666
14846,2012-09-15,3,1,9,19,169,309,478,607.0
14847,2012-09-15,3,1,9,20,89,241,330,474.0
14848,2012-09-15,3,1,9,21,86,210,296,368.0
14849,2012-09-15,3,1,9,22,82,197,279,301.6666666666667
14850,2012-09-15,3,1,9,23,47,182,229,268.0
14851,2012-09-16,3,1,9,0,28,123,151,219.66666666666666
14852,2012-09-16,3,1,9,1,35,82,117,165.66666666666666
14853,2012-09-16,3,1,9,2,27,62,89,119.0
14854,2012-09-16,3,1,9,3,10,38,48,84.66666666666667
14855,2012-09-16,3,1,9,4,2,6,8,48.333333333333336
14856,2012-09-16,3,1,9,5,3,10,13,23.0
14857,2012-09-16,3,1,9,6,9,26,35,18.666666666666668
14858,2012-09-16,3,1,9,7,28,43,71,39.666666666666664
14859,2012-09-16,3,1,9,8,34,94,128,78.0
14860,2012-09-16,3,1,9,9,70,226,296,165.0
14861,2012-09-16,3,1,9,10,160,330,490,304.6666666666667
14862,2012-09-16,3,1,9,11,183,376,559,448.3333333333333
14863,2012-09-16,3,1,9,12,188,468,656,568.3333333333334
14864,2012-09-16,3,1,9,13,240,454,694,636.3333333333334
14865,2012-09-16,3,1,9,14,225,410,635,661.6666666666666
14866,2012-09-16,3,1,9,15,215,342,557,628.6666666666666
14867,2012-09-16,3,1,9,16,194,402,596,596.0
14868,2012-09-16,3,1,9,17,177,393,570,574.3333333333334
14869,2012-09-16,3,1,9,18,120,361,481,549.0
14870,2012-09-16,3,1,9,19,91,312,403,484.6666666666667
14871,2012-09-16,3,1,9,20,57,267,324,402.6666666666667
14872,2012-09-16,3,1,9,21,43,148,191,306.0
14873,2012-09-16,3,1,9,22,18,109,127,214.0
14874,2012-09-16,3,1,9,23,9,85,94,137.33333333333334
14875,2012-09-17,3,1,9,0,14,31,45,88.66666666666667
14876,2012-09-17,3,1,9,1,9,12,21,53.333333333333336
14877,2012-09-17,3,1,9,2,5,8,13,26.333333333333332
14878,2012-09-17,3,1,9,3,0,7,7,13.666666666666666
14879,2012-09-17,3,1,9,4,2,9,11,10.333333333333334
14880,2012-09-17,3,1,9,5,1,44,45,21.0
14881,2012-09-17,3,1,9,6,7,157,164,73.33333333333333
14882,2012-09-17,3,1,9,7,18,474,492,233.66666666666666
14883,2012-09-17,3,1,9,8,36,647,683,446.3333333333333
14884,2012-09-17,3,1,9,9,34,265,299,491.3333333333333
14885,2012-09-17,3,1,9,10,73,129,202,394.6666666666667
14886,2012-09-17,3,1,9,11,61,191,252,251.0
14887,2012-09-17,3,1,9,12,62,233,295,249.66666666666666
14888,2012-09-17,3,1,9,13,112,231,343,296.6666666666667
14889,2012-09-17,3,1,9,14,129,203,332,323.3333333333333
14890,2012-09-17,3,1,9,15,82,256,338,337.6666666666667
14891,2012-09-17,3,1,9,16,74,379,453,374.3333333333333
14892,2012-09-17,3,1,9,17,102,740,842,544.3333333333334
14893,2012-09-17,3,1,9,18,66,708,774,689.6666666666666
14894,2012-09-17,3,1,9,19,51,435,486,700.6666666666666
14895,2012-09-17,3,1,9,20,32,308,340,533.3333333333334
14896,2012-09-17,3,1,9,21,28,205,233,353.0
14897,2012-09-17,3,1,9,22,20,109,129,234.0
14898,2012-09-17,3,1,9,23,4,66,70,144.0
14899,2012-09-18,3,1,9,0,2,11,13,70.66666666666667
14900,2012-09-18,3,1,9,1,0,5,5,29.333333333333332
14901,2012-09-18,3,1,9,2,0,4,4,7.333333333333333
14902,2012-09-18,3,1,9,3,0,6,6,5.0
14903,2012-09-18,3,1,9,4,2,5,7,5.666666666666667
14904,2012-09-18,3,1,9,5,3,45,48,20.333333333333332
14905,2012-09-18,3,1,9,6,4,163,167,74.0
14906,2012-09-18,3,1,9,7,13,343,356,190.33333333333334
14907,2012-09-18,3,1,9,8,32,640,672,398.3333333333333
14908,2012-09-18,3,1,9,9,27,266,293,440.3333333333333
14909,2012-09-18,3,1,9,10,30,130,160,375.0
14910,2012-09-18,3,1,9,11,36,115,151,201.33333333333334
14911,2012-09-18,3,1,9,12,16,72,88,133.0
14912,2012-09-18,3,1,9,13,17,97,114,117.66666666666667
14913,2012-09-18,3,1,9,14,27,116,143,115.0
14914,2012-09-18,3,1,9,15,1,35,36,97.66666666666667
14915,2012-09-18,3,1,9,16,19,122,141,106.66666666666667
14916,2012-09-18,3,1,9,17,36,302,338,171.66666666666666
14917,2012-09-18,3,1,9,18,19,262,281,253.33333333333334
14918,2012-09-18,3,1,9,19,22,302,324,314.3333333333333
14919,2012-09-18,3,1,9,20,19,271,290,298.3333333333333
14920,2012-09-18,3,1,9,21,21,186,207,273.6666666666667
14921,2012-09-18,3,1,9,22,14,137,151,216.0
14922,2012-09-18,3,1,9,23,11,67,78,145.33333333333334
14923,2012-09-19,3,1,9,0,3,23,26,85.0
14924,2012-09-19,3,1,9,1,0,12,12,38.666666666666664
14925,2012-09-19,3,1,9,2,0,3,3,13.666666666666666
14926,2012-09-19,3,1,9,3,1,4,5,6.666666666666667
14927,2012-09-19,3,1,9,4,0,10,10,6.0
14928,2012-09-19,3,1,9,5,2,54,56,23.666666666666668
14929,2012-09-19,3,1,9,6,6,166,172,79.33333333333333
14930,2012-09-19,3,1,9,7,16,529,545,257.6666666666667
14931,2012-09-19,3,1,9,8,39,758,797,504.6666666666667
14932,2012-09-19,3,1,9,9,26,336,362,568.0
14933,2012-09-19,3,1,9,10,23,169,192,450.3333333333333
14934,2012-09-19,3,1,9,11,44,203,247,267.0
14935,2012-09-19,3,1,9,12,53,260,313,250.66666666666666
14936,2012-09-19,3,1,9,13,55,234,289,283.0
14937,2012-09-19,3,1,9,14,59,227,286,296.0
14938,2012-09-19,3,1,9,15,57,254,311,295.3333333333333
14939,2012-09-19,3,1,9,16,69,397,466,354.3333333333333
14940,2012-09-19,3,1,9,17,74,812,886,554.3333333333334
14941,2012-09-19,3,1,9,18,85,807,892,748.0
14942,2012-09-19,3,1,9,19,72,539,611,796.3333333333334
14943,2012-09-19,3,1,9,20,31,378,409,637.3333333333334
14944,2012-09-19,3,1,9,21,25,324,349,456.3333333333333
14945,2012-09-19,3,1,9,22,31,198,229,329.0
14946,2012-09-19,3,1,9,23,17,106,123,233.66666666666666
14947,2012-09-20,3,1,9,0,12,46,58,136.66666666666666
14948,2012-09-20,3,1,9,1,4,14,18,66.33333333333333
14949,2012-09-20,3,1,9,2,2,9,11,29.0
14950,2012-09-20,3,1,9,3,0,6,6,11.666666666666666
14951,2012-09-20,3,1,9,4,0,6,6,7.666666666666667
14952,2012-09-20,3,1,9,5,4,52,56,22.666666666666668
14953,2012-09-20,3,1,9,6,9,161,170,77.33333333333333
14954,2012-09-20,3,1,9,7,20,514,534,253.33333333333334
14955,2012-09-20,3,1,9,8,44,746,790,498.0
14956,2012-09-20,3,1,9,9,25,330,355,559.6666666666666
14957,2012-09-20,3,1,9,10,33,157,190,445.0
14958,2012-09-20,3,1,9,11,37,206,243,262.6666666666667
14959,2012-09-20,3,1,9,12,57,233,290,241.0
14960,2012-09-20,3,1,9,13,68,268,336,289.6666666666667
14961,2012-09-20,3,1,9,14,76,222,298,308.0
14962,2012-09-20,3,1,9,15,60,231,291,308.3333333333333
14963,2012-09-20,3,1,9,16,72,385,457,348.6666666666667
14964,2012-09-20,3,1,9,17,91,885,976,574.6666666666666
14965,2012-09-20,3,1,9,18,119,781,900,777.6666666666666
14966,2012-09-20,3,1,9,19,69,534,603,826.3333333333334
14967,2012-09-20,3,1,9,20,57,360,417,640.0
14968,2012-09-20,3,1,9,21,28,246,274,431.3333333333333
14969,2012-09-20,3,1,9,22,35,252,287,326.0
14970,2012-09-20,3,1,9,23,17,137,154,238.33333333333334
14971,2012-09-21,3,1,9,0,13,53,66,169.0
14972,2012-09-21,3,1,9,1,11,38,49,89.66666666666667
14973,2012-09-21,3,1,9,2,6,8,14,43.0
14974,2012-09-21,3,1,9,3,1,11,12,25.0
14975,2012-09-21,3,1,9,4,1,9,10,12.0
14976,2012-09-21,3,1,9,5,2,47,49,23.666666666666668
14977,2012-09-21,3,1,9,6,19,146,165,74.66666666666667
14978,2012-09-21,3,1,9,7,35,468,503,239.0
14979,2012-09-21,3,1,9,8,31,726,757,475.0
14980,2012-09-21,3,1,9,9,35,348,383,547.6666666666666
14981,2012-09-21,3,1,9,10,44,181,225,455.0
14982,2012-09-21,3,1,9,11,79,242,321,309.6666666666667
14983,2012-09-21,3,1,9,12,84,305,389,311.6666666666667
14984,2012-09-21,3,1,9,13,105,316,421,377.0
14985,2012-09-21,3,1,9,14,113,299,412,407.3333333333333
14986,2012-09-21,3,1,9,15,90,333,423,418.6666666666667
14987,2012-09-21,3,1,9,16,103,464,567,467.3333333333333
14988,2012-09-21,3,1,9,17,107,739,846,612.0
14989,2012-09-21,3,1,9,18,106,699,805,739.3333333333334
14990,2012-09-21,3,1,9,19,95,493,588,746.3333333333334
14991,2012-09-21,3,1,9,20,54,315,369,587.3333333333334
14992,2012-09-21,3,1,9,21,46,266,312,423.0
14993,2012-09-21,3,1,9,22,47,248,295,325.3333333333333
14994,2012-09-21,3,1,9,23,23,163,186,264.3333333333333
14995,2012-09-22,3,1,9,0,32,140,172,217.66666666666666
14996,2012-09-22,3,1,9,1,18,106,124,160.66666666666666
14997,2012-09-22,3,1,9,2,10,73,83,126.33333333333333
14998,2012-09-22,3,1,9,3,6,39,45,84.0
14999,2012-09-22,3,1,9,4,5,10,15,47.666666666666664
15000,2012-09-22,3,1,9,5,2,15,17,25.666666666666668
15001,2012-09-22,3,1,9,6,6,35,41,24.333333333333332
15002,2012-09-22,3,1,9,7,7,70,77,45.0
15003,2012-09-22,3,1,9,8,21,197,218,112.0
15004,2012-09-22,3,1,9,9,88,289,377,224.0
15005,2012-09-22,3,1,9,10,124,350,474,356.3333333333333
15006,2012-09-22,3,1,9,11,189,437,626,492.3333333333333
15007,2012-09-22,3,1,9,12,228,460,688,596.0
15008,2012-09-22,3,1,9,13,273,434,707,673.6666666666666
15009,2012-09-22,3,1,9,14,250,404,654,683.0
15010,2012-09-22,3,1,9,15,307,443,750,703.6666666666666
15011,2012-09-22,3,1,9,16,253,427,680,694.6666666666666
15012,2012-09-22,3,1,9,17,195,451,646,692.0
15013,2012-09-22,3,1,9,18,171,427,598,641.3333333333334
15014,2012-09-22,3,1,9,19,99,308,407,550.3333333333334
15015,2012-09-22,3,1,9,20,76,249,325,443.3333333333333
15016,2012-09-22,3,1,9,21,59,202,261,331.0
15017,2012-09-22,3,1,9,22,59,180,239,275.0
15018,2012-09-22,3,1,9,23,34,137,171,223.66666666666666
15019,2012-09-23,4,1,9,0,34,146,180,196.66666666666666
15020,2012-09-23,4,1,9,1,23,119,142,164.33333333333334
15021,2012-09-23,4,1,9,2,18,77,95,139.0
15022,2012-09-23,4,1,9,3,13,41,54,97.0
15023,2012-09-23,4,1,9,4,1,9,10,53.0
15024,2012-09-23,4,1,9,5,1,5,6,23.333333333333332
15025,2012-09-23,4,1,9,6,5,11,16,10.666666666666666
15026,2012-09-23,4,1,9,7,9,48,57,26.333333333333332
15027,2012-09-23,4,1,9,8,38,137,175,82.66666666666667
15028,2012-09-23,4,1,9,9,71,205,276,169.33333333333334
15029,2012-09-23,4,1,9,10,138,351,489,313.3333333333333
15030,2012-09-23,4,1,9,11,186,384,570,445.0
15031,2012-09-23,4,1,9,12,250,526,776,611.6666666666666
15032,2012-09-23,4,1,9,13,257,445,702,682.6666666666666
15033,2012-09-23,4,1,9,14,266,400,666,714.6666666666666
15034,2012-09-23,4,1,9,15,265,375,640,669.3333333333334
15035,2012-09-23,4,1,9,16,254,437,691,665.6666666666666
15036,2012-09-23,4,1,9,17,227,496,723,684.6666666666666
15037,2012-09-23,4,1,9,18,135,405,540,651.3333333333334
15038,2012-09-23,4,1,9,19,82,331,413,558.6666666666666
15039,2012-09-23,4,1,9,20,60,192,252,401.6666666666667
15040,2012-09-23,4,1,9,21,51,145,196,287.0
15041,2012-09-23,4,1,9,22,40,98,138,195.33333333333334
15042,2012-09-23,4,1,9,23,30,70,100,144.66666666666666
15043,2012-09-24,4,1,9,0,10,54,64,100.66666666666667
15044,2012-09-24,4,1,9,1,6,12,18,60.666666666666664
15045,2012-09-24,4,1,9,2,0,8,8,30.0
15046,2012-09-24,4,1,9,3,0,5,5,10.333333333333334
15047,2012-09-24,4,1,9,4,0,8,8,7.0
15048,2012-09-24,4,1,9,5,2,35,37,16.666666666666668
15049,2012-09-24,4,1,9,6,6,162,168,71.0
15050,2012-09-24,4,1,9,7,17,513,530,245.0
15051,2012-09-24,4,1,9,8,31,719,750,482.6666666666667
15052,2012-09-24,4,1,9,9,42,286,328,536.0
15053,2012-09-24,4,1,9,10,52,146,198,425.3333333333333
15054,2012-09-24,4,1,9,11,71,167,238,254.66666666666666
15055,2012-09-24,4,1,9,12,77,265,342,259.3333333333333
15056,2012-09-24,4,1,9,13,80,248,328,302.6666666666667
15057,2012-09-24,4,1,9,14,77,226,303,324.3333333333333
15058,2012-09-24,4,1,9,15,84,216,300,310.3333333333333
15059,2012-09-24,4,1,9,16,99,417,516,373.0
15060,2012-09-24,4,1,9,17,89,809,898,571.3333333333334
15061,2012-09-24,4,1,9,18,95,758,853,755.6666666666666
15062,2012-09-24,4,1,9,19,56,534,590,780.3333333333334
15063,2012-09-24,4,1,9,20,52,380,432,625.0
15064,2012-09-24,4,1,9,21,26,230,256,426.0
15065,2012-09-24,4,1,9,22,18,154,172,286.6666666666667
15066,2012-09-24,4,1,9,23,11,83,94,174.0
15067,2012-09-25,4,1,9,0,8,56,64,110.0
15068,2012-09-25,4,1,9,1,2,11,13,57.0
15069,2012-09-25,4,1,9,2,5,9,14,30.333333333333332
15070,2012-09-25,4,1,9,3,2,3,5,10.666666666666666
15071,2012-09-25,4,1,9,4,2,7,9,9.333333333333334
15072,2012-09-25,4,1,9,5,1,46,47,20.333333333333332
15073,2012-09-25,4,1,9,6,5,189,194,83.33333333333333
15074,2012-09-25,4,1,9,7,17,539,556,265.6666666666667
15075,2012-09-25,4,1,9,8,41,764,805,518.3333333333334
15076,2012-09-25,4,1,9,9,28,381,409,590.0
15077,2012-09-25,4,1,9,10,45,125,170,461.3333333333333
15078,2012-09-25,4,1,9,11,63,155,218,265.6666666666667
15079,2012-09-25,4,1,9,12,69,233,302,230.0
15080,2012-09-25,4,1,9,13,48,257,305,275.0
15081,2012-09-25,4,1,9,14,80,213,293,300.0
15082,2012-09-25,4,1,9,15,56,247,303,300.3333333333333
15083,2012-09-25,4,1,9,16,59,436,495,363.6666666666667
15084,2012-09-25,4,1,9,17,107,860,967,588.3333333333334
15085,2012-09-25,4,1,9,18,64,758,822,761.3333333333334
15086,2012-09-25,4,1,9,19,49,490,539,776.0
15087,2012-09-25,4,1,9,20,37,388,425,595.3333333333334
15088,2012-09-25,4,1,9,21,34,263,297,420.3333333333333
15089,2012-09-25,4,1,9,22,14,174,188,303.3333333333333
15090,2012-09-25,4,1,9,23,9,89,98,194.33333333333334
15091,2012-09-26,4,1,9,0,6,34,40,108.66666666666667
15092,2012-09-26,4,1,9,1,10,19,29,55.666666666666664
15093,2012-09-26,4,1,9,2,2,15,17,28.666666666666668
15094,2012-09-26,4,1,9,3,4,6,10,18.666666666666668
15095,2012-09-26,4,1,9,4,2,12,14,13.666666666666666
15096,2012-09-26,4,1,9,5,1,35,36,20.0
15097,2012-09-26,4,1,9,6,3,179,182,77.33333333333333
15098,2012-09-26,4,1,9,7,9,523,532,250.0
15099,2012-09-26,4,1,9,8,30,808,838,517.3333333333334
15100,2012-09-26,4,1,9,9,27,307,334,568.0
15101,2012-09-26,4,1,9,10,29,156,185,452.3333333333333
15102,2012-09-26,4,1,9,11,46,181,227,248.66666666666666
15103,2012-09-26,4,1,9,12,56,260,316,242.66666666666666
15104,2012-09-26,4,1,9,13,67,273,340,294.3333333333333
15105,2012-09-26,4,1,9,14,60,217,277,311.0
15106,2012-09-26,4,1,9,15,69,231,300,305.6666666666667
15107,2012-09-26,4,1,9,16,71,397,468,348.3333333333333
15108,2012-09-26,4,1,9,17,77,876,953,573.6666666666666
15109,2012-09-26,4,1,9,18,69,815,884,768.3333333333334
15110,2012-09-26,4,1,9,19,38,589,627,821.3333333333334
15111,2012-09-26,4,1,9,20,45,389,434,648.3333333333334
15112,2012-09-26,4,1,9,21,32,328,360,473.6666666666667
15113,2012-09-26,4,1,9,22,21,194,215,336.3333333333333
15114,2012-09-26,4,1,9,23,13,102,115,230.0
15115,2012-09-27,4,1,9,0,5,60,65,131.66666666666666
15116,2012-09-27,4,1,9,1,5,16,21,67.0
15117,2012-09-27,4,1,9,2,3,13,16,34.0
15118,2012-09-27,4,1,9,3,0,7,7,14.666666666666666
15119,2012-09-27,4,1,9,4,2,6,8,10.333333333333334
15120,2012-09-27,4,1,9,5,2,64,66,27.0
15121,2012-09-27,4,1,9,6,5,164,169,81.0
15122,2012-09-27,4,1,9,7,12,546,558,264.3333333333333
15123,2012-09-27,4,1,9,8,20,774,794,507.0
15124,2012-09-27,4,1,9,9,30,305,335,562.3333333333334
15125,2012-09-27,4,1,9,10,40,168,208,445.6666666666667
15126,2012-09-27,4,1,9,11,67,227,294,279.0
15127,2012-09-27,4,1,9,12,63,272,335,279.0
15128,2012-09-27,4,1,9,13,61,265,326,318.3333333333333
15129,2012-09-27,4,1,9,14,44,214,258,306.3333333333333
15130,2012-09-27,4,1,9,15,41,255,296,293.3333333333333
15131,2012-09-27,4,1,9,16,73,399,472,342.0
15132,2012-09-27,4,1,9,17,87,818,905,557.6666666666666
15133,2012-09-27,4,1,9,18,77,822,899,758.6666666666666
15134,2012-09-27,4,1,9,19,48,511,559,787.6666666666666
15135,2012-09-27,4,1,9,20,45,412,457,638.3333333333334
15136,2012-09-27,4,1,9,21,18,235,253,423.0
15137,2012-09-27,4,1,9,22,2,45,47,252.33333333333334
15138,2012-09-27,4,1,9,23,1,44,45,115.0
15139,2012-09-28,4,1,9,0,2,15,17,36.333333333333336
15140,2012-09-28,4,1,9,1,0,13,13,25.0
15141,2012-09-28,4,1,9,2,1,9,10,13.333333333333334
15142,2012-09-28,4,1,9,3,0,7,7,10.0
15143,2012-09-28,4,1,9,4,2,10,12,9.666666666666666
15144,2012-09-28,4,1,9,5,1,37,38,19.0
15145,2012-09-28,4,1,9,6,2,136,138,62.666666666666664
15146,2012-09-28,4,1,9,7,10,384,394,190.0
15147,2012-09-28,4,1,9,8,31,674,705,412.3333333333333
15148,2012-09-28,4,1,9,9,27,399,426,508.3333333333333
15149,2012-09-28,4,1,9,10,51,194,245,458.6666666666667
15150,2012-09-28,4,1,9,11,109,252,361,344.0
15151,2012-09-28,4,1,9,12,94,286,380,328.6666666666667
15152,2012-09-28,4,1,9,13,106,304,410,383.6666666666667
15153,2012-09-28,4,1,9,14,105,294,399,396.3333333333333
15154,2012-09-28,4,1,9,15,104,288,392,400.3333333333333
15155,2012-09-28,4,1,9,16,83,419,502,431.0
15156,2012-09-28,4,1,9,17,101,707,808,567.3333333333334
15157,2012-09-28,4,1,9,18,58,609,667,659.0
15158,2012-09-28,4,1,9,19,38,470,508,661.0
15159,2012-09-28,4,1,9,20,32,304,336,503.6666666666667
15160,2012-09-28,4,1,9,21,32,205,237,360.3333333333333
15161,2012-09-28,4,1,9,22,30,190,220,264.3333333333333
15162,2012-09-28,4,1,9,23,26,164,190,215.66666666666666
15163,2012-09-29,4,1,9,0,15,134,149,186.33333333333334
15164,2012-09-29,4,1,9,1,12,89,101,146.66666666666666
15165,2012-09-29,4,1,9,2,12,80,92,114.0
15166,2012-09-29,4,1,9,3,4,25,29,74.0
15167,2012-09-29,4,1,9,4,6,8,14,45.0
15168,2012-09-29,4,1,9,5,2,13,15,19.333333333333332
15169,2012-09-29,4,1,9,6,4,33,37,22.0
15170,2012-09-29,4,1,9,7,12,61,73,41.666666666666664
15171,2012-09-29,4,1,9,8,37,174,211,107.0
15172,2012-09-29,4,1,9,9,69,263,332,205.33333333333334
15173,2012-09-29,4,1,9,10,134,338,472,338.3333333333333
15174,2012-09-29,4,1,9,11,217,446,663,489.0
15175,2012-09-29,4,1,9,12,191,491,682,605.6666666666666
15176,2012-09-29,4,1,9,13,233,453,686,677.0
15177,2012-09-29,4,1,9,14,302,448,750,706.0
15178,2012-09-29,4,1,9,15,271,456,727,721.0
15179,2012-09-29,4,1,9,16,275,447,722,733.0
15180,2012-09-29,4,1,9,17,256,456,712,720.3333333333334
15181,2012-09-29,4,1,9,18,174,420,594,676.0
15182,2012-09-29,4,1,9,19,119,351,470,592.0
15183,2012-09-29,4,1,9,20,88,227,315,459.6666666666667
15184,2012-09-29,4,1,9,21,73,219,292,359.0
15185,2012-09-29,4,1,9,22,48,173,221,276.0
15186,2012-09-29,4,1,9,23,35,161,196,236.33333333333334
15187,2012-09-30,4,1,9,0,35,112,147,188.0
15188,2012-09-30,4,1,9,1,31,85,116,153.0
15189,2012-09-30,4,1,9,2,21,71,92,118.33333333333333
15190,2012-09-30,4,1,9,3,17,41,58,88.66666666666667
15191,2012-09-30,4,1,9,4,1,6,7,52.333333333333336
15192,2012-09-30,4,1,9,5,1,9,10,25.0
15193,2012-09-30,4,1,9,6,2,20,22,13.0
15194,2012-09-30,4,1,9,7,14,43,57,29.666666666666668
15195,2012-09-30,4,1,9,8,18,126,144,74.33333333333333
15196,2012-09-30,4,1,9,9,74,211,285,162.0
15197,2012-09-30,4,1,9,10,160,319,479,302.6666666666667
15198,2012-09-30,4,1,9,11,222,369,591,451.6666666666667
15199,2012-09-30,4,1,9,12,206,474,680,583.3333333333334
15200,2012-09-30,4,1,9,13,180,414,594,621.6666666666666
15201,2012-09-30,4,1,9,14,208,404,612,628.6666666666666
15202,2012-09-30,4,1,9,15,230,419,649,618.3333333333334
15203,2012-09-30,4,1,9,16,202,446,648,636.3333333333334
15204,2012-09-30,4,1,9,17,195,380,575,624.0
15205,2012-09-30,4,1,9,18,91,310,401,541.3333333333334
15206,2012-09-30,4,1,9,19,34,223,257,411.0
15207,2012-09-30,4,1,9,20,31,163,194,284.0
15208,2012-09-30,4,1,9,21,19,104,123,191.33333333333334
15209,2012-09-30,4,1,9,22,15,76,91,136.0
15210,2012-09-30,4,1,9,23,8,49,57,90.33333333333333
15211,2012-10-01,4,1,10,0,6,39,45,64.33333333333333
15212,2012-10-01,4,1,10,1,5,13,18,40.0
15213,2012-10-01,4,1,10,2,6,6,12,25.0
15214,2012-10-01,4,1,10,3,1,6,7,12.333333333333334
15215,2012-10-01,4,1,10,4,0,10,10,9.666666666666666
15216,2012-10-01,4,1,10,5,2,34,36,17.666666666666668
15217,2012-10-01,4,1,10,6,8,147,155,67.0
15218,2012-10-01,4,1,10,7,13,470,483,224.66666666666666
15219,2012-10-01,4,1,10,8,40,744,784,474.0
15220,2012-10-01,4,1,10,9,26,314,340,535.6666666666666
15221,2012-10-01,4,1,10,10,44,135,179,434.3333333333333
15222,2012-10-01,4,1,10,11,76,196,272,263.6666666666667
15223,2012-10-01,4,1,10,12,61,262,323,258.0
15224,2012-10-01,4,1,10,13,80,225,305,300.0
15225,2012-10-01,4,1,10,14,51,193,244,290.6666666666667
15226,2012-10-01,4,1,10,15,95,234,329,292.6666666666667
15227,2012-10-01,4,1,10,16,51,408,459,344.0
15228,2012-10-01,4,1,10,17,65,791,856,548.0
15229,2012-10-01,4,1,10,18,42,571,613,642.6666666666666
15230,2012-10-01,4,1,10,19,33,483,516,661.6666666666666
15231,2012-10-01,4,1,10,20,11,251,262,463.6666666666667
15232,2012-10-01,4,1,10,21,13,205,218,332.0
15233,2012-10-01,4,1,10,22,17,190,207,229.0
15234,2012-10-01,4,1,10,23,17,88,105,176.66666666666666
15235,2012-10-02,4,1,10,0,1,30,31,114.33333333333333
15236,2012-10-02,4,1,10,1,0,11,11,49.0
15237,2012-10-02,4,1,10,2,0,2,2,14.666666666666666
15238,2012-10-02,4,1,10,3,1,4,5,6.0
15239,2012-10-02,4,1,10,4,2,8,10,5.666666666666667
15240,2012-10-02,4,1,10,5,1,42,43,19.333333333333332
15241,2012-10-02,4,1,10,6,3,176,179,77.33333333333333
15242,2012-10-02,4,1,10,7,4,256,260,160.66666666666666
15243,2012-10-02,4,1,10,8,6,128,134,191.0
15244,2012-10-02,4,1,10,9,3,83,86,160.0
15245,2012-10-02,4,1,10,10,3,42,45,88.33333333333333
15246,2012-10-02,4,1,10,11,7,92,99,76.66666666666667
15247,2012-10-02,4,1,10,12,6,98,104,82.66666666666667
15248,2012-10-02,4,1,10,13,6,148,154,119.0
15249,2012-10-02,4,1,10,14,16,147,163,140.33333333333334
15250,2012-10-02,4,1,10,15,14,195,209,175.33333333333334
15251,2012-10-02,4,1,10,16,46,328,374,248.66666666666666
15252,2012-10-02,4,1,10,17,38,677,715,432.6666666666667
15253,2012-10-02,4,1,10,18,48,639,687,592.0
15254,2012-10-02,4,1,10,19,27,368,395,599.0
15255,2012-10-02,4,1,10,20,20,286,306,462.6666666666667
15256,2012-10-02,4,1,10,21,24,265,289,330.0
15257,2012-10-02,4,1,10,22,28,212,240,278.3333333333333
15258,2012-10-02,4,1,10,23,11,87,98,209.0
15259,2012-10-03,4,1,10,0,5,47,52,130.0
15260,2012-10-03,4,1,10,1,3,16,19,56.333333333333336
15261,2012-10-03,4,1,10,2,2,7,9,26.666666666666668
15262,2012-10-03,4,1,10,3,0,7,7,11.666666666666666
15263,2012-10-03,4,1,10,4,2,9,11,9.0
15264,2012-10-03,4,1,10,5,2,32,34,17.333333333333332
15265,2012-10-03,4,1,10,6,4,173,177,74.0
15266,2012-10-03,4,1,10,7,11,504,515,242.0
15267,2012-10-03,4,1,10,8,28,781,809,500.3333333333333
15268,2012-10-03,4,1,10,9,30,332,362,562.0
15269,2012-10-03,4,1,10,10,29,146,175,448.6666666666667
15270,2012-10-03,4,1,10,11,52,178,230,255.66666666666666
15271,2012-10-03,4,1,10,12,69,289,358,254.33333333333334
15272,2012-10-03,4,1,10,13,55,224,279,289.0
15273,2012-10-03,4,1,10,14,56,195,251,296.0
15274,2012-10-03,4,1,10,15,59,260,319,283.0
15275,2012-10-03,4,1,10,16,42,436,478,349.3333333333333
15276,2012-10-03,4,1,10,17,84,833,917,571.3333333333334
15277,2012-10-03,4,1,10,18,54,756,810,735.0
15278,2012-10-03,4,1,10,19,49,544,593,773.3333333333334
15279,2012-10-03,4,1,10,20,48,449,497,633.3333333333334
15280,2012-10-03,4,1,10,21,14,195,209,433.0
15281,2012-10-03,4,1,10,22,9,232,241,315.6666666666667
15282,2012-10-03,4,1,10,23,21,199,220,223.33333333333334
15283,2012-10-04,4,1,10,0,11,65,76,179.0
15284,2012-10-04,4,1,10,1,2,23,25,107.0
15285,2012-10-04,4,1,10,2,3,10,13,38.0
15286,2012-10-04,4,1,10,3,5,6,11,16.333333333333332
15287,2012-10-04,4,1,10,4,0,10,10,11.333333333333334
15288,2012-10-04,4,1,10,5,2,37,39,20.0
15289,2012-10-04,4,1,10,6,1,132,133,60.666666666666664
15290,2012-10-04,4,1,10,7,12,379,391,187.66666666666666
15291,2012-10-04,4,1,10,8,27,711,738,420.6666666666667
15292,2012-10-04,4,1,10,9,40,319,359,496.0
15293,2012-10-04,4,1,10,10,27,150,177,424.6666666666667
15294,2012-10-04,4,1,10,11,38,176,214,250.0
15295,2012-10-04,4,1,10,12,57,231,288,226.33333333333334
15296,2012-10-04,4,1,10,13,63,231,294,265.3333333333333
15297,2012-10-04,4,1,10,14,56,211,267,283.0
15298,2012-10-04,4,1,10,15,77,248,325,295.3333333333333
15299,2012-10-04,4,1,10,16,86,411,497,363.0
15300,2012-10-04,4,1,10,17,112,789,901,574.3333333333334
15301,2012-10-04,4,1,10,18,75,812,887,761.6666666666666
15302,2012-10-04,4,1,10,19,67,467,534,774.0
15303,2012-10-04,4,1,10,20,50,391,441,620.6666666666666
15304,2012-10-04,4,1,10,21,33,288,321,432.0
15305,2012-10-04,4,1,10,22,29,203,232,331.3333333333333
15306,2012-10-04,4,1,10,23,18,137,155,236.0
15307,2012-10-05,4,1,10,0,16,86,102,163.0
15308,2012-10-05,4,1,10,1,3,43,46,101.0
15309,2012-10-05,4,1,10,2,1,10,11,53.0
15310,2012-10-05,4,1,10,3,5,11,16,24.333333333333332
15311,2012-10-05,4,1,10,4,0,11,11,12.666666666666666
15312,2012-10-05,4,1,10,5,0,41,41,22.666666666666668
15313,2012-10-05,4,1,10,6,4,133,137,63.0
15314,2012-10-05,4,1,10,7,11,417,428,202.0
15315,2012-10-05,4,1,10,8,36,749,785,450.0
15316,2012-10-05,4,1,10,9,58,326,384,532.3333333333334
15317,2012-10-05,4,1,10,10,68,192,260,476.3333333333333
15318,2012-10-05,4,1,10,11,90,214,304,316.0
15319,2012-10-05,4,1,10,12,161,307,468,344.0
15320,2012-10-05,4,1,10,13,117,307,424,398.6666666666667
15321,2012-10-05,4,1,10,14,113,287,400,430.6666666666667
15322,2012-10-05,4,1,10,15,150,320,470,431.3333333333333
15323,2012-10-05,4,1,10,16,153,481,634,501.3333333333333
15324,2012-10-05,4,1,10,17,158,742,900,668.0
15325,2012-10-05,4,1,10,18,106,655,761,765.0
15326,2012-10-05,4,1,10,19,67,433,500,720.3333333333334
15327,2012-10-05,4,1,10,20,66,306,372,544.3333333333334
15328,2012-10-05,4,1,10,21,47,220,267,379.6666666666667
15329,2012-10-05,4,1,10,22,63,201,264,301.0
15330,2012-10-05,4,1,10,23,23,148,171,234.0
15331,2012-10-06,4,1,10,0,37,154,191,208.66666666666666
15332,2012-10-06,4,1,10,1,25,116,141,167.66666666666666
15333,2012-10-06,4,1,10,2,13,62,75,135.66666666666666
15334,2012-10-06,4,1,10,3,2,54,56,90.66666666666667
15335,2012-10-06,4,1,10,4,4,7,11,47.333333333333336
15336,2012-10-06,4,1,10,5,2,8,10,25.666666666666668
15337,2012-10-06,4,1,10,6,2,28,30,17.0
15338,2012-10-06,4,1,10,7,13,71,84,41.333333333333336
15339,2012-10-06,4,1,10,8,22,184,206,106.66666666666667
15340,2012-10-06,4,1,10,9,130,265,395,228.33333333333334
15341,2012-10-06,4,1,10,10,198,341,539,380.0
15342,2012-10-06,4,1,10,11,258,389,647,527.0
15343,2012-10-06,4,1,10,12,362,381,743,643.0
15344,2012-10-06,4,1,10,13,310,400,710,700.0
15345,2012-10-06,4,1,10,14,269,307,576,676.3333333333334
15346,2012-10-06,4,1,10,15,279,341,620,635.3333333333334
15347,2012-10-06,4,1,10,16,317,342,659,618.3333333333334
15348,2012-10-06,4,1,10,17,268,342,610,629.6666666666666
15349,2012-10-06,4,1,10,18,183,312,495,588.0
15350,2012-10-06,4,1,10,19,102,239,341,482.0
15351,2012-10-06,4,1,10,20,75,172,247,361.0
15352,2012-10-06,4,1,10,21,78,137,215,267.6666666666667
15353,2012-10-06,4,1,10,22,45,140,185,215.66666666666666
15354,2012-10-06,4,1,10,23,37,142,179,193.0
15355,2012-10-07,4,1,10,0,28,99,127,163.66666666666666
15356,2012-10-07,4,1,10,1,29,80,109,138.33333333333334
15357,2012-10-07,4,1,10,2,10,64,74,103.33333333333333
15358,2012-10-07,4,1,10,3,5,17,22,68.33333333333333
15359,2012-10-07,4,1,10,4,5,6,11,35.666666666666664
15360,2012-10-07,4,1,10,5,2,8,10,14.333333333333334
15361,2012-10-07,4,1,10,6,4,19,23,14.666666666666666
15362,2012-10-07,4,1,10,7,6,29,35,22.666666666666668
15363,2012-10-07,4,1,10,8,11,51,62,40.0
15364,2012-10-07,4,1,10,9,16,70,86,61.0
15365,2012-10-07,4,1,10,10,41,144,185,111.0
15366,2012-10-07,4,1,10,11,76,260,336,202.33333333333334
15367,2012-10-07,4,1,10,12,100,292,392,304.3333333333333
15368,2012-10-07,4,1,10,13,80,240,320,349.3333333333333
15369,2012-10-07,4,1,10,14,71,243,314,342.0
15370,2012-10-07,4,1,10,15,74,232,306,313.3333333333333
15371,2012-10-07,4,1,10,16,87,246,333,317.6666666666667
15372,2012-10-07,4,1,10,17,35,122,157,265.3333333333333
15373,2012-10-07,4,1,10,18,24,82,106,198.66666666666666
15374,2012-10-07,4,1,10,19,17,97,114,125.66666666666667
15375,2012-10-07,4,1,10,20,19,97,116,112.0
15376,2012-10-07,4,1,10,21,22,91,113,114.33333333333333
15377,2012-10-07,4,1,10,22,7,72,79,102.66666666666667
15378,2012-10-07,4,1,10,23,12,68,80,90.66666666666667
15379,2012-10-08,4,1,10,0,7,44,51,70.0
15380,2012-10-08,4,1,10,1,2,35,37,56.0
15381,2012-10-08,4,1,10,2,3,12,15,34.333333333333336
15382,2012-10-08,4,1,10,3,2,8,10,20.666666666666668
15383,2012-10-08,4,1,10,4,1,6,7,10.666666666666666
15384,2012-10-08,4,1,10,5,2,17,19,12.0
15385,2012-10-08,4,1,10,6,5,54,59,28.333333333333332
15386,2012-10-08,4,1,10,7,3,151,154,77.33333333333333
15387,2012-10-08,4,1,10,8,23,374,397,203.33333333333334
15388,2012-10-08,4,1,10,9,59,273,332,294.3333333333333
15389,2012-10-08,4,1,10,10,69,229,298,342.3333333333333
15390,2012-10-08,4,1,10,11,72,236,308,312.6666666666667
15391,2012-10-08,4,1,10,12,74,267,341,315.6666666666667
15392,2012-10-08,4,1,10,13,82,323,405,351.3333333333333
15393,2012-10-08,4,1,10,14,121,299,420,388.6666666666667
15394,2012-10-08,4,1,10,15,76,294,370,398.3333333333333
15395,2012-10-08,4,1,10,16,61,316,377,389.0
15396,2012-10-08,4,1,10,17,81,416,497,414.6666666666667
15397,2012-10-08,4,1,10,18,41,415,456,443.3333333333333
15398,2012-10-08,4,1,10,19,38,333,371,441.3333333333333
15399,2012-10-08,4,1,10,20,20,207,227,351.3333333333333
15400,2012-10-08,4,1,10,21,17,134,151,249.66666666666666
15401,2012-10-08,4,1,10,22,6,101,107,161.66666666666666
15402,2012-10-08,4,1,10,23,9,60,69,109.0
15403,2012-10-09,4,1,10,0,9,22,31,69.0
15404,2012-10-09,4,1,10,1,0,13,13,37.666666666666664
15405,2012-10-09,4,1,10,2,2,5,7,17.0
15406,2012-10-09,4,1,10,3,0,3,3,7.666666666666667
15407,2012-10-09,4,1,10,4,1,6,7,5.666666666666667
15408,2012-10-09,4,1,10,5,0,19,19,9.666666666666666
15409,2012-10-09,4,1,10,6,2,141,143,56.333333333333336
15410,2012-10-09,4,1,10,7,5,357,362,174.66666666666666
15411,2012-10-09,4,1,10,8,15,698,713,406.0
15412,2012-10-09,4,1,10,9,37,345,382,485.6666666666667
15413,2012-10-09,4,1,10,10,33,131,164,419.6666666666667
15414,2012-10-09,4,1,10,11,37,156,193,246.33333333333334
15415,2012-10-09,4,1,10,12,43,217,260,205.66666666666666
15416,2012-10-09,4,1,10,13,54,184,238,230.33333333333334
15417,2012-10-09,4,1,10,14,43,201,244,247.33333333333334
15418,2012-10-09,4,1,10,15,59,195,254,245.33333333333334
15419,2012-10-09,4,1,10,16,70,354,424,307.3333333333333
15420,2012-10-09,4,1,10,17,73,733,806,494.6666666666667
15421,2012-10-09,4,1,10,18,26,758,784,671.3333333333334
15422,2012-10-09,4,1,10,19,31,483,514,701.3333333333334
15423,2012-10-09,4,1,10,20,30,330,360,552.6666666666666
15424,2012-10-09,4,1,10,21,16,209,225,366.3333333333333
15425,2012-10-09,4,1,10,22,7,155,162,249.0
15426,2012-10-09,4,1,10,23,8,76,84,157.0
15427,2012-10-10,4,1,10,0,0,33,33,93.0
15428,2012-10-10,4,1,10,1,2,6,8,41.666666666666664
15429,2012-10-10,4,1,10,2,2,6,8,16.333333333333332
15430,2012-10-10,4,1,10,3,0,6,6,7.333333333333333
15431,2012-10-10,4,1,10,4,0,6,6,6.666666666666667
15432,2012-10-10,4,1,10,5,2,38,40,17.333333333333332
15433,2012-10-10,4,1,10,6,3,172,175,73.66666666666667
15434,2012-10-10,4,1,10,7,9,498,507,240.66666666666666
15435,2012-10-10,4,1,10,8,33,806,839,507.0
15436,2012-10-10,4,1,10,9,35,331,366,570.6666666666666
15437,2012-10-10,4,1,10,10,27,190,217,474.0
15438,2012-10-10,4,1,10,11,53,238,291,291.3333333333333
15439,2012-10-10,4,1,10,12,78,312,390,299.3333333333333
15440,2012-10-10,4,1,10,13,60,237,297,326.0
15441,2012-10-10,4,1,10,14,63,208,271,319.3333333333333
15442,2012-10-10,4,1,10,15,58,261,319,295.6666666666667
15443,2012-10-10,4,1,10,16,92,474,566,385.3333333333333
15444,2012-10-10,4,1,10,17,91,857,948,611.0
15445,2012-10-10,4,1,10,18,57,787,844,786.0
15446,2012-10-10,4,1,10,19,32,534,566,786.0
15447,2012-10-10,4,1,10,20,21,371,392,600.6666666666666
15448,2012-10-10,4,1,10,21,18,251,269,409.0
15449,2012-10-10,4,1,10,22,27,170,197,286.0
15450,2012-10-10,4,1,10,23,17,119,136,200.66666666666666
15451,2012-10-11,4,1,10,0,1,41,42,125.0
15452,2012-10-11,4,1,10,1,1,10,11,63.0
15453,2012-10-11,4,1,10,2,4,7,11,21.333333333333332
15454,2012-10-11,4,1,10,3,0,3,3,8.333333333333334
15455,2012-10-11,4,1,10,4,0,10,10,8.0
15456,2012-10-11,4,1,10,5,0,42,42,18.333333333333332
15457,2012-10-11,4,1,10,6,1,158,159,70.33333333333333
15458,2012-10-11,4,1,10,7,11,467,478,226.33333333333334
15459,2012-10-11,4,1,10,8,25,773,798,478.3333333333333
15460,2012-10-11,4,1,10,9,27,328,355,543.6666666666666
15461,2012-10-11,4,1,10,10,39,165,204,452.3333333333333
15462,2012-10-11,4,1,10,11,76,175,251,270.0
15463,2012-10-11,4,1,10,12,47,279,326,260.3333333333333
15464,2012-10-11,4,1,10,13,48,243,291,289.3333333333333
15465,2012-10-11,4,1,10,14,78,270,348,321.6666666666667
15466,2012-10-11,4,1,10,15,102,358,460,366.3333333333333
15467,2012-10-11,4,1,10,16,68,413,481,429.6666666666667
15468,2012-10-11,4,1,10,17,90,737,827,589.3333333333334
15469,2012-10-11,4,1,10,18,64,628,692,666.6666666666666
15470,2012-10-11,4,1,10,19,81,662,743,754.0
15471,2012-10-11,4,1,10,20,27,388,415,616.6666666666666
15472,2012-10-11,4,1,10,21,24,236,260,472.6666666666667
15473,2012-10-11,4,1,10,22,10,167,177,284.0
15474,2012-10-11,4,1,10,23,10,176,186,207.66666666666666
15475,2012-10-12,4,1,10,0,8,60,68,143.66666666666666
15476,2012-10-12,4,1,10,1,8,29,37,97.0
15477,2012-10-12,4,1,10,2,0,16,16,40.333333333333336
15478,2012-10-12,4,1,10,3,0,6,6,19.666666666666668
15479,2012-10-12,4,1,10,4,0,8,8,10.0
15480,2012-10-12,4,1,10,5,2,33,35,16.333333333333332
15481,2012-10-12,4,1,10,6,3,140,143,62.0
15482,2012-10-12,4,1,10,7,8,384,392,190.0
15483,2012-10-12,4,1,10,8,34,711,745,426.6666666666667
15484,2012-10-12,4,1,10,9,26,374,400,512.3333333333334
15485,2012-10-12,4,1,10,10,75,200,275,473.3333333333333
15486,2012-10-12,4,1,10,11,61,252,313,329.3333333333333
15487,2012-10-12,4,1,10,12,75,312,387,325.0
15488,2012-10-12,4,1,10,13,81,300,381,360.3333333333333
15489,2012-10-12,4,1,10,14,109,262,371,379.6666666666667
15490,2012-10-12,4,1,10,15,138,317,455,402.3333333333333
15491,2012-10-12,4,1,10,16,108,412,520,448.6666666666667
15492,2012-10-12,4,1,10,17,131,706,837,604.0
15493,2012-10-12,4,1,10,18,76,566,642,666.3333333333334
15494,2012-10-12,4,1,10,19,40,453,493,657.3333333333334
15495,2012-10-12,4,1,10,20,28,280,308,481.0
15496,2012-10-12,4,1,10,21,21,169,190,330.3333333333333
15497,2012-10-12,4,1,10,22,17,143,160,219.33333333333334
15498,2012-10-12,4,1,10,23,11,89,100,150.0
15499,2012-10-13,4,1,10,0,31,218,249,169.66666666666666
15500,2012-10-13,4,1,10,1,23,123,146,165.0
15501,2012-10-13,4,1,10,2,7,60,67,154.0
15502,2012-10-13,4,1,10,3,2,13,15,76.0
15503,2012-10-13,4,1,10,4,2,9,11,31.0
15504,2012-10-13,4,1,10,5,0,11,11,12.333333333333334
15505,2012-10-13,4,1,10,6,5,23,28,16.666666666666668
15506,2012-10-13,4,1,10,7,10,60,70,36.333333333333336
15507,2012-10-13,4,1,10,8,23,151,174,90.66666666666667
15508,2012-10-13,4,1,10,9,46,220,266,170.0
15509,2012-10-13,4,1,10,10,82,265,347,262.3333333333333
15510,2012-10-13,4,1,10,11,192,335,527,380.0
15511,2012-10-13,4,1,10,12,202,371,573,482.3333333333333
15512,2012-10-13,4,1,10,13,235,435,670,590.0
15513,2012-10-13,4,1,10,14,243,354,597,613.3333333333334
15514,2012-10-13,4,1,10,15,251,364,615,627.3333333333334
15515,2012-10-13,4,1,10,16,294,343,637,616.3333333333334
15516,2012-10-13,4,1,10,17,193,335,528,593.3333333333334
15517,2012-10-13,4,1,10,18,174,299,473,546.0
15518,2012-10-13,4,1,10,19,73,259,332,444.3333333333333
15519,2012-10-13,4,1,10,20,57,198,255,353.3333333333333
15520,2012-10-13,4,1,10,21,47,157,204,263.6666666666667
15521,2012-10-13,4,1,10,22,33,156,189,216.0
15522,2012-10-13,4,1,10,23,27,98,125,172.66666666666666
15523,2012-10-14,4,1,10,0,8,103,111,141.66666666666666
15524,2012-10-14,4,1,10,1,16,96,112,116.0
15525,2012-10-14,4,1,10,2,8,58,66,96.33333333333333
15526,2012-10-14,4,1,10,3,3,25,28,68.66666666666667
15527,2012-10-14,4,1,10,4,2,10,12,35.333333333333336
15528,2012-10-14,4,1,10,5,5,6,11,17.0
15529,2012-10-14,4,1,10,6,4,20,24,15.666666666666666
15530,2012-10-14,4,1,10,7,7,44,51,28.666666666666668
15531,2012-10-14,4,1,10,8,28,104,132,69.0
15532,2012-10-14,4,1,10,9,62,161,223,135.33333333333334
15533,2012-10-14,4,1,10,10,150,278,428,261.0
15534,2012-10-14,4,1,10,11,156,338,494,381.6666666666667
15535,2012-10-14,4,1,10,12,200,362,562,494.6666666666667
15536,2012-10-14,4,1,10,13,218,401,619,558.3333333333334
15537,2012-10-14,4,1,10,14,249,368,617,599.3333333333334
15538,2012-10-14,4,1,10,15,213,355,568,601.3333333333334
15539,2012-10-14,4,1,10,16,203,378,581,588.6666666666666
15540,2012-10-14,4,1,10,17,193,346,539,562.6666666666666
15541,2012-10-14,4,1,10,18,134,319,453,524.3333333333334
15542,2012-10-14,4,1,10,19,68,268,336,442.6666666666667
15543,2012-10-14,4,1,10,20,48,198,246,345.0
15544,2012-10-14,4,1,10,21,40,156,196,259.3333333333333
15545,2012-10-14,4,1,10,22,38,87,125,189.0
15546,2012-10-14,4,1,10,23,27,78,105,142.0
15547,2012-10-15,4,1,10,0,17,31,48,92.66666666666667
15548,2012-10-15,4,1,10,1,5,24,29,60.666666666666664
15549,2012-10-15,4,1,10,2,1,5,6,27.666666666666668
15550,2012-10-15,4,1,10,3,2,2,4,13.0
15551,2012-10-15,4,1,10,4,1,9,10,6.666666666666667
15552,2012-10-15,4,1,10,5,2,38,40,18.0
15553,2012-10-15,4,1,10,6,6,141,147,65.66666666666667
15554,2012-10-15,4,1,10,7,15,461,476,221.0
15555,2012-10-15,4,1,10,8,24,713,737,453.3333333333333
15556,2012-10-15,4,1,10,9,31,328,359,524.0
15557,2012-10-15,4,1,10,10,43,125,168,421.3333333333333
15558,2012-10-15,4,1,10,11,88,175,263,263.3333333333333
15559,2012-10-15,4,1,10,12,73,211,284,238.33333333333334
15560,2012-10-15,4,1,10,13,37,109,146,231.0
15561,2012-10-15,4,1,10,14,57,128,185,205.0
15562,2012-10-15,4,1,10,15,70,190,260,197.0
15563,2012-10-15,4,1,10,16,76,371,447,297.3333333333333
15564,2012-10-15,4,1,10,17,96,670,766,491.0
15565,2012-10-15,4,1,10,18,52,540,592,601.6666666666666
15566,2012-10-15,4,1,10,19,12,227,239,532.3333333333334
15567,2012-10-15,4,1,10,20,19,237,256,362.3333333333333
15568,2012-10-15,4,1,10,21,16,190,206,233.66666666666666
15569,2012-10-15,4,1,10,22,8,118,126,196.0
15570,2012-10-15,4,1,10,23,9,72,81,137.66666666666666
15571,2012-10-16,4,1,10,0,3,45,48,85.0
15572,2012-10-16,4,1,10,1,4,9,13,47.333333333333336
15573,2012-10-16,4,1,10,2,2,1,3,21.333333333333332
15574,2012-10-16,4,1,10,3,0,2,2,6.0
15575,2012-10-16,4,1,10,4,0,7,7,4.0
15576,2012-10-16,4,1,10,5,5,47,52,20.333333333333332
15577,2012-10-16,4,1,10,6,4,168,172,77.0
15578,2012-10-16,4,1,10,7,20,505,525,249.66666666666666
15579,2012-10-16,4,1,10,8,35,800,835,510.6666666666667
15580,2012-10-16,4,1,10,9,32,323,355,571.6666666666666
15581,2012-10-16,4,1,10,10,65,157,222,470.6666666666667
15582,2012-10-16,4,1,10,11,56,172,228,268.3333333333333
15583,2012-10-16,4,1,10,12,69,256,325,258.3333333333333
15584,2012-10-16,4,1,10,13,68,260,328,293.6666666666667
15585,2012-10-16,4,1,10,14,94,214,308,320.3333333333333
15586,2012-10-16,4,1,10,15,76,270,346,327.3333333333333
15587,2012-10-16,4,1,10,16,79,367,446,366.6666666666667
15588,2012-10-16,4,1,10,17,104,839,943,578.3333333333334
15589,2012-10-16,4,1,10,18,71,767,838,742.3333333333334
15590,2012-10-16,4,1,10,19,40,491,531,770.6666666666666
15591,2012-10-16,4,1,10,20,35,397,432,600.3333333333334
15592,2012-10-16,4,1,10,21,19,176,195,386.0
15593,2012-10-16,4,1,10,22,18,163,181,269.3333333333333
15594,2012-10-16,4,1,10,23,23,176,199,191.66666666666666
15595,2012-10-17,4,1,10,0,1,48,49,143.0
15596,2012-10-17,4,1,10,1,3,14,17,88.33333333333333
15597,2012-10-17,4,1,10,2,4,12,16,27.333333333333332
15598,2012-10-17,4,1,10,3,0,7,7,13.333333333333334
15599,2012-10-17,4,1,10,4,0,4,4,9.0
15600,2012-10-17,4,1,10,5,2,39,41,17.333333333333332
15601,2012-10-17,4,1,10,6,7,171,178,74.33333333333333
15602,2012-10-17,4,1,10,7,15,449,464,227.66666666666666
15603,2012-10-17,4,1,10,8,38,779,817,486.3333333333333
15604,2012-10-17,4,1,10,9,38,344,382,554.3333333333334
15605,2012-10-17,4,1,10,10,60,168,228,475.6666666666667
15606,2012-10-17,4,1,10,11,78,156,234,281.3333333333333
15607,2012-10-17,4,1,10,12,71,261,332,264.6666666666667
15608,2012-10-17,4,1,10,13,73,237,310,292.0
15609,2012-10-17,4,1,10,14,82,188,270,304.0
15610,2012-10-17,4,1,10,15,62,239,301,293.6666666666667
15611,2012-10-17,4,1,10,16,70,396,466,345.6666666666667
15612,2012-10-17,4,1,10,17,122,766,888,551.6666666666666
15613,2012-10-17,4,1,10,18,90,794,884,746.0
15614,2012-10-17,4,1,10,19,49,467,516,762.6666666666666
15615,2012-10-17,4,1,10,20,54,360,414,604.6666666666666
15616,2012-10-17,4,1,10,21,28,301,329,419.6666666666667
15617,2012-10-17,4,1,10,22,17,198,215,319.3333333333333
15618,2012-10-17,4,1,10,23,15,84,99,214.33333333333334
15619,2012-10-18,4,1,10,0,4,53,57,123.66666666666667
15620,2012-10-18,4,1,10,1,0,14,14,56.666666666666664
15621,2012-10-18,4,1,10,2,1,13,14,28.333333333333332
15622,2012-10-18,4,1,10,3,0,5,5,11.0
15623,2012-10-18,4,1,10,4,0,5,5,8.0
15624,2012-10-18,4,1,10,5,1,41,42,17.333333333333332
15625,2012-10-18,4,1,10,6,3,150,153,66.66666666666667
15626,2012-10-18,4,1,10,7,20,488,508,234.33333333333334
15627,2012-10-18,4,1,10,8,31,803,834,498.3333333333333
15628,2012-10-18,4,1,10,9,41,346,387,576.3333333333334
15629,2012-10-18,4,1,10,10,60,158,218,479.6666666666667
15630,2012-10-18,4,1,10,11,79,189,268,291.0
15631,2012-10-18,4,1,10,12,93,284,377,287.6666666666667
15632,2012-10-18,4,1,10,13,96,236,332,325.6666666666667
15633,2012-10-18,4,1,10,14,94,191,285,331.3333333333333
15634,2012-10-18,4,1,10,15,69,284,353,323.3333333333333
15635,2012-10-18,4,1,10,16,94,356,450,362.6666666666667
15636,2012-10-18,4,1,10,17,102,788,890,564.3333333333334
15637,2012-10-18,4,1,10,18,68,720,788,709.3333333333334
15638,2012-10-18,4,1,10,19,42,471,513,730.3333333333334
15639,2012-10-18,4,1,10,20,39,348,387,562.6666666666666
15640,2012-10-18,4,1,10,21,38,245,283,394.3333333333333
15641,2012-10-18,4,1,10,22,27,202,229,299.6666666666667
15642,2012-10-18,4,1,10,23,6,111,117,209.66666666666666
15643,2012-10-19,4,1,10,0,5,51,56,134.0
15644,2012-10-19,4,1,10,1,4,12,16,63.0
15645,2012-10-19,4,1,10,2,1,9,10,27.333333333333332
15646,2012-10-19,4,1,10,3,0,5,5,10.333333333333334
15647,2012-10-19,4,1,10,4,1,5,6,7.0
15648,2012-10-19,4,1,10,5,1,35,36,15.666666666666666
15649,2012-10-19,4,1,10,6,5,126,131,57.666666666666664
15650,2012-10-19,4,1,10,7,5,149,154,107.0
15651,2012-10-19,4,1,10,8,20,447,467,250.66666666666666
15652,2012-10-19,4,1,10,9,26,363,389,336.6666666666667
15653,2012-10-19,4,1,10,10,26,198,224,360.0
15654,2012-10-19,4,1,10,11,41,211,252,288.3333333333333
15655,2012-10-19,4,1,10,12,74,258,332,269.3333333333333
15656,2012-10-19,4,1,10,13,87,288,375,319.6666666666667
15657,2012-10-19,4,1,10,14,88,277,365,357.3333333333333
15658,2012-10-19,4,1,10,15,93,302,395,378.3333333333333
15659,2012-10-19,4,1,10,16,131,434,565,441.6666666666667
15660,2012-10-19,4,1,10,17,48,377,425,461.6666666666667
15661,2012-10-19,4,1,10,18,21,212,233,407.6666666666667
15662,2012-10-19,4,1,10,19,19,213,232,296.6666666666667
15663,2012-10-19,4,1,10,20,13,216,229,231.33333333333334
15664,2012-10-19,4,1,10,21,17,189,206,222.33333333333334
15665,2012-10-19,4,1,10,22,14,176,190,208.33333333333334
15666,2012-10-19,4,1,10,23,13,118,131,175.66666666666666
15667,2012-10-20,4,1,10,0,13,110,123,148.0
15668,2012-10-20,4,1,10,1,2,93,95,116.33333333333333
15669,2012-10-20,4,1,10,2,9,69,78,98.66666666666667
15670,2012-10-20,4,1,10,3,2,27,29,67.33333333333333
15671,2012-10-20,4,1,10,4,9,9,18,41.666666666666664
15672,2012-10-20,4,1,10,5,6,7,13,20.0
15673,2012-10-20,4,1,10,6,5,26,31,20.666666666666668
15674,2012-10-20,4,1,10,7,6,59,65,36.333333333333336
15675,2012-10-20,4,1,10,8,29,164,193,96.33333333333333
15676,2012-10-20,4,1,10,9,106,257,363,207.0
15677,2012-10-20,4,1,10,10,111,312,423,326.3333333333333
15678,2012-10-20,4,1,10,11,204,408,612,466.0
15679,2012-10-20,4,1,10,12,267,436,703,579.3333333333334
15680,2012-10-20,4,1,10,13,273,441,714,676.3333333333334
15681,2012-10-20,4,1,10,14,335,376,711,709.3333333333334
15682,2012-10-20,4,1,10,15,308,403,711,712.0
15683,2012-10-20,4,1,10,16,325,366,691,704.3333333333334
15684,2012-10-20,4,1,10,17,347,384,731,711.0
15685,2012-10-20,4,1,10,18,165,356,521,647.6666666666666
15686,2012-10-20,4,1,10,19,77,268,345,532.3333333333334
15687,2012-10-20,4,1,10,20,61,198,259,375.0
15688,2012-10-20,4,1,10,21,72,224,296,300.0
15689,2012-10-20,4,1,10,22,47,155,202,252.33333333333334
15690,2012-10-20,4,1,10,23,27,136,163,220.33333333333334
15691,2012-10-21,4,1,10,0,35,119,154,173.0
15692,2012-10-21,4,1,10,1,20,97,117,144.66666666666666
15693,2012-10-21,4,1,10,2,44,88,132,134.33333333333334
15694,2012-10-21,4,1,10,3,12,29,41,96.66666666666667
15695,2012-10-21,4,1,10,4,8,13,21,64.66666666666667
15696,2012-10-21,4,1,10,5,6,4,10,24.0
15697,2012-10-21,4,1,10,6,8,18,26,19.0
15698,2012-10-21,4,1,10,7,13,43,56,30.666666666666668
15699,2012-10-21,4,1,10,8,39,104,143,75.0
15700,2012-10-21,4,1,10,9,77,192,269,156.0
15701,2012-10-21,4,1,10,10,167,276,443,285.0
15702,2012-10-21,4,1,10,11,191,356,547,419.6666666666667
15703,2012-10-21,4,1,10,12,236,439,675,555.0
15704,2012-10-21,4,1,10,13,243,383,626,616.0
15705,2012-10-21,4,1,10,14,235,405,640,647.0
15706,2012-10-21,4,1,10,15,240,383,623,629.6666666666666
15707,2012-10-21,4,1,10,16,182,409,591,618.0
15708,2012-10-21,4,1,10,17,153,338,491,568.3333333333334
15709,2012-10-21,4,1,10,18,71,342,413,498.3333333333333
15710,2012-10-21,4,1,10,19,50,216,266,390.0
15711,2012-10-21,4,1,10,20,35,160,195,291.3333333333333
15712,2012-10-21,4,1,10,21,42,124,166,209.0
15713,2012-10-21,4,1,10,22,18,95,113,158.0
15714,2012-10-21,4,1,10,23,7,59,66,115.0
15715,2012-10-22,4,1,10,0,3,28,31,70.0
15716,2012-10-22,4,1,10,1,0,11,11,36.0
15717,2012-10-22,4,1,10,2,1,4,5,15.666666666666666
15718,2012-10-22,4,1,10,3,1,5,6,7.333333333333333
15719,2012-10-22,4,1,10,4,1,6,7,6.0
15720,2012-10-22,4,1,10,5,2,44,46,19.666666666666668
15721,2012-10-22,4,1,10,6,4,140,144,65.66666666666667
15722,2012-10-22,4,1,10,7,15,437,452,214.0
15723,2012-10-22,4,1,10,8,32,696,728,441.3333333333333
15724,2012-10-22,4,1,10,9,25,335,360,513.3333333333334
15725,2012-10-22,4,1,10,10,51,161,212,433.3333333333333
15726,2012-10-22,4,1,10,11,63,148,211,261.0
15727,2012-10-22,4,1,10,12,52,231,283,235.33333333333334
15728,2012-10-22,4,1,10,13,88,227,315,269.6666666666667
15729,2012-10-22,4,1,10,14,73,209,282,293.3333333333333
15730,2012-10-22,4,1,10,15,74,222,296,297.6666666666667
15731,2012-10-22,4,1,10,16,80,444,524,367.3333333333333
15732,2012-10-22,4,1,10,17,84,838,922,580.6666666666666
15733,2012-10-22,4,1,10,18,60,726,786,744.0
15734,2012-10-22,4,1,10,19,36,478,514,740.6666666666666
15735,2012-10-22,4,1,10,20,21,382,403,567.6666666666666
15736,2012-10-22,4,1,10,21,19,155,174,363.6666666666667
15737,2012-10-22,4,1,10,22,25,158,183,253.33333333333334
15738,2012-10-22,4,1,10,23,20,143,163,173.33333333333334
15739,2012-10-23,4,1,10,0,5,32,37,127.66666666666667
15740,2012-10-23,4,1,10,1,1,16,17,72.33333333333333
15741,2012-10-23,4,1,10,2,1,6,7,20.333333333333332
15742,2012-10-23,4,1,10,3,0,1,1,8.333333333333334
15743,2012-10-23,4,1,10,4,1,6,7,5.0
15744,2012-10-23,4,1,10,5,1,49,50,19.333333333333332
15745,2012-10-23,4,1,10,6,6,152,158,71.66666666666667
15746,2012-10-23,4,1,10,7,12,519,531,246.33333333333334
15747,2012-10-23,4,1,10,8,28,733,761,483.3333333333333
15748,2012-10-23,4,1,10,9,29,305,334,542.0
15749,2012-10-23,4,1,10,10,50,171,221,438.6666666666667
15750,2012-10-23,4,1,10,11,52,201,253,269.3333333333333
15751,2012-10-23,4,1,10,12,80,298,378,284.0
15752,2012-10-23,4,1,10,13,59,244,303,311.3333333333333
15753,2012-10-23,4,1,10,14,67,229,296,325.6666666666667
15754,2012-10-23,4,1,10,15,76,270,346,315.0
15755,2012-10-23,4,1,10,16,108,433,541,394.3333333333333
15756,2012-10-23,4,1,10,17,67,871,938,608.3333333333334
15757,2012-10-23,4,1,10,18,64,762,826,768.3333333333334
15758,2012-10-23,4,1,10,19,25,457,482,748.6666666666666
15759,2012-10-23,4,1,10,20,45,334,379,562.3333333333334
15760,2012-10-23,4,1,10,21,35,260,295,385.3333333333333
15761,2012-10-23,4,1,10,22,20,174,194,289.3333333333333
15762,2012-10-23,4,1,10,23,9,102,111,200.0
15763,2012-10-24,4,1,10,0,7,39,46,117.0
15764,2012-10-24,4,1,10,1,4,23,27,61.333333333333336
15765,2012-10-24,4,1,10,2,0,6,6,26.333333333333332
15766,2012-10-24,4,1,10,3,0,4,4,12.333333333333334
15767,2012-10-24,4,1,10,4,1,5,6,5.333333333333333
15768,2012-10-24,4,1,10,5,1,52,53,21.0
15769,2012-10-24,4,1,10,6,11,162,173,77.33333333333333
15770,2012-10-24,4,1,10,7,20,506,526,250.66666666666666
15771,2012-10-24,4,1,10,8,24,777,801,500.0
15772,2012-10-24,4,1,10,9,24,349,373,566.6666666666666
15773,2012-10-24,4,1,10,10,29,142,171,448.3333333333333
15774,2012-10-24,4,1,10,11,47,189,236,260.0
15775,2012-10-24,4,1,10,12,48,268,316,241.0
15776,2012-10-24,4,1,10,13,65,241,306,286.0
15777,2012-10-24,4,1,10,14,64,237,301,307.6666666666667
15778,2012-10-24,4,1,10,15,63,245,308,305.0
15779,2012-10-24,4,1,10,16,67,465,532,380.3333333333333
15780,2012-10-24,4,1,10,17,87,876,963,601.0
15781,2012-10-24,4,1,10,18,63,795,858,784.3333333333334
15782,2012-10-24,4,1,10,19,50,522,572,797.6666666666666
15783,2012-10-24,4,1,10,20,45,396,441,623.6666666666666
15784,2012-10-24,4,1,10,21,33,280,313,442.0
15785,2012-10-24,4,1,10,22,30,208,238,330.6666666666667
15786,2012-10-24,4,1,10,23,12,111,123,224.66666666666666
15787,2012-10-25,4,1,10,0,19,57,76,145.66666666666666
15788,2012-10-25,4,1,10,1,6,22,28,75.66666666666667
15789,2012-10-25,4,1,10,2,3,15,18,40.666666666666664
15790,2012-10-25,4,1,10,3,0,8,8,18.0
15791,2012-10-25,4,1,10,4,1,4,5,10.333333333333334
15792,2012-10-25,4,1,10,5,2,53,55,22.666666666666668
15793,2012-10-25,4,1,10,6,3,168,171,77.0
15794,2012-10-25,4,1,10,7,18,477,495,240.33333333333334
15795,2012-10-25,4,1,10,8,33,746,779,481.6666666666667
15796,2012-10-25,4,1,10,9,23,320,343,539.0
15797,2012-10-25,4,1,10,10,53,172,225,449.0
15798,2012-10-25,4,1,10,11,57,181,238,268.6666666666667
15799,2012-10-25,4,1,10,12,61,258,319,260.6666666666667
15800,2012-10-25,4,1,10,13,49,264,313,290.0
15801,2012-10-25,4,1,10,14,71,214,285,305.6666666666667
15802,2012-10-25,4,1,10,15,63,242,305,301.0
15803,2012-10-25,4,1,10,16,92,407,499,363.0
15804,2012-10-25,4,1,10,17,112,774,886,563.3333333333334
15805,2012-10-25,4,1,10,18,77,732,809,731.3333333333334
15806,2012-10-25,4,1,10,19,45,497,542,745.6666666666666
15807,2012-10-25,4,1,10,20,28,319,347,566.0
15808,2012-10-25,4,1,10,21,24,247,271,386.6666666666667
15809,2012-10-25,4,1,10,22,22,185,207,275.0
15810,2012-10-25,4,1,10,23,13,122,135,204.33333333333334
15811,2012-10-26,4,1,10,0,6,65,71,137.66666666666666
15812,2012-10-26,4,1,10,1,4,32,36,80.66666666666667
15813,2012-10-26,4,1,10,2,4,15,19,42.0
15814,2012-10-26,4,1,10,3,5,8,13,22.666666666666668
15815,2012-10-26,4,1,10,4,1,4,5,12.333333333333334
15816,2012-10-26,4,1,10,5,3,47,50,22.666666666666668
15817,2012-10-26,4,1,10,6,2,142,144,66.33333333333333
15818,2012-10-26,4,1,10,7,13,408,421,205.0
15819,2012-10-26,4,1,10,8,20,714,734,433.0
15820,2012-10-26,4,1,10,9,56,347,403,519.3333333333334
15821,2012-10-26,4,1,10,10,41,156,197,444.6666666666667
15822,2012-10-26,4,1,10,11,68,222,290,296.6666666666667
15823,2012-10-26,4,1,10,12,90,302,392,293.0
15824,2012-10-26,4,1,10,13,77,260,337,339.6666666666667
15825,2012-10-26,4,1,10,14,99,252,351,360.0
15826,2012-10-26,4,1,10,15,142,306,448,378.6666666666667
15827,2012-10-26,4,1,10,16,137,445,582,460.3333333333333
15828,2012-10-26,4,1,10,17,125,692,817,615.6666666666666
15829,2012-10-26,4,1,10,18,81,584,665,688.0
15830,2012-10-26,4,1,10,19,72,399,471,651.0
15831,2012-10-26,4,1,10,20,40,271,311,482.3333333333333
15832,2012-10-26,4,1,10,21,40,252,292,358.0
15833,2012-10-26,4,1,10,22,37,180,217,273.3333333333333
15834,2012-10-26,4,1,10,23,19,159,178,229.0
15835,2012-10-27,4,1,10,0,10,132,142,179.0
15836,2012-10-27,4,1,10,1,23,123,146,155.33333333333334
15837,2012-10-27,4,1,10,2,19,71,90,126.0
15838,2012-10-27,4,1,10,3,5,21,26,87.33333333333333
15839,2012-10-27,4,1,10,4,1,12,13,43.0
15840,2012-10-27,4,1,10,5,2,7,9,16.0
15841,2012-10-27,4,1,10,6,2,29,31,17.666666666666668
15842,2012-10-27,4,1,10,7,7,79,86,42.0
15843,2012-10-27,4,1,10,8,26,187,213,110.0
15844,2012-10-27,4,1,10,9,88,240,328,209.0
15845,2012-10-27,4,1,10,10,165,314,479,340.0
15846,2012-10-27,4,1,10,11,197,388,585,464.0
15847,2012-10-27,4,1,10,12,264,404,668,577.3333333333334
15848,2012-10-27,4,1,10,13,310,450,760,671.0
15849,2012-10-27,4,1,10,14,325,425,750,726.0
15850,2012-10-27,4,1,10,15,310,401,711,740.3333333333334
15851,2012-10-27,4,1,10,16,257,355,612,691.0
15852,2012-10-27,4,1,10,17,248,370,618,647.0
15853,2012-10-27,4,1,10,18,138,318,456,562.0
15854,2012-10-27,4,1,10,19,67,233,300,458.0
15855,2012-10-27,4,1,10,20,58,238,296,350.6666666666667
15856,2012-10-27,4,1,10,21,49,160,209,268.3333333333333
15857,2012-10-27,4,1,10,22,41,116,157,220.66666666666666
15858,2012-10-27,4,1,10,23,31,136,167,177.66666666666666
15859,2012-10-28,4,1,10,0,20,97,117,147.0
15860,2012-10-28,4,1,10,1,22,111,133,139.0
15861,2012-10-28,4,1,10,2,17,99,116,122.0
15862,2012-10-28,4,1,10,3,18,61,79,109.33333333333333
15863,2012-10-28,4,1,10,4,1,19,20,71.66666666666667
15864,2012-10-28,4,1,10,5,6,22,28,42.333333333333336
15865,2012-10-28,4,1,10,6,7,32,39,29.0
15866,2012-10-28,4,1,10,7,17,48,65,44.0
15867,2012-10-28,4,1,10,8,55,118,173,92.33333333333333
15868,2012-10-28,4,1,10,9,124,206,330,189.33333333333334
15869,2012-10-28,4,1,10,10,120,314,434,312.3333333333333
15870,2012-10-28,4,1,10,11,110,352,462,408.6666666666667
15871,2012-10-28,4,1,10,12,118,373,491,462.3333333333333
15872,2012-10-28,4,1,10,13,75,316,391,448.0
15873,2012-10-28,4,1,10,14,98,304,402,428.0
15874,2012-10-28,4,1,10,15,76,225,301,364.6666666666667
15875,2012-10-28,4,1,10,16,42,251,293,332.0
15876,2012-10-28,4,1,10,17,37,188,225,273.0
15877,2012-10-28,4,1,10,18,18,136,154,224.0
15878,2012-10-28,4,1,10,19,7,47,54,144.33333333333334
15879,2012-10-28,4,1,10,20,4,51,55,87.66666666666667
15880,2012-10-28,4,1,10,21,2,44,46,51.666666666666664
15881,2012-10-28,4,1,10,22,2,35,37,46.0
15882,2012-10-28,4,1,10,23,2,12,14,32.333333333333336
15883,2012-10-29,4,1,10,0,2,20,22,24.333333333333332
15884,2012-10-30,4,1,10,13,11,105,116,50.666666666666664
15885,2012-10-30,4,1,10,14,8,118,126,88.0
15886,2012-10-30,4,1,10,15,10,114,124,122.0
15887,2012-10-30,4,1,10,16,15,83,98,116.0
15888,2012-10-30,4,1,10,17,19,105,124,115.33333333333333
15889,2012-10-30,4,1,10,18,4,139,143,121.66666666666667
15890,2012-10-30,4,1,10,19,6,109,115,127.33333333333333
15891,2012-10-30,4,1,10,20,5,76,81,113.0
15892,2012-10-30,4,1,10,21,4,60,64,86.66666666666667
15893,2012-10-30,4,1,10,22,2,64,66,70.33333333333333
15894,2012-10-30,4,1,10,23,3,36,39,56.333333333333336
15895,2012-10-31,4,1,10,0,0,16,16,40.333333333333336
15896,2012-10-31,4,1,10,1,0,8,8,21.0
15897,2012-10-31,4,1,10,2,0,7,7,10.333333333333334
15898,2012-10-31,4,1,10,3,0,3,3,6.0
15899,2012-10-31,4,1,10,4,0,5,5,5.0
15900,2012-10-31,4,1,10,5,0,24,24,10.666666666666666
15901,2012-10-31,4,1,10,6,0,116,116,48.333333333333336
15902,2012-10-31,4,1,10,7,3,334,337,159.0
15903,2012-10-31,4,1,10,8,6,615,621,358.0
15904,2012-10-31,4,1,10,9,17,280,297,418.3333333333333
15905,2012-10-31,4,1,10,10,21,147,168,362.0
15906,2012-10-31,4,1,10,11,37,152,189,218.0
15907,2012-10-31,4,1,10,12,44,197,241,199.33333333333334
15908,2012-10-31,4,1,10,13,22,191,213,214.33333333333334
15909,2012-10-31,4,1,10,14,45,179,224,226.0
15910,2012-10-31,4,1,10,15,33,197,230,222.33333333333334
15911,2012-10-31,4,1,10,16,51,373,424,292.6666666666667
15912,2012-10-31,4,1,10,17,39,684,723,459.0
15913,2012-10-31,4,1,10,18,28,556,584,577.0
15914,2012-10-31,4,1,10,19,27,383,410,572.3333333333334
15915,2012-10-31,4,1,10,20,9,259,268,420.6666666666667
15916,2012-10-31,4,1,10,21,12,180,192,290.0
15917,2012-10-31,4,1,10,22,18,147,165,208.33333333333334
15918,2012-10-31,4,1,10,23,7,94,101,152.66666666666666
15919,2012-11-01,4,1,11,0,8,52,60,108.66666666666667
15920,2012-11-01,4,1,11,1,8,22,30,63.666666666666664
15921,2012-11-01,4,1,11,2,10,10,20,36.666666666666664
15922,2012-11-01,4,1,11,3,5,10,15,21.666666666666668
15923,2012-11-01,4,1,11,4,2,8,10,15.0
15924,2012-11-01,4,1,11,5,1,39,40,21.666666666666668
15925,2012-11-01,4,1,11,6,2,146,148,66.0
15926,2012-11-01,4,1,11,7,6,414,420,202.66666666666666
15927,2012-11-01,4,1,11,8,12,668,680,416.0
15928,2012-11-01,4,1,11,9,21,310,331,477.0
15929,2012-11-01,4,1,11,10,13,133,146,385.6666666666667
15930,2012-11-01,4,1,11,11,14,156,170,215.66666666666666
15931,2012-11-01,4,1,11,12,23,198,221,179.0
15932,2012-11-01,4,1,11,13,49,199,248,213.0
15933,2012-11-01,4,1,11,14,31,154,185,218.0
15934,2012-11-01,4,1,11,15,35,179,214,215.66666666666666
15935,2012-11-01,4,1,11,16,31,313,344,247.66666666666666
15936,2012-11-01,4,1,11,17,37,652,689,415.6666666666667
15937,2012-11-01,4,1,11,18,50,628,678,570.3333333333334
15938,2012-11-01,4,1,11,19,28,424,452,606.3333333333334
15939,2012-11-01,4,1,11,20,16,280,296,475.3333333333333
15940,2012-11-01,4,1,11,21,29,238,267,338.3333333333333
15941,2012-11-01,4,1,11,22,27,175,202,255.0
15942,2012-11-01,4,1,11,23,8,112,120,196.33333333333334
15943,2012-11-02,4,1,11,0,10,40,50,124.0
15944,2012-11-02,4,1,11,1,5,19,24,64.66666666666667
15945,2012-11-02,4,1,11,2,3,7,10,28.0
15946,2012-11-02,4,1,11,3,0,3,3,12.333333333333334
15947,2012-11-02,4,1,11,4,1,6,7,6.666666666666667
15948,2012-11-02,4,1,11,5,1,25,26,12.0
15949,2012-11-02,4,1,11,6,2,120,122,51.666666666666664
15950,2012-11-02,4,1,11,7,8,349,357,168.33333333333334
15951,2012-11-02,4,1,11,8,31,656,687,388.6666666666667
15952,2012-11-02,4,1,11,9,27,355,382,475.3333333333333
15953,2012-11-02,4,1,11,10,21,183,204,424.3333333333333
15954,2012-11-02,4,1,11,11,42,179,221,269.0
15955,2012-11-02,4,1,11,12,52,240,292,239.0
15956,2012-11-02,4,1,11,13,64,230,294,269.0
15957,2012-11-02,4,1,11,14,63,199,262,282.6666666666667
15958,2012-11-02,4,1,11,15,51,255,306,287.3333333333333
15959,2012-11-02,4,1,11,16,48,373,421,329.6666666666667
15960,2012-11-02,4,1,11,17,57,581,638,455.0
15961,2012-11-02,4,1,11,18,32,490,522,527.0
15962,2012-11-02,4,1,11,19,38,336,374,511.3333333333333
15963,2012-11-02,4,1,11,20,14,207,221,372.3333333333333
15964,2012-11-02,4,1,11,21,23,133,156,250.33333333333334
15965,2012-11-02,4,1,11,22,14,135,149,175.33333333333334
15966,2012-11-02,4,1,11,23,11,108,119,141.33333333333334
15967,2012-11-03,4,1,11,0,9,99,108,125.33333333333333
15968,2012-11-03,4,1,11,1,6,83,89,105.33333333333333
15969,2012-11-03,4,1,11,2,10,36,46,81.0
15970,2012-11-03,4,1,11,3,6,22,28,54.333333333333336
15971,2012-11-03,4,1,11,4,8,8,16,30.0
15972,2012-11-03,4,1,11,5,1,8,9,17.666666666666668
15973,2012-11-03,4,1,11,6,4,17,21,15.333333333333334
15974,2012-11-03,4,1,11,7,1,58,59,29.666666666666668
15975,2012-11-03,4,1,11,8,10,132,142,74.0
15976,2012-11-03,4,1,11,9,31,188,219,140.0
15977,2012-11-03,4,1,11,10,68,260,328,229.66666666666666
15978,2012-11-03,4,1,11,11,56,284,340,295.6666666666667
15979,2012-11-03,4,1,11,12,74,320,394,354.0
15980,2012-11-03,4,1,11,13,110,339,449,394.3333333333333
15981,2012-11-03,4,1,11,14,136,319,455,432.6666666666667
15982,2012-11-03,4,1,11,15,117,331,448,450.6666666666667
15983,2012-11-03,4,1,11,16,108,292,400,434.3333333333333
15984,2012-11-03,4,1,11,17,112,298,410,419.3333333333333
15985,2012-11-03,4,1,11,18,58,239,297,369.0
15986,2012-11-03,4,1,11,19,22,217,239,315.3333333333333
15987,2012-11-03,4,1,11,20,23,158,181,239.0
15988,2012-11-03,4,1,11,21,31,135,166,195.33333333333334
15989,2012-11-03,4,1,11,22,13,133,146,164.33333333333334
15990,2012-11-03,4,1,11,23,15,133,148,153.33333333333334
15991,2012-11-04,4,1,11,0,5,97,102,132.0
15992,2012-11-04,4,1,11,1,26,139,165,138.33333333333334
15993,2012-11-04,4,1,11,2,6,31,37,101.33333333333333
15994,2012-11-04,4,1,11,3,1,10,11,71.0
15995,2012-11-04,4,1,11,4,2,7,9,19.0
15996,2012-11-04,4,1,11,5,0,5,5,8.333333333333334
15997,2012-11-04,4,1,11,6,2,14,16,10.0
15998,2012-11-04,4,1,11,7,11,39,50,23.666666666666668
15999,2012-11-04,4,1,11,8,34,115,149,71.66666666666667
16000,2012-11-04,4,1,11,9,56,161,217,138.66666666666666
16001,2012-11-04,4,1,11,10,73,287,360,242.0
16002,2012-11-04,4,1,11,11,134,311,445,340.6666666666667
16003,2012-11-04,4,1,11,12,150,354,504,436.3333333333333
16004,2012-11-04,4,1,11,13,122,371,493,480.6666666666667
16005,2012-11-04,4,1,11,14,149,360,509,502.0
16006,2012-11-04,4,1,11,15,149,300,449,483.6666666666667
16007,2012-11-04,4,1,11,16,119,316,435,464.3333333333333
16008,2012-11-04,4,1,11,17,57,270,327,403.6666666666667
16009,2012-11-04,4,1,11,18,31,206,237,333.0
16010,2012-11-04,4,1,11,19,24,203,227,263.6666666666667
16011,2012-11-04,4,1,11,20,7,134,141,201.66666666666666
16012,2012-11-04,4,1,11,21,16,71,87,151.66666666666666
16013,2012-11-04,4,1,11,22,15,64,79,102.33333333333333
16014,2012-11-04,4,1,11,23,12,41,53,73.0
16015,2012-11-05,4,1,11,0,3,20,23,51.666666666666664
16016,2012-11-05,4,1,11,1,0,8,8,28.0
16017,2012-11-05,4,1,11,2,2,4,6,12.333333333333334
16018,2012-11-05,4,1,11,3,1,3,4,6.0
16019,2012-11-05,4,1,11,4,5,11,16,8.666666666666666
16020,2012-11-05,4,1,11,5,1,38,39,19.666666666666668
16021,2012-11-05,4,1,11,6,4,135,139,64.66666666666667
16022,2012-11-05,4,1,11,7,8,453,461,213.0
16023,2012-11-05,4,1,11,8,19,629,648,416.0
16024,2012-11-05,4,1,11,9,18,239,257,455.3333333333333
16025,2012-11-05,4,1,11,10,30,112,142,349.0
16026,2012-11-05,4,1,11,11,31,119,150,183.0
16027,2012-11-05,4,1,11,12,38,206,244,178.66666666666666
16028,2012-11-05,4,1,11,13,39,183,222,205.33333333333334
16029,2012-11-05,4,1,11,14,31,165,196,220.66666666666666
16030,2012-11-05,4,1,11,15,24,207,231,216.33333333333334
16031,2012-11-05,4,1,11,16,35,325,360,262.3333333333333
16032,2012-11-05,4,1,11,17,34,604,638,409.6666666666667
16033,2012-11-05,4,1,11,18,19,523,542,513.3333333333334
16034,2012-11-05,4,1,11,19,11,361,372,517.3333333333334
16035,2012-11-05,4,1,11,20,13,228,241,385.0
16036,2012-11-05,4,1,11,21,8,144,152,255.0
16037,2012-11-05,4,1,11,22,4,111,115,169.33333333333334
16038,2012-11-05,4,1,11,23,0,53,53,106.66666666666667
16039,2012-11-06,4,1,11,0,1,18,19,62.333333333333336
16040,2012-11-06,4,1,11,1,0,8,8,26.666666666666668
16041,2012-11-06,4,1,11,2,0,2,2,9.666666666666666
16042,2012-11-06,4,1,11,3,0,4,4,4.666666666666667
16043,2012-11-06,4,1,11,4,0,7,7,4.333333333333333
16044,2012-11-06,4,1,11,5,1,40,41,17.333333333333332
16045,2012-11-06,4,1,11,6,6,143,149,65.66666666666667
16046,2012-11-06,4,1,11,7,9,378,387,192.33333333333334
16047,2012-11-06,4,1,11,8,20,568,588,374.6666666666667
16048,2012-11-06,4,1,11,9,25,338,363,446.0
16049,2012-11-06,4,1,11,10,41,189,230,393.6666666666667
16050,2012-11-06,4,1,11,11,39,177,216,269.6666666666667
16051,2012-11-06,4,1,11,12,31,217,248,231.33333333333334
16052,2012-11-06,4,1,11,13,46,232,278,247.33333333333334
16053,2012-11-06,4,1,11,14,44,196,240,255.33333333333334
16054,2012-11-06,4,1,11,15,45,227,272,263.3333333333333
16055,2012-11-06,4,1,11,16,33,369,402,304.6666666666667
16056,2012-11-06,4,1,11,17,30,597,627,433.6666666666667
16057,2012-11-06,4,1,11,18,20,477,497,508.6666666666667
16058,2012-11-06,4,1,11,19,15,356,371,498.3333333333333
16059,2012-11-06,4,1,11,20,10,218,228,365.3333333333333
16060,2012-11-06,4,1,11,21,14,137,151,250.0
16061,2012-11-06,4,1,11,22,17,136,153,177.33333333333334
16062,2012-11-06,4,1,11,23,19,186,205,169.66666666666666
16063,2012-11-07,4,1,11,0,49,234,283,213.66666666666666
16064,2012-11-07,4,1,11,1,6,86,92,193.33333333333334
16065,2012-11-07,4,1,11,2,6,68,74,149.66666666666666
16066,2012-11-07,4,1,11,3,2,9,11,59.0
16067,2012-11-07,4,1,11,4,0,9,9,31.333333333333332
16068,2012-11-07,4,1,11,5,0,27,27,15.666666666666666
16069,2012-11-07,4,1,11,6,3,115,118,51.333333333333336
16070,2012-11-07,4,1,11,7,5,314,319,154.66666666666666
16071,2012-11-07,4,1,11,8,18,583,601,346.0
16072,2012-11-07,4,1,11,9,17,351,368,429.3333333333333
16073,2012-11-07,4,1,11,10,27,151,178,382.3333333333333
16074,2012-11-07,4,1,11,11,15,132,147,231.0
16075,2012-11-07,4,1,11,12,24,188,212,179.0
16076,2012-11-07,4,1,11,13,23,158,181,180.0
16077,2012-11-07,4,1,11,14,19,142,161,184.66666666666666
16078,2012-11-07,4,1,11,15,20,178,198,180.0
16079,2012-11-07,4,1,11,16,23,250,273,210.66666666666666
16080,2012-11-07,4,1,11,17,16,501,517,329.3333333333333
16081,2012-11-07,4,1,11,18,17,448,465,418.3333333333333
16082,2012-11-07,4,1,11,19,17,302,319,433.6666666666667
16083,2012-11-07,4,1,11,20,7,249,256,346.6666666666667
16084,2012-11-07,4,1,11,21,5,121,126,233.66666666666666
16085,2012-11-07,4,1,11,22,4,56,60,147.33333333333334
16086,2012-11-07,4,1,11,23,3,37,40,75.33333333333333
16087,2012-11-08,4,1,11,0,1,14,15,38.333333333333336
16088,2012-11-08,4,1,11,1,1,11,12,22.333333333333332
16089,2012-11-08,4,1,11,2,1,5,6,11.0
16090,2012-11-08,4,1,11,4,1,9,10,9.333333333333334
16091,2012-11-08,4,1,11,5,0,35,35,17.0
16092,2012-11-08,4,1,11,6,2,122,124,56.333333333333336
16093,2012-11-08,4,1,11,7,12,411,423,194.0
16094,2012-11-08,4,1,11,8,16,652,668,405.0
16095,2012-11-08,4,1,11,9,22,253,275,455.3333333333333
16096,2012-11-08,4,1,11,10,13,148,161,368.0
16097,2012-11-08,4,1,11,11,16,155,171,202.33333333333334
16098,2012-11-08,4,1,11,12,33,202,235,189.0
16099,2012-11-08,4,1,11,13,33,195,228,211.33333333333334
16100,2012-11-08,4,1,11,14,33,149,182,215.0
16101,2012-11-08,4,1,11,15,32,201,233,214.33333333333334
16102,2012-11-08,4,1,11,16,18,321,339,251.33333333333334
16103,2012-11-08,4,1,11,17,36,556,592,388.0
16104,2012-11-08,4,1,11,18,16,491,507,479.3333333333333
16105,2012-11-08,4,1,11,19,14,359,373,490.6666666666667
16106,2012-11-08,4,1,11,20,10,235,245,375.0
16107,2012-11-08,4,1,11,21,11,222,233,283.6666666666667
16108,2012-11-08,4,1,11,22,14,147,161,213.0
16109,2012-11-08,4,1,11,23,5,82,87,160.33333333333334
16110,2012-11-09,4,1,11,0,9,46,55,101.0
16111,2012-11-09,4,1,11,1,3,17,20,54.0
16112,2012-11-09,4,1,11,2,1,11,12,29.0
16113,2012-11-09,4,1,11,3,3,6,9,13.666666666666666
16114,2012-11-09,4,1,11,4,0,14,14,11.666666666666666
16115,2012-11-09,4,1,11,5,2,25,27,16.666666666666668
16116,2012-11-09,4,1,11,6,5,126,131,57.333333333333336
16117,2012-11-09,4,1,11,7,9,332,341,166.33333333333334
16118,2012-11-09,4,1,11,8,25,668,693,388.3333333333333
16119,2012-11-09,4,1,11,9,23,304,327,453.6666666666667
16120,2012-11-09,4,1,11,10,34,163,197,405.6666666666667
16121,2012-11-09,4,1,11,11,66,185,251,258.3333333333333
16122,2012-11-09,4,1,11,12,48,214,262,236.66666666666666
16123,2012-11-09,4,1,11,13,62,237,299,270.6666666666667
16124,2012-11-09,4,1,11,14,67,207,274,278.3333333333333
16125,2012-11-09,4,1,11,15,78,278,356,309.6666666666667
16126,2012-11-09,4,1,11,16,57,377,434,354.6666666666667
16127,2012-11-09,4,1,11,17,61,593,654,481.3333333333333
16128,2012-11-09,4,1,11,18,46,450,496,528.0
16129,2012-11-09,4,1,11,19,30,331,361,503.6666666666667
16130,2012-11-09,4,1,11,20,20,235,255,370.6666666666667
16131,2012-11-09,4,1,11,21,23,176,199,271.6666666666667
16132,2012-11-09,4,1,11,22,17,146,163,205.66666666666666
16133,2012-11-09,4,1,11,23,20,142,162,174.66666666666666
16134,2012-11-10,4,1,11,0,16,106,122,149.0
16135,2012-11-10,4,1,11,1,8,68,76,120.0
16136,2012-11-10,4,1,11,2,2,42,44,80.66666666666667
16137,2012-11-10,4,1,11,3,9,11,20,46.666666666666664
16138,2012-11-10,4,1,11,4,2,4,6,23.333333333333332
16139,2012-11-10,4,1,11,5,1,9,10,12.0
16140,2012-11-10,4,1,11,6,5,11,16,10.666666666666666
16141,2012-11-10,4,1,11,7,14,57,71,32.333333333333336
16142,2012-11-10,4,1,11,8,16,130,146,77.66666666666667
16143,2012-11-10,4,1,11,9,43,216,259,158.66666666666666
16144,2012-11-10,4,1,11,10,86,264,350,251.66666666666666
16145,2012-11-10,4,1,11,11,143,323,466,358.3333333333333
16146,2012-11-10,4,1,11,12,258,348,606,474.0
16147,2012-11-10,4,1,11,13,268,383,651,574.3333333333334
16148,2012-11-10,4,1,11,14,280,347,627,628.0
16149,2012-11-10,4,1,11,15,216,351,567,615.0
16150,2012-11-10,4,1,11,16,227,378,605,599.6666666666666
16151,2012-11-10,4,1,11,17,183,318,501,557.6666666666666
16152,2012-11-10,4,1,11,18,103,256,359,488.3333333333333
16153,2012-11-10,4,1,11,19,55,228,283,381.0
16154,2012-11-10,4,1,11,20,39,153,192,278.0
16155,2012-11-10,4,1,11,21,51,169,220,231.66666666666666
16156,2012-11-10,4,1,11,22,39,154,193,201.66666666666666
16157,2012-11-10,4,1,11,23,26,120,146,186.33333333333334
16158,2012-11-11,4,1,11,0,14,110,124,154.33333333333334
16159,2012-11-11,4,1,11,1,26,82,108,126.0
16160,2012-11-11,4,1,11,2,12,58,70,100.66666666666667
16161,2012-11-11,4,1,11,3,9,39,48,75.33333333333333
16162,2012-11-11,4,1,11,4,5,6,11,43.0
16163,2012-11-11,4,1,11,5,0,12,12,23.666666666666668
16164,2012-11-11,4,1,11,6,3,16,19,14.0
16165,2012-11-11,4,1,11,7,12,56,68,33.0
16166,2012-11-11,4,1,11,8,32,87,119,68.66666666666667
16167,2012-11-11,4,1,11,9,94,179,273,153.33333333333334
16168,2012-11-11,4,1,11,10,133,272,405,265.6666666666667
16169,2012-11-11,4,1,11,11,180,324,504,394.0
16170,2012-11-11,4,1,11,12,195,390,585,498.0
16171,2012-11-11,4,1,11,13,262,424,686,591.6666666666666
16172,2012-11-11,4,1,11,14,292,362,654,641.6666666666666
16173,2012-11-11,4,1,11,15,304,420,724,688.0
16174,2012-11-11,4,1,11,16,260,393,653,677.0
16175,2012-11-11,4,1,11,17,151,342,493,623.3333333333334
16176,2012-11-11,4,1,11,18,102,303,405,517.0
16177,2012-11-11,4,1,11,19,69,208,277,391.6666666666667
16178,2012-11-11,4,1,11,20,54,146,200,294.0
16179,2012-11-11,4,1,11,21,44,127,171,216.0
16180,2012-11-11,4,1,11,22,21,113,134,168.33333333333334
16181,2012-11-11,4,1,11,23,16,93,109,138.0
16182,2012-11-12,4,1,11,0,6,43,49,97.33333333333333
16183,2012-11-12,4,1,11,1,4,26,30,62.666666666666664
16184,2012-11-12,4,1,11,2,6,14,20,33.0
16185,2012-11-12,4,1,11,3,1,3,4,18.0
16186,2012-11-12,4,1,11,4,1,3,4,9.333333333333334
16187,2012-11-12,4,1,11,5,1,23,24,10.666666666666666
16188,2012-11-12,4,1,11,6,7,64,71,33.0
16189,2012-11-12,4,1,11,7,16,248,264,119.66666666666667
16190,2012-11-12,4,1,11,8,50,490,540,291.6666666666667
16191,2012-11-12,4,1,11,9,60,337,397,400.3333333333333
16192,2012-11-12,4,1,11,10,82,184,266,401.0
16193,2012-11-12,4,1,11,11,112,255,367,343.3333333333333
16194,2012-11-12,4,1,11,12,105,314,419,350.6666666666667
16195,2012-11-12,4,1,11,13,108,312,420,402.0
16196,2012-11-12,4,1,11,14,134,310,444,427.6666666666667
16197,2012-11-12,4,1,11,15,102,280,382,415.3333333333333
16198,2012-11-12,4,1,11,16,87,347,434,420.0
16199,2012-11-12,4,1,11,17,66,530,596,470.6666666666667
16200,2012-11-12,4,1,11,18,65,486,551,527.0
16201,2012-11-12,4,1,11,19,30,323,353,500.0
16202,2012-11-12,4,1,11,20,31,273,304,402.6666666666667
16203,2012-11-12,4,1,11,21,10,145,155,270.6666666666667
16204,2012-11-12,4,1,11,22,12,100,112,190.33333333333334
16205,2012-11-12,4,1,11,23,1,62,63,110.0
16206,2012-11-13,4,1,11,0,5,18,23,66.0
16207,2012-11-13,4,1,11,1,0,5,5,30.333333333333332
16208,2012-11-13,4,1,11,2,7,4,11,13.0
16209,2012-11-13,4,1,11,3,2,3,5,7.0
16210,2012-11-13,4,1,11,4,0,9,9,8.333333333333334
16211,2012-11-13,4,1,11,5,0,18,18,10.666666666666666
16212,2012-11-13,4,1,11,6,2,48,50,25.666666666666668
16213,2012-11-13,4,1,11,7,1,106,107,58.333333333333336
16214,2012-11-13,4,1,11,8,4,207,211,122.66666666666667
16215,2012-11-13,4,1,11,9,1,109,110,142.66666666666666
16216,2012-11-13,4,1,11,10,10,84,94,138.33333333333334
16217,2012-11-13,4,1,11,11,22,133,155,119.66666666666667
16218,2012-11-13,4,1,11,12,16,180,196,148.33333333333334
16219,2012-11-13,4,1,11,13,30,188,218,189.66666666666666
16220,2012-11-13,4,1,11,14,34,169,203,205.66666666666666
16221,2012-11-13,4,1,11,15,33,184,217,212.66666666666666
16222,2012-11-13,4,1,11,16,28,282,310,243.33333333333334
16223,2012-11-13,4,1,11,17,33,575,608,378.3333333333333
16224,2012-11-13,4,1,11,18,45,514,559,492.3333333333333
16225,2012-11-13,4,1,11,19,12,344,356,507.6666666666667
16226,2012-11-13,4,1,11,20,12,211,223,379.3333333333333
16227,2012-11-13,4,1,11,21,9,178,187,255.33333333333334
16228,2012-11-13,4,1,11,22,15,120,135,181.66666666666666
16229,2012-11-13,4,1,11,23,6,78,84,135.33333333333334
16230,2012-11-14,4,1,11,0,4,20,24,81.0
16231,2012-11-14,4,1,11,1,2,10,12,40.0
16232,2012-11-14,4,1,11,2,0,1,1,12.333333333333334
16233,2012-11-14,4,1,11,3,0,5,5,6.0
16234,2012-11-14,4,1,11,4,0,6,6,4.0
16235,2012-11-14,4,1,11,5,0,39,39,16.666666666666668
16236,2012-11-14,4,1,11,6,4,142,146,63.666666666666664
16237,2012-11-14,4,1,11,7,10,405,415,200.0
16238,2012-11-14,4,1,11,8,27,664,691,417.3333333333333
16239,2012-11-14,4,1,11,9,22,310,332,479.3333333333333
16240,2012-11-14,4,1,11,10,18,153,171,398.0
16241,2012-11-14,4,1,11,11,25,126,151,218.0
16242,2012-11-14,4,1,11,12,40,200,240,187.33333333333334
16243,2012-11-14,4,1,11,13,32,182,214,201.66666666666666
16244,2012-11-14,4,1,11,14,20,161,181,211.66666666666666
16245,2012-11-14,4,1,11,15,32,228,260,218.33333333333334
16246,2012-11-14,4,1,11,16,31,290,321,254.0
16247,2012-11-14,4,1,11,17,19,564,583,388.0
16248,2012-11-14,4,1,11,18,24,543,567,490.3333333333333
16249,2012-11-14,4,1,11,19,28,368,396,515.3333333333334
16250,2012-11-14,4,1,11,20,15,252,267,410.0
16251,2012-11-14,4,1,11,21,5,208,213,292.0
16252,2012-11-14,4,1,11,22,6,167,173,217.66666666666666
16253,2012-11-14,4,1,11,23,9,78,87,157.66666666666666
16254,2012-11-15,4,1,11,0,1,33,34,98.0
16255,2012-11-15,4,1,11,1,2,14,16,45.666666666666664
16256,2012-11-15,4,1,11,2,0,7,7,19.0
16257,2012-11-15,4,1,11,3,0,2,2,8.333333333333334
16258,2012-11-15,4,1,11,4,0,5,5,4.666666666666667
16259,2012-11-15,4,1,11,5,3,34,37,14.666666666666666
16260,2012-11-15,4,1,11,6,1,146,147,63.0
16261,2012-11-15,4,1,11,7,7,403,410,198.0
16262,2012-11-15,4,1,11,8,21,625,646,401.0
16263,2012-11-15,4,1,11,9,17,306,323,459.6666666666667
16264,2012-11-15,4,1,11,10,11,142,153,374.0
16265,2012-11-15,4,1,11,11,28,138,166,214.0
16266,2012-11-15,4,1,11,12,29,184,213,177.33333333333334
16267,2012-11-15,4,1,11,13,20,197,217,198.66666666666666
16268,2012-11-15,4,1,11,14,27,174,201,210.33333333333334
16269,2012-11-15,4,1,11,15,26,191,217,211.66666666666666
16270,2012-11-15,4,1,11,16,24,318,342,253.33333333333334
16271,2012-11-15,4,1,11,17,22,541,563,374.0
16272,2012-11-15,4,1,11,18,10,563,573,492.6666666666667
16273,2012-11-15,4,1,11,19,11,375,386,507.3333333333333
16274,2012-11-15,4,1,11,20,23,262,285,414.6666666666667
16275,2012-11-15,4,1,11,21,20,204,224,298.3333333333333
16276,2012-11-15,4,1,11,22,10,143,153,220.66666666666666
16277,2012-11-15,4,1,11,23,7,118,125,167.33333333333334
16278,2012-11-16,4,1,11,0,7,58,65,114.33333333333333
16279,2012-11-16,4,1,11,1,5,16,21,70.33333333333333
16280,2012-11-16,4,1,11,2,0,9,9,31.666666666666668
16281,2012-11-16,4,1,11,3,0,6,6,12.0
16282,2012-11-16,4,1,11,4,0,5,5,6.666666666666667
16283,2012-11-16,4,1,11,5,2,34,36,15.666666666666666
16284,2012-11-16,4,1,11,6,4,126,130,57.0
16285,2012-11-16,4,1,11,7,5,362,367,177.66666666666666
16286,2012-11-16,4,1,11,8,17,694,711,402.6666666666667
16287,2012-11-16,4,1,11,9,21,330,351,476.3333333333333
16288,2012-11-16,4,1,11,10,33,165,198,420.0
16289,2012-11-16,4,1,11,11,33,185,218,255.66666666666666
16290,2012-11-16,4,1,11,12,28,262,290,235.33333333333334
16291,2012-11-16,4,1,11,13,52,226,278,262.0
16292,2012-11-16,4,1,11,14,47,204,251,273.0
16293,2012-11-16,4,1,11,15,30,237,267,265.3333333333333
16294,2012-11-16,4,1,11,16,33,350,383,300.3333333333333
16295,2012-11-16,4,1,11,17,41,539,580,410.0
16296,2012-11-16,4,1,11,18,22,483,505,489.3333333333333
16297,2012-11-16,4,1,11,19,26,306,332,472.3333333333333
16298,2012-11-16,4,1,11,20,20,207,227,354.6666666666667
16299,2012-11-16,4,1,11,21,21,157,178,245.66666666666666
16300,2012-11-16,4,1,11,22,23,139,162,189.0
16301,2012-11-16,4,1,11,23,14,114,128,156.0
16302,2012-11-17,4,1,11,0,11,95,106,132.0
16303,2012-11-17,4,1,11,1,13,74,87,107.0
16304,2012-11-17,4,1,11,2,8,41,49,80.66666666666667
16305,2012-11-17,4,1,11,3,2,19,21,52.333333333333336
16306,2012-11-17,4,1,11,4,1,6,7,25.666666666666668
16307,2012-11-17,4,1,11,5,1,10,11,13.0
16308,2012-11-17,4,1,11,6,0,21,21,13.0
16309,2012-11-17,4,1,11,7,8,70,78,36.666666666666664
16310,2012-11-17,4,1,11,8,30,138,168,89.0
16311,2012-11-17,4,1,11,9,48,200,248,164.66666666666666
16312,2012-11-17,4,1,11,10,62,258,320,245.33333333333334
16313,2012-11-17,4,1,11,11,80,343,423,330.3333333333333
16314,2012-11-17,4,1,11,12,117,359,476,406.3333333333333
16315,2012-11-17,4,1,11,13,179,346,525,474.6666666666667
16316,2012-11-17,4,1,11,14,175,380,555,518.6666666666666
16317,2012-11-17,4,1,11,15,175,374,549,543.0
16318,2012-11-17,4,1,11,16,144,325,469,524.3333333333334
16319,2012-11-17,4,1,11,17,101,302,403,473.6666666666667
16320,2012-11-17,4,1,11,18,34,237,271,381.0
16321,2012-11-17,4,1,11,19,45,208,253,309.0
16322,2012-11-17,4,1,11,20,30,142,172,232.0
16323,2012-11-17,4,1,11,21,15,124,139,188.0
16324,2012-11-17,4,1,11,22,15,130,145,152.0
16325,2012-11-17,4,1,11,23,19,114,133,139.0
16326,2012-11-18,4,1,11,0,11,118,129,135.66666666666666
16327,2012-11-18,4,1,11,1,14,81,95,119.0
16328,2012-11-18,4,1,11,2,8,65,73,99.0
16329,2012-11-18,4,1,11,3,9,37,46,71.33333333333333
16330,2012-11-18,4,1,11,4,4,8,12,43.666666666666664
16331,2012-11-18,4,1,11,5,5,7,12,23.333333333333332
16332,2012-11-18,4,1,11,6,2,13,15,13.0
16333,2012-11-18,4,1,11,7,3,39,42,23.0
16334,2012-11-18,4,1,11,8,19,100,119,58.666666666666664
16335,2012-11-18,4,1,11,9,49,155,204,121.66666666666667
16336,2012-11-18,4,1,11,10,79,250,329,217.33333333333334
16337,2012-11-18,4,1,11,11,92,267,359,297.3333333333333
16338,2012-11-18,4,1,11,12,101,341,442,376.6666666666667
16339,2012-11-18,4,1,11,13,113,334,447,416.0
16340,2012-11-18,4,1,11,14,125,303,428,439.0
16341,2012-11-18,4,1,11,15,89,318,407,427.3333333333333
16342,2012-11-18,4,1,11,16,59,313,372,402.3333333333333
16343,2012-11-18,4,1,11,17,48,232,280,353.0
16344,2012-11-18,4,1,11,18,36,240,276,309.3333333333333
16345,2012-11-18,4,1,11,19,16,194,210,255.33333333333334
16346,2012-11-18,4,1,11,20,9,120,129,205.0
16347,2012-11-18,4,1,11,21,17,93,110,149.66666666666666
16348,2012-11-18,4,1,11,22,8,66,74,104.33333333333333
16349,2012-11-18,4,1,11,23,6,53,59,81.0
16350,2012-11-19,4,1,11,0,5,22,27,53.333333333333336
16351,2012-11-19,4,1,11,1,0,19,19,35.0
16352,2012-11-19,4,1,11,2,0,5,5,17.0
16353,2012-11-19,4,1,11,3,0,2,2,8.666666666666666
16354,2012-11-19,4,1,11,4,1,11,12,6.333333333333333
16355,2012-11-19,4,1,11,5,1,38,39,17.666666666666668
16356,2012-11-19,4,1,11,6,3,128,131,60.666666666666664
16357,2012-11-19,4,1,11,7,5,381,386,185.33333333333334
16358,2012-11-19,4,1,11,8,13,650,663,393.3333333333333
16359,2012-11-19,4,1,11,9,18,260,278,442.3333333333333
16360,2012-11-19,4,1,11,10,33,106,139,360.0
16361,2012-11-19,4,1,11,11,33,164,197,204.66666666666666
16362,2012-11-19,4,1,11,12,35,207,242,192.66666666666666
16363,2012-11-19,4,1,11,13,46,205,251,230.0
16364,2012-11-19,4,1,11,14,47,170,217,236.66666666666666
16365,2012-11-19,4,1,11,15,44,213,257,241.66666666666666
16366,2012-11-19,4,1,11,16,55,325,380,284.6666666666667
16367,2012-11-19,4,1,11,17,33,586,619,418.6666666666667
16368,2012-11-19,4,1,11,18,21,559,580,526.3333333333334
16369,2012-11-19,4,1,11,19,25,381,406,535.0
16370,2012-11-19,4,1,11,20,7,252,259,415.0
16371,2012-11-19,4,1,11,21,15,188,203,289.3333333333333
16372,2012-11-19,4,1,11,22,7,106,113,191.66666666666666
16373,2012-11-19,4,1,11,23,2,72,74,130.0
16374,2012-11-20,4,1,11,0,3,26,29,72.0
16375,2012-11-20,4,1,11,1,3,10,13,38.666666666666664
16376,2012-11-20,4,1,11,2,0,5,5,15.666666666666666
16377,2012-11-20,4,1,11,3,0,2,2,6.666666666666667
16378,2012-11-20,4,1,11,4,0,6,6,4.333333333333333
16379,2012-11-20,4,1,11,5,2,32,34,14.0
16380,2012-11-20,4,1,11,6,2,146,148,62.666666666666664
16381,2012-11-20,4,1,11,7,7,411,418,200.0
16382,2012-11-20,4,1,11,8,16,649,665,410.3333333333333
16383,2012-11-20,4,1,11,9,28,298,326,469.6666666666667
16384,2012-11-20,4,1,11,10,32,144,176,389.0
16385,2012-11-20,4,1,11,11,45,160,205,235.66666666666666
16386,2012-11-20,4,1,11,12,70,243,313,231.33333333333334
16387,2012-11-20,4,1,11,13,49,218,267,261.6666666666667
16388,2012-11-20,4,1,11,14,47,177,224,268.0
16389,2012-11-20,4,1,11,15,61,226,287,259.3333333333333
16390,2012-11-20,4,1,11,16,60,335,395,302.0
16391,2012-11-20,4,1,11,17,37,553,590,424.0
16392,2012-11-20,4,1,11,18,16,534,550,511.6666666666667
16393,2012-11-20,4,1,11,19,23,361,384,508.0
16394,2012-11-20,4,1,11,20,11,224,235,389.6666666666667
16395,2012-11-20,4,1,11,21,14,143,157,258.6666666666667
16396,2012-11-20,4,1,11,22,7,115,122,171.33333333333334
16397,2012-11-20,4,1,11,23,1,82,83,120.66666666666667
16398,2012-11-21,4,1,11,0,1,25,26,77.0
16399,2012-11-21,4,1,11,1,1,13,14,41.0
16400,2012-11-21,4,1,11,2,2,6,8,16.0
16401,2012-11-21,4,1,11,3,0,2,2,8.0
16402,2012-11-21,4,1,11,4,0,10,10,6.666666666666667
16403,2012-11-21,4,1,11,5,1,28,29,13.666666666666666
16404,2012-11-21,4,1,11,6,2,99,101,46.666666666666664
16405,2012-11-21,4,1,11,7,11,262,273,134.33333333333334
16406,2012-11-21,4,1,11,8,12,539,551,308.3333333333333
16407,2012-11-21,4,1,11,9,45,320,365,396.3333333333333
16408,2012-11-21,4,1,11,10,22,150,172,362.6666666666667
16409,2012-11-21,4,1,11,11,43,198,241,259.3333333333333
16410,2012-11-21,4,1,11,12,74,270,344,252.33333333333334
16411,2012-11-21,4,1,11,13,70,295,365,316.6666666666667
16412,2012-11-21,4,1,11,14,84,329,413,374.0
16413,2012-11-21,4,1,11,15,68,381,449,409.0
16414,2012-11-21,4,1,11,16,59,410,469,443.6666666666667
16415,2012-11-21,4,1,11,17,41,333,374,430.6666666666667
16416,2012-11-21,4,1,11,18,24,287,311,384.6666666666667
16417,2012-11-21,4,1,11,19,23,220,243,309.3333333333333
16418,2012-11-21,4,1,11,20,11,125,136,230.0
16419,2012-11-21,4,1,11,21,8,97,105,161.33333333333334
16420,2012-11-21,4,1,11,22,6,82,88,109.66666666666667
16421,2012-11-21,4,1,11,23,7,50,57,83.33333333333333
16422,2012-11-22,4,1,11,0,3,43,46,63.666666666666664
16423,2012-11-22,4,1,11,1,5,37,42,48.333333333333336
16424,2012-11-22,4,1,11,2,3,15,18,35.333333333333336
16425,2012-11-22,4,1,11,3,0,6,6,22.0
16426,2012-11-22,4,1,11,4,1,2,3,9.0
16427,2012-11-22,4,1,11,5,2,6,8,5.666666666666667
16428,2012-11-22,4,1,11,6,2,15,17,9.333333333333334
16429,2012-11-22,4,1,11,7,7,49,56,27.0
16430,2012-11-22,4,1,11,8,20,77,97,56.666666666666664
16431,2012-11-22,4,1,11,9,25,94,119,90.66666666666667
16432,2012-11-22,4,1,11,10,65,154,219,145.0
16433,2012-11-22,4,1,11,11,89,143,232,190.0
16434,2012-11-22,4,1,11,12,117,145,262,237.66666666666666
16435,2012-11-22,4,1,11,13,125,144,269,254.33333333333334
16436,2012-11-22,4,1,11,14,125,95,220,250.33333333333334
16437,2012-11-22,4,1,11,15,132,96,228,239.0
16438,2012-11-22,4,1,11,16,101,81,182,210.0
16439,2012-11-22,4,1,11,17,66,43,109,173.0
16440,2012-11-22,4,1,11,18,16,54,70,120.33333333333333
16441,2012-11-22,4,1,11,19,13,31,44,74.33333333333333
16442,2012-11-22,4,1,11,20,15,37,52,55.333333333333336
16443,2012-11-22,4,1,11,21,7,39,46,47.333333333333336
16444,2012-11-22,4,1,11,22,8,36,44,47.333333333333336
16445,2012-11-22,4,1,11,23,8,28,36,42.0
16446,2012-11-23,4,1,11,0,0,32,32,37.333333333333336
16447,2012-11-23,4,1,11,1,2,11,13,27.0
16448,2012-11-23,4,1,11,2,1,4,5,16.666666666666668
16449,2012-11-23,4,1,11,3,1,0,1,6.333333333333333
16450,2012-11-23,4,1,11,4,1,3,4,3.3333333333333335
16451,2012-11-23,4,1,11,5,0,10,10,5.0
16452,2012-11-23,4,1,11,6,0,20,20,11.333333333333334
16453,2012-11-23,4,1,11,7,5,72,77,35.666666666666664
16454,2012-11-23,4,1,11,8,11,83,94,63.666666666666664
16455,2012-11-23,4,1,11,9,32,80,112,94.33333333333333
16456,2012-11-23,4,1,11,10,87,114,201,135.66666666666666
16457,2012-11-23,4,1,11,11,121,130,251,188.0
16458,2012-11-23,4,1,11,12,186,193,379,277.0
16459,2012-11-23,4,1,11,13,224,200,424,351.3333333333333
16460,2012-11-23,4,1,11,14,240,195,435,412.6666666666667
16461,2012-11-23,4,1,11,15,233,214,447,435.3333333333333
16462,2012-11-23,4,1,11,16,158,199,357,413.0
16463,2012-11-23,4,1,11,17,117,183,300,368.0
16464,2012-11-23,4,1,11,18,50,158,208,288.3333333333333
16465,2012-11-23,4,1,11,19,33,121,154,220.66666666666666
16466,2012-11-23,4,1,11,20,42,100,142,168.0
16467,2012-11-23,4,1,11,21,23,75,98,131.33333333333334
16468,2012-11-23,4,1,11,22,16,63,79,106.33333333333333
16469,2012-11-23,4,1,11,23,20,47,67,81.33333333333333
16470,2012-11-24,4,1,11,0,9,33,42,62.666666666666664
16471,2012-11-24,4,1,11,1,1,19,20,43.0
16472,2012-11-24,4,1,11,2,10,22,32,31.333333333333332
16473,2012-11-24,4,1,11,3,6,5,11,21.0
16474,2012-11-24,4,1,11,4,1,2,3,15.333333333333334
16475,2012-11-24,4,1,11,5,1,2,3,5.666666666666667
16476,2012-11-24,4,1,11,6,1,9,10,5.333333333333333
16477,2012-11-24,4,1,11,7,4,21,25,12.666666666666666
16478,2012-11-24,4,1,11,8,7,55,62,32.333333333333336
16479,2012-11-24,4,1,11,9,26,96,122,69.66666666666667
16480,2012-11-24,4,1,11,10,46,96,142,108.66666666666667
16481,2012-11-24,4,1,11,11,55,131,186,150.0
16482,2012-11-24,4,1,11,12,53,146,199,175.66666666666666
16483,2012-11-24,4,1,11,13,64,161,225,203.33333333333334
16484,2012-11-24,4,1,11,14,58,149,207,210.33333333333334
16485,2012-11-24,4,1,11,15,59,139,198,210.0
16486,2012-11-24,4,1,11,16,43,127,170,191.66666666666666
16487,2012-11-24,4,1,11,17,29,97,126,164.66666666666666
16488,2012-11-24,4,1,11,18,22,123,145,147.0
16489,2012-11-24,4,1,11,19,9,74,83,118.0
16490,2012-11-24,4,1,11,20,3,55,58,95.33333333333333
16491,2012-11-24,4,1,11,21,9,66,75,72.0
16492,2012-11-24,4,1,11,22,7,69,76,69.66666666666667
16493,2012-11-24,4,1,11,23,9,48,57,69.33333333333333
16494,2012-11-25,4,1,11,0,3,31,34,55.666666666666664
16495,2012-11-25,4,1,11,1,4,32,36,42.333333333333336
16496,2012-11-25,4,1,11,2,1,27,28,32.666666666666664
16497,2012-11-25,4,1,11,3,0,8,8,24.0
16498,2012-11-25,4,1,11,4,1,1,2,12.666666666666666
16499,2012-11-25,4,1,11,5,0,3,3,4.333333333333333
16500,2012-11-25,4,1,11,6,1,10,11,5.333333333333333
16501,2012-11-25,4,1,11,7,2,19,21,11.666666666666666
16502,2012-11-25,4,1,11,8,2,32,34,22.0
16503,2012-11-25,4,1,11,9,13,83,96,50.333333333333336
16504,2012-11-25,4,1,11,10,15,124,139,89.66666666666667
16505,2012-11-25,4,1,11,11,49,155,204,146.33333333333334
16506,2012-11-25,4,1,11,12,37,165,202,181.66666666666666
16507,2012-11-25,4,1,11,13,37,158,195,200.33333333333334
16508,2012-11-25,4,1,11,14,33,170,203,200.0
16509,2012-11-25,4,1,11,15,36,209,245,214.33333333333334
16510,2012-11-25,4,1,11,16,25,203,228,225.33333333333334
16511,2012-11-25,4,1,11,17,11,170,181,218.0
16512,2012-11-25,4,1,11,18,9,132,141,183.33333333333334
16513,2012-11-25,4,1,11,19,13,114,127,149.66666666666666
16514,2012-11-25,4,1,11,20,9,110,119,129.0
16515,2012-11-25,4,1,11,21,4,60,64,103.33333333333333
16516,2012-11-25,4,1,11,22,3,59,62,81.66666666666667
16517,2012-11-25,4,1,11,23,1,40,41,55.666666666666664
16518,2012-11-26,4,1,11,0,4,19,23,42.0
16519,2012-11-26,4,1,11,1,1,9,10,24.666666666666668
16520,2012-11-26,4,1,11,2,0,5,5,12.666666666666666
16521,2012-11-26,4,1,11,3,1,4,5,6.666666666666667
16522,2012-11-26,4,1,11,4,0,10,10,6.666666666666667
16523,2012-11-26,4,1,11,5,0,41,41,18.666666666666668
16524,2012-11-26,4,1,11,6,1,123,124,58.333333333333336
16525,2012-11-26,4,1,11,7,2,363,365,176.66666666666666
16526,2012-11-26,4,1,11,8,9,629,638,375.6666666666667
16527,2012-11-26,4,1,11,9,10,276,286,429.6666666666667
16528,2012-11-26,4,1,11,10,20,127,147,357.0
16529,2012-11-26,4,1,11,11,18,112,130,187.66666666666666
16530,2012-11-26,4,1,11,12,22,188,210,162.33333333333334
16531,2012-11-26,4,1,11,13,20,197,217,185.66666666666666
16532,2012-11-26,4,1,11,14,51,177,228,218.33333333333334
16533,2012-11-26,4,1,11,15,49,181,230,225.0
16534,2012-11-26,4,1,11,16,49,297,346,268.0
16535,2012-11-26,4,1,11,17,13,540,553,376.3333333333333
16536,2012-11-26,4,1,11,18,19,502,521,473.3333333333333
16537,2012-11-26,4,1,11,19,16,355,371,481.6666666666667
16538,2012-11-26,4,1,11,20,12,265,277,389.6666666666667
16539,2012-11-26,4,1,11,21,9,172,181,276.3333333333333
16540,2012-11-26,4,1,11,22,3,101,104,187.33333333333334
16541,2012-11-26,4,1,11,23,8,57,65,116.66666666666667
16542,2012-11-27,4,1,11,0,2,24,26,65.0
16543,2012-11-27,4,1,11,1,0,6,6,32.333333333333336
16544,2012-11-27,4,1,11,2,0,5,5,12.333333333333334
16545,2012-11-27,4,1,11,3,1,3,4,5.0
16546,2012-11-27,4,1,11,4,0,5,5,4.666666666666667
16547,2012-11-27,4,1,11,5,0,31,31,13.333333333333334
16548,2012-11-27,4,1,11,6,3,97,100,45.333333333333336
16549,2012-11-27,4,1,11,7,4,289,293,141.33333333333334
16550,2012-11-27,4,1,11,8,6,494,500,297.6666666666667
16551,2012-11-27,4,1,11,9,11,257,268,353.6666666666667
16552,2012-11-27,4,1,11,10,5,52,57,275.0
16553,2012-11-27,4,1,11,11,6,59,65,130.0
16554,2012-11-27,4,1,11,12,6,70,76,66.0
16555,2012-11-27,4,1,11,13,4,73,77,72.66666666666667
16556,2012-11-27,4,1,11,14,8,86,94,82.33333333333333
16557,2012-11-27,4,1,11,15,9,146,155,108.66666666666667
16558,2012-11-27,4,1,11,16,5,252,257,168.66666666666666
16559,2012-11-27,4,1,11,17,13,514,527,313.0
16560,2012-11-27,4,1,11,18,13,469,482,422.0
16561,2012-11-27,4,1,11,19,12,338,350,453.0
16562,2012-11-27,4,1,11,20,4,228,232,354.6666666666667
16563,2012-11-27,4,1,11,21,6,179,185,255.66666666666666
16564,2012-11-27,4,1,11,22,2,95,97,171.33333333333334
16565,2012-11-27,4,1,11,23,3,64,67,116.33333333333333
16566,2012-11-28,4,1,11,0,1,22,23,62.333333333333336
16567,2012-11-28,4,1,11,1,0,12,12,34.0
16568,2012-11-28,4,1,11,2,0,1,1,12.0
16569,2012-11-28,4,1,11,3,0,3,3,5.333333333333333
16570,2012-11-28,4,1,11,4,0,4,4,2.6666666666666665
16571,2012-11-28,4,1,11,5,0,39,39,15.333333333333334
16572,2012-11-28,4,1,11,6,4,132,136,59.666666666666664
16573,2012-11-28,4,1,11,7,6,403,409,194.66666666666666
16574,2012-11-28,4,1,11,8,9,683,692,412.3333333333333
16575,2012-11-28,4,1,11,9,13,309,322,474.3333333333333
16576,2012-11-28,4,1,11,10,17,144,161,391.6666666666667
16577,2012-11-28,4,1,11,11,19,127,146,209.66666666666666
16578,2012-11-28,4,1,11,12,19,189,208,171.66666666666666
16579,2012-11-28,4,1,11,13,21,193,214,189.33333333333334
16580,2012-11-28,4,1,11,14,15,161,176,199.33333333333334
16581,2012-11-28,4,1,11,15,7,172,179,189.66666666666666
16582,2012-11-28,4,1,11,16,9,316,325,226.66666666666666
16583,2012-11-28,4,1,11,17,17,546,563,355.6666666666667
16584,2012-11-28,4,1,11,18,12,530,542,476.6666666666667
16585,2012-11-28,4,1,11,19,9,378,387,497.3333333333333
16586,2012-11-28,4,1,11,20,5,258,263,397.3333333333333
16587,2012-11-28,4,1,11,21,4,219,223,291.0
16588,2012-11-28,4,1,11,22,6,148,154,213.33333333333334
16589,2012-11-28,4,1,11,23,5,73,78,151.66666666666666
16590,2012-11-29,4,1,11,0,4,25,29,87.0
16591,2012-11-29,4,1,11,1,1,15,16,41.0
16592,2012-11-29,4,1,11,2,1,6,7,17.333333333333332
16593,2012-11-29,4,1,11,4,0,7,7,10.0
16594,2012-11-29,4,1,11,5,0,42,42,18.666666666666668
16595,2012-11-29,4,1,11,6,1,120,121,56.666666666666664
16596,2012-11-29,4,1,11,7,8,354,362,175.0
16597,2012-11-29,4,1,11,8,15,664,679,387.3333333333333
16598,2012-11-29,4,1,11,9,13,286,299,446.6666666666667
16599,2012-11-29,4,1,11,10,25,153,178,385.3333333333333
16600,2012-11-29,4,1,11,11,13,150,163,213.33333333333334
16601,2012-11-29,4,1,11,12,11,225,236,192.33333333333334
16602,2012-11-29,4,1,11,13,15,209,224,207.66666666666666
16603,2012-11-29,4,1,11,14,13,174,187,215.66666666666666
16604,2012-11-29,4,1,11,15,19,201,220,210.33333333333334
16605,2012-11-29,4,1,11,16,24,346,370,259.0
16606,2012-11-29,4,1,11,17,17,544,561,383.6666666666667
16607,2012-11-29,4,1,11,18,17,520,537,489.3333333333333
16608,2012-11-29,4,1,11,19,18,326,344,480.6666666666667
16609,2012-11-29,4,1,11,20,11,241,252,377.6666666666667
16610,2012-11-29,4,1,11,21,7,201,208,268.0
16611,2012-11-29,4,1,11,22,4,147,151,203.66666666666666
16612,2012-11-29,4,1,11,23,6,124,130,163.0
16613,2012-11-30,4,1,11,0,4,48,52,111.0
16614,2012-11-30,4,1,11,1,2,17,19,67.0
16615,2012-11-30,4,1,11,2,2,10,12,27.666666666666668
16616,2012-11-30,4,1,11,3,0,4,4,11.666666666666666
16617,2012-11-30,4,1,11,4,0,3,3,6.333333333333333
16618,2012-11-30,4,1,11,5,1,39,40,15.666666666666666
16619,2012-11-30,4,1,11,6,2,104,106,49.666666666666664
16620,2012-11-30,4,1,11,7,6,346,352,166.0
16621,2012-11-30,4,1,11,8,20,709,729,395.6666666666667
16622,2012-11-30,4,1,11,9,17,313,330,470.3333333333333
16623,2012-11-30,4,1,11,10,10,159,169,409.3333333333333
16624,2012-11-30,4,1,11,11,31,170,201,233.33333333333334
16625,2012-11-30,4,1,11,12,25,243,268,212.66666666666666
16626,2012-11-30,4,1,11,13,21,241,262,243.66666666666666
16627,2012-11-30,4,1,11,14,26,225,251,260.3333333333333
16628,2012-11-30,4,1,11,15,34,262,296,269.6666666666667
16629,2012-11-30,4,1,11,16,37,368,405,317.3333333333333
16630,2012-11-30,4,1,11,17,31,551,582,427.6666666666667
16631,2012-11-30,4,1,11,18,20,489,509,498.6666666666667
16632,2012-11-30,4,1,11,19,18,359,377,489.3333333333333
16633,2012-11-30,4,1,11,20,12,233,245,377.0
16634,2012-11-30,4,1,11,21,14,169,183,268.3333333333333
16635,2012-11-30,4,1,11,22,18,145,163,197.0
16636,2012-11-30,4,1,11,23,11,99,110,152.0
16637,2012-12-01,4,1,12,0,9,99,108,127.0
16638,2012-12-01,4,1,12,1,5,64,69,95.66666666666667
16639,2012-12-01,4,1,12,2,3,47,50,75.66666666666667
16640,2012-12-01,4,1,12,3,1,14,15,44.666666666666664
16641,2012-12-01,4,1,12,4,0,5,5,23.333333333333332
16642,2012-12-01,4,1,12,5,1,12,13,11.0
16643,2012-12-01,4,1,12,6,7,20,27,15.0
16644,2012-12-01,4,1,12,7,7,56,63,34.333333333333336
16645,2012-12-01,4,1,12,8,11,133,144,78.0
16646,2012-12-01,4,1,12,9,34,159,193,133.33333333333334
16647,2012-12-01,4,1,12,10,45,211,256,197.66666666666666
16648,2012-12-01,4,1,12,11,74,318,392,280.3333333333333
16649,2012-12-01,4,1,12,12,119,327,446,364.6666666666667
16650,2012-12-01,4,1,12,13,123,386,509,449.0
16651,2012-12-01,4,1,12,14,110,369,479,478.0
16652,2012-12-01,4,1,12,15,113,371,484,490.6666666666667
16653,2012-12-01,4,1,12,16,89,354,443,468.6666666666667
16654,2012-12-01,4,1,12,17,50,270,320,415.6666666666667
16655,2012-12-01,4,1,12,18,42,255,297,353.3333333333333
16656,2012-12-01,4,1,12,19,30,219,249,288.6666666666667
16657,2012-12-01,4,1,12,20,28,170,198,248.0
16658,2012-12-01,4,1,12,21,23,135,158,201.66666666666666
16659,2012-12-01,4,1,12,22,17,130,147,167.66666666666666
16660,2012-12-01,4,1,12,23,10,116,126,143.66666666666666
16661,2012-12-02,4,1,12,0,9,108,117,130.0
16662,2012-12-02,4,1,12,1,10,84,94,112.33333333333333
16663,2012-12-02,4,1,12,2,2,72,74,95.0
16664,2012-12-02,4,1,12,3,4,21,25,64.33333333333333
16665,2012-12-02,4,1,12,4,1,6,7,35.333333333333336
16666,2012-12-02,4,1,12,5,1,7,8,13.333333333333334
16667,2012-12-02,4,1,12,6,1,15,16,10.333333333333334
16668,2012-12-02,4,1,12,7,5,26,31,18.333333333333332
16669,2012-12-02,4,1,12,8,12,81,93,46.666666666666664
16670,2012-12-02,4,1,12,9,37,135,172,98.66666666666667
16671,2012-12-02,4,1,12,10,63,230,293,186.0
16672,2012-12-02,4,1,12,11,81,274,355,273.3333333333333
16673,2012-12-02,4,1,12,12,111,409,520,389.3333333333333
16674,2012-12-02,4,1,12,13,84,347,431,435.3333333333333
16675,2012-12-02,4,1,12,14,142,331,473,474.6666666666667
16676,2012-12-02,4,1,12,15,106,311,417,440.3333333333333
16677,2012-12-02,4,1,12,16,85,358,443,444.3333333333333
16678,2012-12-02,4,1,12,17,59,244,303,387.6666666666667
16679,2012-12-02,4,1,12,18,25,178,203,316.3333333333333
16680,2012-12-02,4,1,12,19,16,158,174,226.66666666666666
16681,2012-12-02,4,1,12,20,12,142,154,177.0
16682,2012-12-02,4,1,12,21,8,91,99,142.33333333333334
16683,2012-12-02,4,1,12,22,11,85,96,116.33333333333333
16684,2012-12-02,4,1,12,23,7,44,51,82.0
16685,2012-12-03,4,1,12,0,3,18,21,56.0
16686,2012-12-03,4,1,12,1,2,11,13,28.333333333333332
16687,2012-12-03,4,1,12,2,1,9,10,14.666666666666666
16688,2012-12-03,4,1,12,3,2,6,8,10.333333333333334
16689,2012-12-03,4,1,12,4,1,4,5,7.666666666666667
16690,2012-12-03,4,1,12,5,0,38,38,17.0
16691,2012-12-03,4,1,12,6,2,136,138,60.333333333333336
16692,2012-12-03,4,1,12,7,9,387,396,190.66666666666666
16693,2012-12-03,4,1,12,8,19,712,731,421.6666666666667
16694,2012-12-03,4,1,12,9,19,289,308,478.3333333333333
16695,2012-12-03,4,1,12,10,31,105,136,391.6666666666667
16696,2012-12-03,4,1,12,11,51,182,233,225.66666666666666
16697,2012-12-03,4,1,12,12,40,228,268,212.33333333333334
16698,2012-12-03,4,1,12,13,81,240,321,274.0
16699,2012-12-03,4,1,12,14,51,209,260,283.0
16700,2012-12-03,4,1,12,15,58,210,268,283.0
16701,2012-12-03,4,1,12,16,45,397,442,323.3333333333333
16702,2012-12-03,4,1,12,17,43,665,708,472.6666666666667
16703,2012-12-03,4,1,12,18,26,666,692,614.0
16704,2012-12-03,4,1,12,19,27,444,471,623.6666666666666
16705,2012-12-03,4,1,12,20,16,284,300,487.6666666666667
16706,2012-12-03,4,1,12,21,14,207,221,330.6666666666667
16707,2012-12-03,4,1,12,22,5,139,144,221.66666666666666
16708,2012-12-03,4,1,12,23,9,93,102,155.66666666666666
16709,2012-12-04,4,1,12,0,6,49,55,100.33333333333333
16710,2012-12-04,4,1,12,1,3,22,25,60.666666666666664
16711,2012-12-04,4,1,12,2,3,5,8,29.333333333333332
16712,2012-12-04,4,1,12,3,1,3,4,12.333333333333334
16713,2012-12-04,4,1,12,4,0,7,7,6.333333333333333
16714,2012-12-04,4,1,12,5,1,45,46,19.0
16715,2012-12-04,4,1,12,6,3,150,153,68.66666666666667
16716,2012-12-04,4,1,12,7,7,495,502,233.66666666666666
16717,2012-12-04,4,1,12,8,21,700,721,458.6666666666667
16718,2012-12-04,4,1,12,9,19,317,336,519.6666666666666
16719,2012-12-04,4,1,12,10,26,130,156,404.3333333333333
16720,2012-12-04,4,1,12,11,24,183,207,233.0
16721,2012-12-04,4,1,12,12,39,273,312,225.0
16722,2012-12-04,4,1,12,13,39,233,272,263.6666666666667
16723,2012-12-04,4,1,12,14,39,231,270,284.6666666666667
16724,2012-12-04,4,1,12,15,56,244,300,280.6666666666667
16725,2012-12-04,4,1,12,16,44,391,435,335.0
16726,2012-12-04,4,1,12,17,43,700,743,492.6666666666667
16727,2012-12-04,4,1,12,18,38,693,731,636.3333333333334
16728,2012-12-04,4,1,12,19,46,414,460,644.6666666666666
16729,2012-12-04,4,1,12,20,34,272,306,499.0
16730,2012-12-04,4,1,12,21,28,252,280,348.6666666666667
16731,2012-12-04,4,1,12,22,26,155,181,255.66666666666666
16732,2012-12-04,4,1,12,23,5,91,96,185.66666666666666
16733,2012-12-05,4,1,12,0,6,31,37,104.66666666666667
16734,2012-12-05,4,1,12,1,0,11,11,48.0
16735,2012-12-05,4,1,12,2,2,7,9,19.0
16736,2012-12-05,4,1,12,3,0,7,7,9.0
16737,2012-12-05,4,1,12,4,1,9,10,8.666666666666666
16738,2012-12-05,4,1,12,5,1,48,49,22.0
16739,2012-12-05,4,1,12,6,5,119,124,61.0
16740,2012-12-05,4,1,12,7,9,389,398,190.33333333333334
16741,2012-12-05,4,1,12,8,22,737,759,427.0
16742,2012-12-05,4,1,12,9,26,362,388,515.0
16743,2012-12-05,4,1,12,10,14,127,141,429.3333333333333
16744,2012-12-05,4,1,12,11,11,161,172,233.66666666666666
16745,2012-12-05,4,1,12,12,24,208,232,181.66666666666666
16746,2012-12-05,4,1,12,13,14,200,214,206.0
16747,2012-12-05,4,1,12,14,39,179,218,221.33333333333334
16748,2012-12-05,4,1,12,15,20,265,285,239.0
16749,2012-12-05,4,1,12,16,23,354,377,293.3333333333333
16750,2012-12-05,4,1,12,17,29,576,605,422.3333333333333
16751,2012-12-05,4,1,12,18,29,580,609,530.3333333333334
16752,2012-12-05,4,1,12,19,14,400,414,542.6666666666666
16753,2012-12-05,4,1,12,20,19,274,293,438.6666666666667
16754,2012-12-05,4,1,12,21,14,184,198,301.6666666666667
16755,2012-12-05,4,1,12,22,4,101,105,198.66666666666666
16756,2012-12-05,4,1,12,23,5,69,74,125.66666666666667
16757,2012-12-06,4,1,12,0,1,43,44,74.33333333333333
16758,2012-12-06,4,1,12,1,0,16,16,44.666666666666664
16759,2012-12-06,4,1,12,2,0,9,9,23.0
16760,2012-12-06,4,1,12,3,0,2,2,9.0
16761,2012-12-06,4,1,12,4,1,8,9,6.666666666666667
16762,2012-12-06,4,1,12,5,0,32,32,14.333333333333334
16763,2012-12-06,4,1,12,6,2,122,124,55.0
16764,2012-12-06,4,1,12,7,8,381,389,181.66666666666666
16765,2012-12-06,4,1,12,8,13,646,659,390.6666666666667
16766,2012-12-06,4,1,12,9,19,257,276,441.3333333333333
16767,2012-12-06,4,1,12,10,23,122,145,360.0
16768,2012-12-06,4,1,12,11,16,162,178,199.66666666666666
16769,2012-12-06,4,1,12,12,29,206,235,186.0
16770,2012-12-06,4,1,12,13,33,212,245,219.33333333333334
16771,2012-12-06,4,1,12,14,37,175,212,230.66666666666666
16772,2012-12-06,4,1,12,15,38,232,270,242.33333333333334
16773,2012-12-06,4,1,12,16,39,292,331,271.0
16774,2012-12-06,4,1,12,17,31,586,617,406.0
16775,2012-12-06,4,1,12,18,23,542,565,504.3333333333333
16776,2012-12-06,4,1,12,19,13,360,373,518.3333333333334
16777,2012-12-06,4,1,12,20,5,222,227,388.3333333333333
16778,2012-12-06,4,1,12,21,7,184,191,263.6666666666667
16779,2012-12-06,4,1,12,22,2,131,133,183.66666666666666
16780,2012-12-06,4,1,12,23,0,93,93,139.0
16781,2012-12-07,4,1,12,0,3,45,48,91.33333333333333
16782,2012-12-07,4,1,12,1,2,26,28,56.333333333333336
16783,2012-12-07,4,1,12,2,0,11,11,29.0
16784,2012-12-07,4,1,12,3,0,5,5,14.666666666666666
16785,2012-12-07,4,1,12,4,0,10,10,8.666666666666666
16786,2012-12-07,4,1,12,5,1,25,26,13.666666666666666
16787,2012-12-07,4,1,12,6,0,84,84,40.0
16788,2012-12-07,4,1,12,7,3,212,215,108.33333333333333
16789,2012-12-07,4,1,12,8,11,430,441,246.66666666666666
16790,2012-12-07,4,1,12,9,10,291,301,319.0
16791,2012-12-07,4,1,12,10,16,150,166,302.6666666666667
16792,2012-12-07,4,1,12,11,20,183,203,223.33333333333334
16793,2012-12-07,4,1,12,12,36,204,240,203.0
16794,2012-12-07,4,1,12,13,23,197,220,221.0
16795,2012-12-07,4,1,12,14,40,175,215,225.0
16796,2012-12-07,4,1,12,15,34,269,303,246.0
16797,2012-12-07,4,1,12,16,39,336,375,297.6666666666667
16798,2012-12-07,4,1,12,17,29,539,568,415.3333333333333
16799,2012-12-07,4,1,12,18,25,473,498,480.3333333333333
16800,2012-12-07,4,1,12,19,15,337,352,472.6666666666667
16801,2012-12-07,4,1,12,20,12,229,241,363.6666666666667
16802,2012-12-07,4,1,12,21,9,162,171,254.66666666666666
16803,2012-12-07,4,1,12,22,15,150,165,192.33333333333334
16804,2012-12-07,4,1,12,23,6,116,122,152.66666666666666
16805,2012-12-08,4,1,12,0,5,98,103,130.0
16806,2012-12-08,4,1,12,1,16,84,100,108.33333333333333
16807,2012-12-08,4,1,12,2,3,67,70,91.0
16808,2012-12-08,4,1,12,3,6,23,29,66.33333333333333
16809,2012-12-08,4,1,12,4,3,9,12,37.0
16810,2012-12-08,4,1,12,5,2,4,6,15.666666666666666
16811,2012-12-08,4,1,12,6,1,19,20,12.666666666666666
16812,2012-12-08,4,1,12,7,3,36,39,21.666666666666668
16813,2012-12-08,4,1,12,8,5,106,111,56.666666666666664
16814,2012-12-08,4,1,12,9,17,153,170,106.66666666666667
16815,2012-12-08,4,1,12,10,43,244,287,189.33333333333334
16816,2012-12-08,4,1,12,11,63,341,404,287.0
16817,2012-12-08,4,1,12,12,122,364,486,392.3333333333333
16818,2012-12-08,4,1,12,13,148,399,547,479.0
16819,2012-12-08,4,1,12,14,164,378,542,525.0
16820,2012-12-08,4,1,12,15,167,374,541,543.3333333333334
16821,2012-12-08,4,1,12,16,139,368,507,530.0
16822,2012-12-08,4,1,12,17,77,268,345,464.3333333333333
16823,2012-12-08,4,1,12,18,40,264,304,385.3333333333333
16824,2012-12-08,4,1,12,19,34,212,246,298.3333333333333
16825,2012-12-08,4,1,12,20,20,162,182,244.0
16826,2012-12-08,4,1,12,21,34,175,209,212.33333333333334
16827,2012-12-08,4,1,12,22,23,137,160,183.66666666666666
16828,2012-12-08,4,1,12,23,18,144,162,177.0
16829,2012-12-09,4,1,12,0,15,103,118,146.66666666666666
16830,2012-12-09,4,1,12,1,17,85,102,127.33333333333333
16831,2012-12-09,4,1,12,2,8,70,78,99.33333333333333
16832,2012-12-09,4,1,12,3,14,34,48,76.0
16833,2012-12-09,4,1,12,4,1,11,12,46.0
16834,2012-12-09,4,1,12,5,0,8,8,22.666666666666668
16835,2012-12-09,4,1,12,6,0,6,6,8.666666666666666
16836,2012-12-09,4,1,12,7,1,22,23,12.333333333333334
16837,2012-12-09,4,1,12,8,1,68,69,32.666666666666664
16838,2012-12-09,4,1,12,9,9,94,103,65.0
16839,2012-12-09,4,1,12,10,39,180,219,130.33333333333334
16840,2012-12-09,4,1,12,11,40,210,250,190.66666666666666
16841,2012-12-09,4,1,12,12,60,255,315,261.3333333333333
16842,2012-12-09,4,1,12,13,65,220,285,283.3333333333333
16843,2012-12-09,4,1,12,14,42,190,232,277.3333333333333
16844,2012-12-09,4,1,12,15,25,200,225,247.33333333333334
16845,2012-12-09,4,1,12,16,33,220,253,236.66666666666666
16846,2012-12-09,4,1,12,17,20,209,229,235.66666666666666
16847,2012-12-09,4,1,12,18,17,181,198,226.66666666666666
16848,2012-12-09,4,1,12,19,12,110,122,183.0
16849,2012-12-09,4,1,12,20,6,102,108,142.66666666666666
16850,2012-12-09,4,1,12,21,10,86,96,108.66666666666667
16851,2012-12-09,4,1,12,22,3,75,78,94.0
16852,2012-12-09,4,1,12,23,3,48,51,75.0
16853,2012-12-10,4,1,12,0,0,20,20,49.666666666666664
16854,2012-12-10,4,1,12,1,0,4,4,25.0
16855,2012-12-10,4,1,12,2,2,3,5,9.666666666666666
16856,2012-12-10,4,1,12,3,0,4,4,4.333333333333333
16857,2012-12-10,4,1,12,4,3,9,12,7.0
16858,2012-12-10,4,1,12,5,0,27,27,14.333333333333334
16859,2012-12-10,4,1,12,6,2,121,123,54.0
16860,2012-12-10,4,1,12,7,3,291,294,148.0
16861,2012-12-10,4,1,12,8,9,575,584,333.6666666666667
16862,2012-12-10,4,1,12,9,11,273,284,387.3333333333333
16863,2012-12-10,4,1,12,10,12,121,133,333.6666666666667
16864,2012-12-10,4,1,12,11,8,126,134,183.66666666666666
16865,2012-12-10,4,1,12,12,23,150,173,146.66666666666666
16866,2012-12-10,4,1,12,13,30,190,220,175.66666666666666
16867,2012-12-10,4,1,12,14,31,179,210,201.0
16868,2012-12-10,4,1,12,15,29,207,236,222.0
16869,2012-12-10,4,1,12,16,37,308,345,263.6666666666667
16870,2012-12-10,4,1,12,17,38,578,616,399.0
16871,2012-12-10,4,1,12,18,20,544,564,508.3333333333333
16872,2012-12-10,4,1,12,19,18,409,427,535.6666666666666
16873,2012-12-10,4,1,12,20,13,287,300,430.3333333333333
16874,2012-12-10,4,1,12,21,21,224,245,324.0
16875,2012-12-10,4,1,12,22,11,115,126,223.66666666666666
16876,2012-12-10,4,1,12,23,8,76,84,151.66666666666666
16877,2012-12-11,4,1,12,0,2,29,31,80.33333333333333
16878,2012-12-11,4,1,12,1,1,7,8,41.0
16879,2012-12-11,4,1,12,2,0,1,1,13.333333333333334
16880,2012-12-11,4,1,12,3,0,3,3,4.0
16881,2012-12-11,4,1,12,4,0,8,8,4.0
16882,2012-12-11,4,1,12,5,1,40,41,17.333333333333332
16883,2012-12-11,4,1,12,6,0,118,118,55.666666666666664
16884,2012-12-11,4,1,12,7,8,372,380,179.66666666666666
16885,2012-12-11,4,1,12,8,16,708,724,407.3333333333333
16886,2012-12-11,4,1,12,9,12,322,334,479.3333333333333
16887,2012-12-11,4,1,12,10,12,142,154,404.0
16888,2012-12-11,4,1,12,11,28,145,173,220.33333333333334
16889,2012-12-11,4,1,12,12,13,213,226,184.33333333333334
16890,2012-12-11,4,1,12,13,28,226,254,217.66666666666666
16891,2012-12-11,4,1,12,14,19,185,204,228.0
16892,2012-12-11,4,1,12,15,20,250,270,242.66666666666666
16893,2012-12-11,4,1,12,16,24,334,358,277.3333333333333
16894,2012-12-11,4,1,12,17,21,580,601,409.6666666666667
16895,2012-12-11,4,1,12,18,23,523,546,501.6666666666667
16896,2012-12-11,4,1,12,19,21,412,433,526.6666666666666
16897,2012-12-11,4,1,12,20,9,248,257,412.0
16898,2012-12-11,4,1,12,21,14,193,207,299.0
16899,2012-12-11,4,1,12,22,6,100,106,190.0
16900,2012-12-11,4,1,12,23,4,60,64,125.66666666666667
16901,2012-12-12,4,1,12,0,1,33,34,68.0
16902,2012-12-12,4,1,12,1,3,18,21,39.666666666666664
16903,2012-12-12,4,1,12,2,5,4,9,21.333333333333332
16904,2012-12-12,4,1,12,3,3,7,10,13.333333333333334
16905,2012-12-12,4,1,12,4,0,4,4,7.666666666666667
16906,2012-12-12,4,1,12,5,0,37,37,17.0
16907,2012-12-12,4,1,12,6,2,126,128,56.333333333333336
16908,2012-12-12,4,1,12,7,3,366,369,178.0
16909,2012-12-12,4,1,12,8,18,670,688,395.0
16910,2012-12-12,4,1,12,9,13,272,285,447.3333333333333
16911,2012-12-12,4,1,12,10,20,116,136,369.6666666666667
16912,2012-12-12,4,1,12,11,24,148,172,197.66666666666666
16913,2012-12-12,4,1,12,12,14,218,232,180.0
16914,2012-12-12,4,1,12,13,18,220,238,214.0
16915,2012-12-12,4,1,12,14,34,191,225,231.66666666666666
16916,2012-12-12,4,1,12,15,21,207,228,230.33333333333334
16917,2012-12-12,4,1,12,16,19,310,329,260.6666666666667
16918,2012-12-12,4,1,12,17,21,540,561,372.6666666666667
16919,2012-12-12,4,1,12,18,25,515,540,476.6666666666667
16920,2012-12-12,4,1,12,19,18,384,402,501.0
16921,2012-12-12,4,1,12,20,25,243,268,403.3333333333333
16922,2012-12-12,4,1,12,21,16,186,202,290.6666666666667
16923,2012-12-12,4,1,12,22,4,118,122,197.33333333333334
16924,2012-12-12,4,1,12,23,3,76,79,134.33333333333334
16925,2012-12-13,4,1,12,0,1,31,32,77.66666666666667
16926,2012-12-13,4,1,12,1,4,19,23,44.666666666666664
16927,2012-12-13,4,1,12,2,3,5,8,21.0
16928,2012-12-13,4,1,12,3,0,2,2,11.0
16929,2012-12-13,4,1,12,4,0,8,8,6.0
16930,2012-12-13,4,1,12,5,2,31,33,14.333333333333334
16931,2012-12-13,4,1,12,6,2,112,114,51.666666666666664
16932,2012-12-13,4,1,12,7,5,380,385,177.33333333333334
16933,2012-12-13,4,1,12,8,24,655,679,392.6666666666667
16934,2012-12-13,4,1,12,9,25,300,325,463.0
16935,2012-12-13,4,1,12,10,28,139,167,390.3333333333333
16936,2012-12-13,4,1,12,11,25,164,189,227.0
16937,2012-12-13,4,1,12,12,30,252,282,212.66666666666666
16938,2012-12-13,4,1,12,13,41,230,271,247.33333333333334
16939,2012-12-13,4,1,12,14,31,211,242,265.0
16940,2012-12-13,4,1,12,15,40,240,280,264.3333333333333
16941,2012-12-13,4,1,12,16,50,356,406,309.3333333333333
16942,2012-12-13,4,1,12,17,43,507,550,412.0
16943,2012-12-13,4,1,12,18,20,446,466,474.0
16944,2012-12-13,4,1,12,19,20,328,348,454.6666666666667
16945,2012-12-13,4,1,12,20,6,235,241,351.6666666666667
16946,2012-12-13,4,1,12,21,13,200,213,267.3333333333333
16947,2012-12-13,4,1,12,22,7,141,148,200.66666666666666
16948,2012-12-13,4,1,12,23,5,115,120,160.33333333333334
16949,2012-12-14,4,1,12,0,4,43,47,105.0
16950,2012-12-14,4,1,12,1,0,26,26,64.33333333333333
16951,2012-12-14,4,1,12,2,3,6,9,27.333333333333332
16952,2012-12-14,4,1,12,3,0,12,12,15.666666666666666
16953,2012-12-14,4,1,12,4,1,9,10,10.333333333333334
16954,2012-12-14,4,1,12,5,0,34,34,18.666666666666668
16955,2012-12-14,4,1,12,6,1,112,113,52.333333333333336
16956,2012-12-14,4,1,12,7,3,305,308,151.66666666666666
16957,2012-12-14,4,1,12,8,13,623,636,352.3333333333333
16958,2012-12-14,4,1,12,9,13,330,343,429.0
16959,2012-12-14,4,1,12,10,28,162,190,389.6666666666667
16960,2012-12-14,4,1,12,11,31,180,211,248.0
16961,2012-12-14,4,1,12,12,29,244,273,224.66666666666666
16962,2012-12-14,4,1,12,13,39,274,313,265.6666666666667
16963,2012-12-14,4,1,12,14,48,251,299,295.0
16964,2012-12-14,4,1,12,15,57,252,309,307.0
16965,2012-12-14,4,1,12,16,45,372,417,341.6666666666667
16966,2012-12-14,4,1,12,17,40,582,622,449.3333333333333
16967,2012-12-14,4,1,12,18,23,432,455,498.0
16968,2012-12-14,4,1,12,19,17,302,319,465.3333333333333
16969,2012-12-14,4,1,12,20,12,209,221,331.6666666666667
16970,2012-12-14,4,1,12,21,7,165,172,237.33333333333334
16971,2012-12-14,4,1,12,22,4,134,138,177.0
16972,2012-12-14,4,1,12,23,11,123,134,148.0
16973,2012-12-15,4,1,12,0,4,90,94,122.0
16974,2012-12-15,4,1,12,1,9,86,95,107.66666666666667
16975,2012-12-15,4,1,12,2,6,63,69,86.0
16976,2012-12-15,4,1,12,3,5,18,23,62.333333333333336
16977,2012-12-15,4,1,12,4,1,5,6,32.666666666666664
16978,2012-12-15,4,1,12,5,0,3,3,10.666666666666666
16979,2012-12-15,4,1,12,6,0,11,11,6.666666666666667
16980,2012-12-15,4,1,12,7,1,47,48,20.666666666666668
16981,2012-12-15,4,1,12,8,8,111,119,59.333333333333336
16982,2012-12-15,4,1,12,9,17,203,220,129.0
16983,2012-12-15,4,1,12,10,23,250,273,204.0
16984,2012-12-15,4,1,12,11,66,327,393,295.3333333333333
16985,2012-12-15,4,1,12,12,89,364,453,373.0
16986,2012-12-15,4,1,12,13,88,368,456,434.0
16987,2012-12-15,4,1,12,14,92,334,426,445.0
16988,2012-12-15,4,1,12,15,95,352,447,443.0
16989,2012-12-15,4,1,12,16,85,328,413,428.6666666666667
16990,2012-12-15,4,1,12,17,35,274,309,389.6666666666667
16991,2012-12-15,4,1,12,18,40,232,272,331.3333333333333
16992,2012-12-15,4,1,12,19,32,225,257,279.3333333333333
16993,2012-12-15,4,1,12,20,23,178,201,243.33333333333334
16994,2012-12-15,4,1,12,21,15,169,184,214.0
16995,2012-12-15,4,1,12,22,22,134,156,180.33333333333334
16996,2012-12-15,4,1,12,23,11,108,119,153.0
16997,2012-12-16,4,1,12,0,8,102,110,128.33333333333334
16998,2012-12-16,4,1,12,1,14,82,96,108.33333333333333
16999,2012-12-16,4,1,12,2,8,79,87,97.66666666666667
17000,2012-12-16,4,1,12,3,1,37,38,73.66666666666667
17001,2012-12-16,4,1,12,4,1,10,11,45.333333333333336
17002,2012-12-16,4,1,12,5,0,9,9,19.333333333333332
17003,2012-12-16,4,1,12,6,0,6,6,8.666666666666666
17004,2012-12-16,4,1,12,7,5,22,27,14.0
17005,2012-12-16,4,1,12,8,12,76,88,40.333333333333336
17006,2012-12-16,4,1,12,9,19,113,132,82.33333333333333
17007,2012-12-16,4,1,12,10,42,215,257,159.0
17008,2012-12-16,4,1,12,11,47,248,295,228.0
17009,2012-12-16,4,1,12,12,67,350,417,323.0
17010,2012-12-16,4,1,12,13,67,289,356,356.0
17011,2012-12-16,4,1,12,14,50,260,310,361.0
17012,2012-12-16,4,1,12,15,46,292,338,334.6666666666667
17013,2012-12-16,4,1,12,16,66,334,400,349.3333333333333
17014,2012-12-16,4,1,12,17,29,214,243,327.0
17015,2012-12-16,4,1,12,18,8,99,107,250.0
17016,2012-12-16,4,1,12,19,10,99,109,153.0
17017,2012-12-16,4,1,12,20,14,108,122,112.66666666666667
17018,2012-12-16,4,1,12,21,14,92,106,112.33333333333333
17019,2012-12-16,4,1,12,22,6,83,89,105.66666666666667
17020,2012-12-16,4,1,12,23,4,29,33,76.0
17021,2012-12-17,4,1,12,0,2,26,28,50.0
17022,2012-12-17,4,1,12,1,1,14,15,25.333333333333332
17023,2012-12-17,4,1,12,2,1,4,5,16.0
17024,2012-12-17,4,1,12,3,0,3,3,7.666666666666667
17025,2012-12-17,4,1,12,4,2,3,5,4.333333333333333
17026,2012-12-17,4,1,12,5,0,24,24,10.666666666666666
17027,2012-12-17,4,1,12,6,1,107,108,45.666666666666664
17028,2012-12-17,4,1,12,7,5,314,319,150.33333333333334
17029,2012-12-17,4,1,12,8,10,582,592,339.6666666666667
17030,2012-12-17,4,1,12,9,11,271,282,397.6666666666667
17031,2012-12-17,4,1,12,10,15,120,135,336.3333333333333
17032,2012-12-17,4,1,12,11,22,148,170,195.66666666666666
17033,2012-12-17,4,1,12,12,21,211,232,179.0
17034,2012-12-17,4,1,12,13,16,194,210,204.0
17035,2012-12-17,4,1,12,14,12,169,181,207.66666666666666
17036,2012-12-17,4,1,12,15,15,196,211,200.66666666666666
17037,2012-12-17,4,1,12,16,15,287,302,231.33333333333334
17038,2012-12-17,4,1,12,17,17,478,495,336.0
17039,2012-12-17,4,1,12,18,14,493,507,434.6666666666667
17040,2012-12-17,4,1,12,19,7,333,340,447.3333333333333
17041,2012-12-17,4,1,12,20,8,192,200,349.0
17042,2012-12-17,4,1,12,21,6,114,120,220.0
17043,2012-12-17,4,1,12,22,5,49,54,124.66666666666667
17044,2012-12-17,4,1,12,23,6,41,47,73.66666666666667
17045,2012-12-18,4,1,12,0,0,18,18,39.666666666666664
17046,2012-12-18,4,1,12,1,0,15,15,26.666666666666668
17047,2012-12-18,4,1,12,2,2,5,7,13.333333333333334
17048,2012-12-18,4,1,12,3,0,5,5,9.0
17049,2012-12-18,4,1,12,4,3,5,8,6.666666666666667
17050,2012-12-18,4,1,12,5,0,36,36,16.333333333333332
17051,2012-12-18,4,1,12,6,1,117,118,54.0
17052,2012-12-18,4,1,12,7,4,351,355,169.66666666666666
17053,2012-12-18,4,1,12,8,10,652,662,378.3333333333333
17054,2012-12-18,4,1,12,9,19,307,326,447.6666666666667
17055,2012-12-18,4,1,12,10,22,162,184,390.6666666666667
17056,2012-12-18,4,1,12,11,58,211,269,259.6666666666667
17057,2012-12-18,4,1,12,12,49,264,313,255.33333333333334
17058,2012-12-18,4,1,12,13,51,235,286,289.3333333333333
17059,2012-12-18,4,1,12,14,56,191,247,282.0
17060,2012-12-18,4,1,12,15,28,218,246,259.6666666666667
17061,2012-12-18,4,1,12,16,40,323,363,285.3333333333333
17062,2012-12-18,4,1,12,17,39,533,572,393.6666666666667
17063,2012-12-18,4,1,12,18,13,512,525,486.6666666666667
17064,2012-12-18,4,1,12,19,19,334,353,483.3333333333333
17065,2012-12-18,4,1,12,20,4,264,268,382.0
17066,2012-12-18,4,1,12,21,9,159,168,263.0
17067,2012-12-18,4,1,12,22,5,127,132,189.33333333333334
17068,2012-12-18,4,1,12,23,1,80,81,127.0
17069,2012-12-19,4,1,12,0,6,35,41,84.66666666666667
17070,2012-12-19,4,1,12,1,1,14,15,45.666666666666664
17071,2012-12-19,4,1,12,2,1,2,3,19.666666666666668
17072,2012-12-19,4,1,12,3,0,5,5,7.666666666666667
17073,2012-12-19,4,1,12,4,1,6,7,5.0
17074,2012-12-19,4,1,12,5,2,29,31,14.333333333333334
17075,2012-12-19,4,1,12,6,3,109,112,50.0
17076,2012-12-19,4,1,12,7,3,360,363,168.66666666666666
17077,2012-12-19,4,1,12,8,13,665,678,384.3333333333333
17078,2012-12-19,4,1,12,9,8,309,317,452.6666666666667
17079,2012-12-19,4,1,12,10,17,147,164,386.3333333333333
17080,2012-12-19,4,1,12,11,31,169,200,227.0
17081,2012-12-19,4,1,12,12,33,203,236,200.0
17082,2012-12-19,4,1,12,13,30,183,213,216.33333333333334
17083,2012-12-19,4,1,12,14,33,185,218,222.33333333333334
17084,2012-12-19,4,1,12,15,28,209,237,222.66666666666666
17085,2012-12-19,4,1,12,16,37,297,334,263.0
17086,2012-12-19,4,1,12,17,26,536,562,377.6666666666667
17087,2012-12-19,4,1,12,18,23,546,569,488.3333333333333
17088,2012-12-19,4,1,12,19,7,329,336,489.0
17089,2012-12-19,4,1,12,20,10,231,241,382.0
17090,2012-12-19,4,1,12,21,4,164,168,248.33333333333334
17091,2012-12-19,4,1,12,22,12,117,129,179.33333333333334
17092,2012-12-19,4,1,12,23,4,84,88,128.33333333333334
17093,2012-12-20,4,1,12,0,2,40,42,86.33333333333333
17094,2012-12-20,4,1,12,1,1,19,20,50.0
17095,2012-12-20,4,1,12,2,2,6,8,23.333333333333332
17096,2012-12-20,4,1,12,3,1,3,4,10.666666666666666
17097,2012-12-20,4,1,12,4,0,6,6,6.0
17098,2012-12-20,4,1,12,5,0,35,35,15.0
17099,2012-12-20,4,1,12,6,4,114,118,53.0
17100,2012-12-20,4,1,12,7,4,346,350,167.66666666666666
17101,2012-12-20,4,1,12,8,14,585,599,355.6666666666667
17102,2012-12-20,4,1,12,9,14,303,317,422.0
17103,2012-12-20,4,1,12,10,23,138,161,359.0
17104,2012-12-20,4,1,12,11,22,168,190,222.66666666666666
17105,2012-12-20,4,1,12,12,31,181,212,187.66666666666666
17106,2012-12-20,4,1,12,13,46,171,217,206.33333333333334
17107,2012-12-20,4,1,12,14,43,171,214,214.33333333333334
17108,2012-12-20,4,1,12,15,33,216,249,226.66666666666666
17109,2012-12-20,4,1,12,16,21,281,302,255.0
17110,2012-12-20,4,1,12,17,25,450,475,342.0
17111,2012-12-20,4,1,12,18,22,359,381,386.0
17112,2012-12-20,4,1,12,19,3,115,118,324.6666666666667
17113,2012-12-20,4,1,12,20,1,49,50,183.0
17114,2012-12-20,4,1,12,21,1,25,26,64.66666666666667
17115,2012-12-20,4,1,12,22,1,20,21,32.333333333333336
17116,2012-12-20,4,1,12,23,0,13,13,20.0
17117,2012-12-21,1,1,12,0,0,17,17,17.0
17118,2012-12-21,1,1,12,1,2,7,9,13.0
17119,2012-12-21,1,1,12,2,0,3,3,9.666666666666666
17120,2012-12-21,1,1,12,3,0,3,3,5.0
17121,2012-12-21,1,1,12,4,1,5,6,4.0
17122,2012-12-21,1,1,12,5,0,13,13,7.333333333333333
17123,2012-12-21,1,1,12,6,4,76,80,33.0
17124,2012-12-21,1,1,12,7,3,205,208,100.33333333333333
17125,2012-12-21,1,1,12,8,8,464,472,253.33333333333334
17126,2012-12-21,1,1,12,9,2,265,267,315.6666666666667
17127,2012-12-21,1,1,12,10,8,146,154,297.6666666666667
17128,2012-12-21,1,1,12,11,12,150,162,194.33333333333334
17129,2012-12-21,1,1,12,12,25,199,224,180.0
17130,2012-12-21,1,1,12,13,26,214,240,208.66666666666666
17131,2012-12-21,1,1,12,14,20,199,219,227.66666666666666
17132,2012-12-21,1,1,12,15,29,234,263,240.66666666666666
17133,2012-12-21,1,1,12,16,28,253,281,254.33333333333334
17134,2012-12-21,1,1,12,17,24,297,321,288.3333333333333
17135,2012-12-21,1,1,12,18,7,236,243,281.6666666666667
17136,2012-12-21,1,1,12,19,5,148,153,239.0
17137,2012-12-21,1,1,12,20,8,104,112,169.33333333333334
17138,2012-12-21,1,1,12,21,2,68,70,111.66666666666667
17139,2012-12-21,1,1,12,22,6,57,63,81.66666666666667
17140,2012-12-21,1,1,12,23,1,39,40,57.666666666666664
17141,2012-12-22,1,1,12,0,1,30,31,44.666666666666664
17142,2012-12-22,1,1,12,1,1,34,35,35.333333333333336
17143,2012-12-22,1,1,12,2,0,23,23,29.666666666666668
17144,2012-12-22,1,1,12,3,0,7,7,21.666666666666668
17145,2012-12-22,1,1,12,4,3,2,5,11.666666666666666
17146,2012-12-22,1,1,12,5,0,5,5,5.666666666666667
17147,2012-12-22,1,1,12,6,0,13,13,7.666666666666667
17148,2012-12-22,1,1,12,7,2,18,20,12.666666666666666
17149,2012-12-22,1,1,12,8,0,29,29,20.666666666666668
17150,2012-12-22,1,1,12,9,13,77,90,46.333333333333336
17151,2012-12-22,1,1,12,10,13,105,118,79.0
17152,2012-12-22,1,1,12,11,29,130,159,122.33333333333333
17153,2012-12-22,1,1,12,12,18,128,146,141.0
17154,2012-12-22,1,1,12,13,23,135,158,154.33333333333334
17155,2012-12-22,1,1,12,14,20,141,161,155.0
17156,2012-12-22,1,1,12,15,14,139,153,157.33333333333334
17157,2012-12-22,1,1,12,16,23,124,147,153.66666666666666
17158,2012-12-22,1,1,12,17,15,99,114,138.0
17159,2012-12-22,1,1,12,18,7,75,82,114.33333333333333
17160,2012-12-22,1,1,12,19,9,51,60,85.33333333333333
17161,2012-12-22,1,1,12,20,6,55,61,67.66666666666667
17162,2012-12-22,1,1,12,21,4,49,53,58.0
17163,2012-12-22,1,1,12,22,1,38,39,51.0
17164,2012-12-22,1,1,12,23,3,37,40,44.0
17165,2012-12-23,1,1,12,0,3,24,27,35.333333333333336
17166,2012-12-23,1,1,12,1,1,19,20,29.0
17167,2012-12-23,1,1,12,2,1,17,18,21.666666666666668
17168,2012-12-23,1,1,12,3,0,9,9,15.666666666666666
17169,2012-12-23,1,1,12,4,1,3,4,10.333333333333334
17170,2012-12-23,1,1,12,5,0,6,6,6.333333333333333
17171,2012-12-23,1,1,12,6,4,5,9,6.333333333333333
17172,2012-12-23,1,1,12,7,3,16,19,11.333333333333334
17173,2012-12-23,1,1,12,8,5,43,48,25.333333333333332
17174,2012-12-23,1,1,12,9,7,49,56,41.0
17175,2012-12-23,1,1,12,10,26,67,93,65.66666666666667
17176,2012-12-23,1,1,12,11,48,104,152,100.33333333333333
17177,2012-12-23,1,1,12,12,52,144,196,147.0
17178,2012-12-23,1,1,12,13,63,123,186,178.0
17179,2012-12-23,1,1,12,14,57,118,175,185.66666666666666
17180,2012-12-23,1,1,12,15,39,98,137,166.0
17181,2012-12-23,1,1,12,16,53,137,190,167.33333333333334
17182,2012-12-23,1,1,12,17,21,93,114,147.0
17183,2012-12-23,1,1,12,18,8,85,93,132.33333333333334
17184,2012-12-23,1,1,12,19,4,54,58,88.33333333333333
17185,2012-12-23,1,1,12,20,0,52,52,67.66666666666667
17186,2012-12-23,1,1,12,21,4,38,42,50.666666666666664
17187,2012-12-23,1,1,12,22,5,53,58,50.666666666666664
17188,2012-12-23,1,1,12,23,3,22,25,41.666666666666664
17189,2012-12-24,1,1,12,0,0,12,12,31.666666666666668
17190,2012-12-24,1,1,12,1,0,11,11,16.0
17191,2012-12-24,1,1,12,2,0,5,5,9.333333333333334
17192,2012-12-24,1,1,12,3,1,2,3,6.333333333333333
17193,2012-12-24,1,1,12,5,0,9,9,5.666666666666667
17194,2012-12-24,1,1,12,6,1,16,17,9.666666666666666
17195,2012-12-24,1,1,12,7,3,27,30,18.666666666666668
17196,2012-12-24,1,1,12,8,4,62,66,37.666666666666664
17197,2012-12-24,1,1,12,9,17,68,85,60.333333333333336
17198,2012-12-24,1,1,12,10,21,82,103,84.66666666666667
17199,2012-12-24,1,1,12,11,20,104,124,104.0
17200,2012-12-24,1,1,12,12,22,113,135,120.66666666666667
17201,2012-12-24,1,1,12,13,16,54,70,109.66666666666667
17202,2012-12-24,1,1,12,14,13,33,46,83.66666666666667
17203,2012-12-24,1,1,12,15,6,27,33,49.666666666666664
17204,2012-12-24,1,1,12,16,6,27,33,37.333333333333336
17205,2012-12-24,1,1,12,17,7,19,26,30.666666666666668
17206,2012-12-24,1,1,12,18,6,20,26,28.333333333333332
17207,2012-12-24,1,1,12,19,4,14,18,23.333333333333332
17208,2012-12-24,1,1,12,20,6,17,23,22.333333333333332
17209,2012-12-24,1,1,12,21,13,9,22,21.0
17210,2012-12-24,1,1,12,22,7,5,12,19.0
17211,2012-12-24,1,1,12,23,1,10,11,15.0
17212,2012-12-25,1,1,12,0,3,10,13,12.0
17213,2012-12-25,1,1,12,1,0,13,13,12.333333333333334
17214,2012-12-25,1,1,12,2,0,7,7,11.0
17215,2012-12-25,1,1,12,4,0,1,1,7.0
17216,2012-12-25,1,1,12,5,2,1,3,3.6666666666666665
17217,2012-12-25,1,1,12,6,1,6,7,3.6666666666666665
17218,2012-12-25,1,1,12,7,0,6,6,5.333333333333333
17219,2012-12-25,1,1,12,8,1,10,11,8.0
17220,2012-12-25,1,1,12,9,7,21,28,15.0
17221,2012-12-25,1,1,12,10,11,21,32,23.666666666666668
17222,2012-12-25,1,1,12,11,43,43,86,48.666666666666664
17223,2012-12-25,1,1,12,12,62,52,114,77.33333333333333
17224,2012-12-25,1,1,12,13,75,46,121,107.0
17225,2012-12-25,1,1,12,14,58,68,126,120.33333333333333
17226,2012-12-25,1,1,12,15,51,56,107,118.0
17227,2012-12-25,1,1,12,16,48,38,86,106.33333333333333
17228,2012-12-25,1,1,12,17,16,34,50,81.0
17229,2012-12-25,1,1,12,18,20,23,43,59.666666666666664
17230,2012-12-25,1,1,12,19,16,20,36,43.0
17231,2012-12-25,1,1,12,20,11,29,40,39.666666666666664
17232,2012-12-25,1,1,12,21,8,26,34,36.666666666666664
17233,2012-12-25,1,1,12,22,3,16,19,31.0
17234,2012-12-25,1,1,12,23,4,26,30,27.666666666666668
17235,2012-12-26,1,1,12,0,1,8,9,19.333333333333332
17236,2012-12-26,1,1,12,1,0,7,7,15.333333333333334
17237,2012-12-26,1,1,12,2,0,1,1,5.666666666666667
17238,2012-12-26,1,1,12,3,0,2,2,3.3333333333333335
17239,2012-12-26,1,1,12,4,0,2,2,1.6666666666666667
17240,2012-12-26,1,1,12,5,0,11,11,5.0
17241,2012-12-26,1,1,12,6,0,36,36,16.333333333333332
17242,2012-12-26,1,1,12,7,0,26,26,24.333333333333332
17243,2012-12-26,1,1,12,8,0,31,31,31.0
17244,2012-12-26,1,1,12,9,1,22,23,26.666666666666668
17245,2012-12-26,1,1,12,10,0,8,8,20.666666666666668
17246,2012-12-26,1,1,12,11,0,10,10,13.666666666666666
17247,2012-12-26,1,1,12,12,0,10,10,9.333333333333334
17248,2012-12-26,1,1,12,13,0,15,15,11.666666666666666
17249,2012-12-26,1,1,12,14,0,20,20,15.0
17250,2012-12-26,1,1,12,15,0,13,13,16.0
17251,2012-12-26,1,1,12,16,0,13,13,15.333333333333334
17252,2012-12-26,1,1,12,17,2,51,53,26.333333333333332
17253,2012-12-26,1,1,12,18,1,42,43,36.333333333333336
17254,2012-12-26,1,1,12,19,2,33,35,43.666666666666664
17255,2012-12-26,1,1,12,20,0,32,32,36.666666666666664
17256,2012-12-26,1,1,12,21,0,20,20,29.0
17257,2012-12-26,1,1,12,22,0,11,11,21.0
17258,2012-12-26,1,1,12,23,2,8,10,13.666666666666666
17259,2012-12-27,1,1,12,0,0,3,3,8.0
17260,2012-12-27,1,1,12,1,0,5,5,6.0
17261,2012-12-27,1,1,12,2,0,2,2,3.3333333333333335
17262,2012-12-27,1,1,12,3,0,1,1,2.6666666666666665
17263,2012-12-27,1,1,12,4,0,3,3,2.0
17264,2012-12-27,1,1,12,5,1,10,11,5.0
17265,2012-12-27,1,1,12,6,0,45,45,19.666666666666668
17266,2012-12-27,1,1,12,7,0,90,90,48.666666666666664
17267,2012-12-27,1,1,12,8,2,206,208,114.33333333333333
17268,2012-12-27,1,1,12,9,6,127,133,143.66666666666666
17269,2012-12-27,1,1,12,10,8,67,75,138.66666666666666
17270,2012-12-27,1,1,12,11,23,80,103,103.66666666666667
17271,2012-12-27,1,1,12,12,22,87,109,95.66666666666667
17272,2012-12-27,1,1,12,13,19,99,118,110.0
17273,2012-12-27,1,1,12,14,25,94,119,115.33333333333333
17274,2012-12-27,1,1,12,15,31,89,120,119.0
17275,2012-12-27,1,1,12,16,23,151,174,137.66666666666666
17276,2012-12-27,1,1,12,17,30,227,257,183.66666666666666
17277,2012-12-27,1,1,12,18,9,188,197,209.33333333333334
17278,2012-12-27,1,1,12,19,11,106,117,190.33333333333334
17279,2012-12-27,1,1,12,20,12,79,91,135.0
17280,2012-12-27,1,1,12,21,12,51,63,90.33333333333333
17281,2012-12-27,1,1,12,22,11,33,44,66.0
17282,2012-12-27,1,1,12,23,2,24,26,44.333333333333336
17283,2012-12-28,1,1,12,0,3,22,25,31.666666666666668
17284,2012-12-28,1,1,12,1,0,9,9,20.0
17285,2012-12-28,1,1,12,2,0,5,5,13.0
17286,2012-12-28,1,1,12,3,0,2,2,5.333333333333333
17287,2012-12-28,1,1,12,4,0,4,4,3.6666666666666665
17288,2012-12-28,1,1,12,5,0,15,15,7.0
17289,2012-12-28,1,1,12,6,2,49,51,23.333333333333332
17290,2012-12-28,1,1,12,7,1,111,112,59.333333333333336
17291,2012-12-28,1,1,12,8,1,238,239,134.0
17292,2012-12-28,1,1,12,9,18,173,191,180.66666666666666
17293,2012-12-28,1,1,12,10,77,85,162,197.33333333333334
17294,2012-12-28,1,1,12,11,71,107,178,177.0
17295,2012-12-28,1,1,12,12,72,150,222,187.33333333333334
17296,2012-12-28,1,1,12,13,76,146,222,207.33333333333334
17297,2012-12-28,1,1,12,14,84,177,261,235.0
17298,2012-12-28,1,1,12,15,74,151,225,236.0
17299,2012-12-28,1,1,12,16,42,208,250,245.33333333333334
17300,2012-12-28,1,1,12,17,43,228,271,248.66666666666666
17301,2012-12-28,1,1,12,18,16,197,213,244.66666666666666
17302,2012-12-28,1,1,12,19,15,113,128,204.0
17303,2012-12-28,1,1,12,20,14,83,97,146.0
17304,2012-12-28,1,1,12,21,17,75,92,105.66666666666667
17305,2012-12-28,1,1,12,22,13,49,62,83.66666666666667
17306,2012-12-28,1,1,12,23,5,54,59,71.0
17307,2012-12-29,1,1,12,0,1,25,26,49.0
17308,2012-12-29,1,1,12,1,6,31,37,40.666666666666664
17309,2012-12-29,1,1,12,2,1,18,19,27.333333333333332
17310,2012-12-29,1,1,12,3,1,5,6,20.666666666666668
17311,2012-12-29,1,1,12,4,0,3,3,9.333333333333334
17312,2012-12-29,1,1,12,5,0,3,3,4.0
17313,2012-12-29,1,1,12,6,0,7,7,4.333333333333333
17314,2012-12-29,1,1,12,7,1,17,18,9.333333333333334
17315,2012-12-29,1,1,12,8,9,35,44,23.0
17316,2012-12-29,1,1,12,9,16,33,49,37.0
17317,2012-12-29,1,1,12,10,6,35,41,44.666666666666664
17318,2012-12-29,1,1,12,11,7,38,45,45.0
17319,2012-12-29,1,1,12,12,5,43,48,44.666666666666664
17320,2012-12-29,1,1,12,13,13,71,84,59.0
17321,2012-12-29,1,1,12,14,10,88,98,76.66666666666667
17322,2012-12-29,1,1,12,15,19,110,129,103.66666666666667
17323,2012-12-29,1,1,12,16,22,125,147,124.66666666666667
17324,2012-12-29,1,1,12,17,18,100,118,131.33333333333334
17325,2012-12-29,1,1,12,18,8,102,110,125.0
17326,2012-12-29,1,1,12,19,7,90,97,108.33333333333333
17327,2012-12-29,1,1,12,20,2,64,66,91.0
17328,2012-12-29,1,1,12,21,4,56,60,74.33333333333333
17329,2012-12-29,1,1,12,22,3,51,54,60.0
17330,2012-12-29,1,1,12,23,0,32,32,48.666666666666664
17331,2012-12-30,1,1,12,0,0,41,41,42.333333333333336
17332,2012-12-30,1,1,12,1,1,27,28,33.666666666666664
17333,2012-12-30,1,1,12,2,0,19,19,29.333333333333332
17334,2012-12-30,1,1,12,3,1,14,15,20.666666666666668
17335,2012-12-30,1,1,12,4,0,7,7,13.666666666666666
17336,2012-12-30,1,1,12,5,0,2,2,8.0
17337,2012-12-30,1,1,12,6,1,7,8,5.666666666666667
17338,2012-12-30,1,1,12,7,0,13,13,7.666666666666667
17339,2012-12-30,1,1,12,8,1,32,33,18.0
17340,2012-12-30,1,1,12,9,9,65,74,40.0
17341,2012-12-30,1,1,12,10,31,91,122,76.33333333333333
17342,2012-12-30,1,1,12,11,33,103,136,110.66666666666667
17343,2012-12-30,1,1,12,12,47,97,144,134.0
17344,2012-12-30,1,1,12,13,49,120,169,149.66666666666666
17345,2012-12-30,1,1,12,14,39,121,160,157.66666666666666
17346,2012-12-30,1,1,12,15,37,101,138,155.66666666666666
17347,2012-12-30,1,1,12,16,31,102,133,143.66666666666666
17348,2012-12-30,1,1,12,17,26,97,123,131.33333333333334
17349,2012-12-30,1,1,12,18,12,113,125,127.0
17350,2012-12-30,1,1,12,19,16,86,102,116.66666666666667
17351,2012-12-30,1,1,12,20,9,63,72,99.66666666666667
17352,2012-12-30,1,1,12,21,5,42,47,73.66666666666667
17353,2012-12-30,1,1,12,22,6,30,36,51.666666666666664
17354,2012-12-30,1,1,12,23,10,39,49,44.0
17355,2012-12-31,1,1,12,0,4,30,34,39.666666666666664
17356,2012-12-31,1,1,12,1,6,13,19,34.0
17357,2012-12-31,1,1,12,2,3,8,11,21.333333333333332
17358,2012-12-31,1,1,12,3,0,1,1,10.333333333333334
17359,2012-12-31,1,1,12,4,0,3,3,5.0
17360,2012-12-31,1,1,12,5,0,9,9,4.333333333333333
17361,2012-12-31,1,1,12,6,0,40,40,17.333333333333332
17362,2012-12-31,1,1,12,7,2,83,85,44.666666666666664
17363,2012-12-31,1,1,12,8,9,187,196,107.0
17364,2012-12-31,1,1,12,9,13,144,157,146.0
17365,2012-12-31,1,1,12,10,33,87,120,157.66666666666666
17366,2012-12-31,1,1,12,11,43,114,157,144.66666666666666
17367,2012-12-31,1,1,12,12,52,172,224,167.0
17368,2012-12-31,1,1,12,13,38,165,203,194.66666666666666
17369,2012-12-31,1,1,12,14,62,185,247,224.66666666666666
17370,2012-12-31,1,1,12,15,69,246,315,255.0
17371,2012-12-31,1,1,12,16,30,184,214,258.6666666666667
17372,2012-12-31,1,1,12,17,14,150,164,231.0
17373,2012-12-31,1,1,12,18,10,112,122,166.66666666666666
17374,2012-12-31,1,1,12,19,11,108,119,135.0
17375,2012-12-31,1,1,12,20,8,81,89,110.0
17376,2012-12-31,1,1,12,21,7,83,90,99.33333333333333
17377,2012-12-31,1,1,12,22,13,48,61,80.0
17378,2012-12-31,1,1,12,23,12,37,49,66.66666666666667
